372327343,apache/flink,04/09/18 17:44,spirals-bears,e1e687d4-f849-47b3-a53e-600cf5a719ad_04-18-week4-FAILING_AND_PASSING,60,7,67
370022107,apache/flink,04/09/18 17:44,spirals-bears,e1e687d4-f849-47b3-a53e-600cf5a719ad_04-18-week4-FAILING_AND_PASSING,67,6,73
371450509,apache/flink,04/09/18 17:44,spirals-bears,e1e687d4-f849-47b3-a53e-600cf5a719ad_04-18-week4-FAILING_AND_PASSING,82,6,88
371364072,apache/flink,04/09/18 17:45,spirals-bears,e1e687d4-f849-47b3-a53e-600cf5a719ad_04-18-week4-FAILING_AND_PASSING,71,6,77
371288626,apache/flink,04/09/18 18:29,spirals-bears,e1e687d4-f849-47b3-a53e-600cf5a719ad_04-18-week4-FAILING_AND_PASSING,11,0,2,1,2,103,0,51,841,6,62,1624,70,1,2774
371129522,apache/flink,04/09/18 18:31,spirals-bears,e1e687d4-f849-47b3-a53e-600cf5a719ad_04-18-week4-FAILING_AND_PASSING,26,0,2,1,1,171,0,46,789,5,72,1652,61,2,2828
370789010,apache/flink,04/09/18 18:31,spirals-bears,e1e687d4-f849-47b3-a53e-600cf5a719ad_04-18-week4-FAILING_AND_PASSING,109,6,115
370473908,apache/flink,04/09/18 18:33,spirals-bears,e1e687d4-f849-47b3-a53e-600cf5a719ad_04-18-week4-FAILING_AND_PASSING,66,8,74
370494152,apache/flink,04/09/18 18:34,spirals-bears,e1e687d4-f849-47b3-a53e-600cf5a719ad_04-18-week4-FAILING_AND_PASSING,12,0,1,0,1,164,0,48,895,5,57,1633,61,4,2881
370121117,apache/flink,04/09/18 18:34,spirals-bears,e1e687d4-f849-47b3-a53e-600cf5a719ad_04-18-week4-FAILING_AND_PASSING,65,7,72
370372394,apache/flink,04/09/18 18:35,spirals-bears,e1e687d4-f849-47b3-a53e-600cf5a719ad_04-18-week4-FAILING_AND_PASSING,59,5,64
371086495,apache/flink,04/09/18 18:36,spirals-bears,e1e687d4-f849-47b3-a53e-600cf5a719ad_04-18-week4-FAILING_AND_PASSING,14,0,14,0,1,185,0,48,1065,11,69,1647,61,5,3120
369930371,apache/flink,04/09/18 18:38,spirals-bears,e1e687d4-f849-47b3-a53e-600cf5a719ad_04-18-week4-FAILING_AND_PASSING,70,5,75
369692987,apache/flink,04/09/18 18:39,spirals-bears,e1e687d4-f849-47b3-a53e-600cf5a719ad_04-18-week4-FAILING_AND_PASSING,62,6,68
372818752,prestodb/presto,04/09/18 18:41,spirals-bears,e1e687d4-f849-47b3-a53e-600cf5a719ad_04-18-week4-FAILING_AND_PASSING,52,7,59
372239554,prestodb/presto,04/09/18 19:10,spirals-bears,e1e687d4-f849-47b3-a53e-600cf5a719ad_04-18-week4-FAILING_AND_PASSING,811,909,42,0,2,1,1765
372243127,prestodb/presto,04/09/18 19:12,spirals-bears,e1e687d4-f849-47b3-a53e-600cf5a719ad_04-18-week4-FAILING_AND_PASSING,50,4,54
371698399,prestodb/presto,04/09/18 19:12,spirals-bears,e1e687d4-f849-47b3-a53e-600cf5a719ad_04-18-week4-FAILING_AND_PASSING,43,4,47
371779665,prestodb/presto,04/09/18 19:14,spirals-bears,e1e687d4-f849-47b3-a53e-600cf5a719ad_04-18-week4-FAILING_AND_PASSING,46,4,50
371697932,prestodb/presto,04/09/18 19:14,spirals-bears,e1e687d4-f849-47b3-a53e-600cf5a719ad_04-18-week4-FAILING_AND_PASSING,41,3,44
364740595,prestodb/presto,04/09/18 19:16,spirals-bears,e1e687d4-f849-47b3-a53e-600cf5a719ad_04-18-week4-FAILING_AND_PASSING,51,8,59
364739841,prestodb/presto,04/09/18 19:17,spirals-bears,e1e687d4-f849-47b3-a53e-600cf5a719ad_04-18-week4-FAILING_AND_PASSING,48,7,55
371214478,prestodb/presto,04/09/18 19:18,spirals-bears,e1e687d4-f849-47b3-a53e-600cf5a719ad_04-18-week4-FAILING_AND_PASSING,46,9,55
371209049,prestodb/presto,04/09/18 19:19,spirals-bears,e1e687d4-f849-47b3-a53e-600cf5a719ad_04-18-week4-FAILING_AND_PASSING,51,7,58
349551984,apache/flink,04/09/18 19:19,spirals-bears,e1e687d4-f849-47b3-a53e-600cf5a719ad_04-18-week4-FAILING_AND_PASSING,50,1610,11,70,0,8,1,154,0,921,2,12,2839
370850400,prestodb/presto,04/09/18 19:20,spirals-bears,e1e687d4-f849-47b3-a53e-600cf5a719ad_04-18-week4-FAILING_AND_PASSING,42,6,48
369937938,apache/flink,04/09/18 19:20,spirals-bears,e1e687d4-f849-47b3-a53e-600cf5a719ad_04-18-week4-FAILING_AND_PASSING,21,0,2,1,1,165,0,39,710,5,57,1648,60,3,2712
369851710,apache/flink,04/09/18 19:21,spirals-bears,e1e687d4-f849-47b3-a53e-600cf5a719ad_04-18-week4-FAILING_AND_PASSING,11,0,2,0,1,157,0,41,718,4,47,1668,61,3,2713
370811149,prestodb/presto,04/09/18 19:21,spirals-bears,e1e687d4-f849-47b3-a53e-600cf5a719ad_04-18-week4-FAILING_AND_PASSING,45,6,51
370427814,prestodb/presto,04/09/18 19:21,spirals-bears,e1e687d4-f849-47b3-a53e-600cf5a719ad_04-18-week4-FAILING_AND_PASSING,46,4,50
370725635,prestodb/presto,04/09/18 19:21,spirals-bears,e1e687d4-f849-47b3-a53e-600cf5a719ad_04-18-week4-FAILING_AND_PASSING,43,5,48
370737933,prestodb/presto,04/09/18 19:22,spirals-bears,e1e687d4-f849-47b3-a53e-600cf5a719ad_04-18-week4-FAILING_AND_PASSING,45,6,51
370361055,prestodb/presto,04/09/18 19:22,spirals-bears,e1e687d4-f849-47b3-a53e-600cf5a719ad_04-18-week4-FAILING_AND_PASSING,43,6,49
370400175,prestodb/presto,04/09/18 19:22,spirals-bears,e1e687d4-f849-47b3-a53e-600cf5a719ad_04-18-week4-FAILING_AND_PASSING,76,5,81
370186910,prestodb/presto,04/09/18 19:23,spirals-bears,e1e687d4-f849-47b3-a53e-600cf5a719ad_04-18-week4-FAILING_AND_PASSING,45,8,53
350486775,prestodb/presto,04/09/18 19:23,spirals-bears,e1e687d4-f849-47b3-a53e-600cf5a719ad_04-18-week4-FAILING_AND_PASSING,42,6,48
372463550,apache/incubator-druid,04/09/18 19:24,spirals-bears,e1e687d4-f849-47b3-a53e-600cf5a719ad_04-18-week4-FAILING_AND_PASSING,42,9,51
372274289,apache/incubator-druid,04/09/18 19:25,spirals-bears,e1e687d4-f849-47b3-a53e-600cf5a719ad_04-18-week4-FAILING_AND_PASSING,33,7,40
370742980,prestodb/presto,04/09/18 19:49,spirals-bears,e1e687d4-f849-47b3-a53e-600cf5a719ad_04-18-week4-FAILING_AND_PASSING,794,878,46,0,1,2,1721
373120770,apache/incubator-druid,04/09/18 20:02,spirals-bears,e1e687d4-f849-47b3-a53e-600cf5a719ad_04-18-week4-FAILING_AND_PASSING,1350,938,36,0,9,1,2334
370284812,apache/incubator-druid,04/09/18 20:05,spirals-bears,e1e687d4-f849-47b3-a53e-600cf5a719ad_04-18-week4-FAILING_AND_PASSING,60,5,65
370663614,apache/incubator-druid,04/09/18 20:06,spirals-bears,e1e687d4-f849-47b3-a53e-600cf5a719ad_04-18-week4-FAILING_AND_PASSING,37,5,42
370790533,apache/incubator-druid,04/09/18 20:37,spirals-bears,e1e687d4-f849-47b3-a53e-600cf5a719ad_04-18-week4-FAILING_AND_PASSING,56,0,3,64,1,457,0,1545,339,1,1342,533,35,49,4425
370603219,apache/incubator-druid,04/09/18 20:40,spirals-bears,e1e687d4-f849-47b3-a53e-600cf5a719ad_04-18-week4-FAILING_AND_PASSING,47,12,59
372234537,apache/incubator-druid,04/09/18 20:43,spirals-bears,e1e687d4-f849-47b3-a53e-600cf5a719ad_04-18-week4-FAILING_AND_PASSING,1506,1400,8,34,0,6,0,54,0,178,4,5,3195
370198714,apache/incubator-druid,04/09/18 20:45,spirals-bears,e1e687d4-f849-47b3-a53e-600cf5a719ad_04-18-week4-FAILING_AND_PASSING,36,6,42
369676461,apache/incubator-druid,04/09/18 20:46,spirals-bears,e1e687d4-f849-47b3-a53e-600cf5a719ad_04-18-week4-FAILING_AND_PASSING,37,5,42
372328177,thelastpickle/cassandra-reaper,04/09/18 20:46,spirals-bears,e1e687d4-f849-47b3-a53e-600cf5a719ad_04-18-week4-FAILING_AND_PASSING,8,0,8
372284096,apache/incubator-druid,04/09/18 20:56,spirals-bears,e1e687d4-f849-47b3-a53e-600cf5a719ad_04-18-week4-FAILING_AND_PASSING,57,0,2,1,1,43,3,1549,721,8,1942,1097,36,4,5464
370398818,apache/incubator-druid,04/09/18 21:16,spirals-bears,e1e687d4-f849-47b3-a53e-600cf5a719ad_04-18-week4-FAILING_AND_PASSING,1070,1008,38,0,16,1,2133
370692901,apache/incubator-druid,04/09/18 21:19,spirals-bears,e1e687d4-f849-47b3-a53e-600cf5a719ad_04-18-week4-FAILING_AND_PASSING,7,0,2,1,39,0,1118,396,1,1547,1216,36,1,4364
372669159,JMRI/JMRI,04/09/18 21:21,spirals-bears,e1e687d4-f849-47b3-a53e-600cf5a719ad_04-18-week4-FAILING_AND_PASSING,1321,116,578,0,34,0,2049
372009769,JMRI/JMRI,04/09/18 21:41,spirals-bears,e1e687d4-f849-47b3-a53e-600cf5a719ad_04-18-week4-FAILING_AND_PASSING,2093,108,11,271,0,4,0,113,0,70,12,4,2686
371048699,JMRI/JMRI,04/09/18 21:54,spirals-bears,e1e687d4-f849-47b3-a53e-600cf5a719ad_04-18-week4-FAILING_AND_PASSING,1666,113,278,0,3,1,10,2071
370862526,JMRI/JMRI,04/09/18 21:57,spirals-bears,e1e687d4-f849-47b3-a53e-600cf5a719ad_04-18-week4-FAILING_AND_PASSING,1708,114,270,0,32,0,16,2140
371245170,JMRI/JMRI,04/09/18 22:03,spirals-bears,e1e687d4-f849-47b3-a53e-600cf5a719ad_04-18-week4-FAILING_AND_PASSING,1695,109,10,639,0,31,0,139,0,91,5,5,2724
370858900,JMRI/JMRI,04/09/18 22:21,spirals-bears,e1e687d4-f849-47b3-a53e-600cf5a719ad_04-18-week4-FAILING_AND_PASSING,1629,110,596,0,4,0,7,2346
373059595,apache/nifi,04/09/18 22:22,spirals-bears,e1e687d4-f849-47b3-a53e-600cf5a719ad_04-18-week4-FAILING_AND_PASSING,35,6,41
369362002,JMRI/JMRI,04/09/18 22:32,spirals-bears,e1e687d4-f849-47b3-a53e-600cf5a719ad_04-18-week4-FAILING_AND_PASSING,1651,112,278,0,33,0,5,2079
370800128,JMRI/JMRI,04/09/18 22:34,spirals-bears,e1e687d4-f849-47b3-a53e-600cf5a719ad_04-18-week4-FAILING_AND_PASSING,1650,115,16,263,0,46,0,149,0,91,3,8,2341
369526251,JMRI/JMRI,04/09/18 22:39,spirals-bears,e1e687d4-f849-47b3-a53e-600cf5a719ad_04-18-week4-FAILING_AND_PASSING,1583,109,11,264,0,31,0,70,0,87,3,7,2165
371554568,apache/nifi,04/09/18 22:40,spirals-bears,e1e687d4-f849-47b3-a53e-600cf5a719ad_04-18-week4-FAILING_AND_PASSING,42,6,48
372622768,apache/nifi,04/09/18 22:48,spirals-bears,e1e687d4-f849-47b3-a53e-600cf5a719ad_04-18-week4-FAILING_AND_PASSING,1526,34,1,5,3,1569
372113520,apache/nifi,04/09/18 23:00,spirals-bears,e1e687d4-f849-47b3-a53e-600cf5a719ad_04-18-week4-FAILING_AND_PASSING,1623,35,1,8,3,1670
371040387,apache/nifi,04/09/18 23:01,spirals-bears,e1e687d4-f849-47b3-a53e-600cf5a719ad_04-18-week4-FAILING_AND_PASSING,43,4,47
371650023,apache/nifi,04/09/18 23:02,spirals-bears,e1e687d4-f849-47b3-a53e-600cf5a719ad_04-18-week4-FAILING_AND_PASSING,1645,37,1,2,4,1689
370634382,apache/nifi,04/09/18 23:03,spirals-bears,e1e687d4-f849-47b3-a53e-600cf5a719ad_04-18-week4-FAILING_AND_PASSING,38,5,43
371421285,apache/nifi,04/09/18 23:10,spirals-bears,e1e687d4-f849-47b3-a53e-600cf5a719ad_04-18-week4-FAILING_AND_PASSING,1706,36,1,9,4,1756
371233263,apache/nifi,04/09/18 23:17,spirals-bears,e1e687d4-f849-47b3-a53e-600cf5a719ad_04-18-week4-FAILING_AND_PASSING,1691,35,1,4,4,1735
370728924,apache/nifi,04/09/18 23:30,spirals-bears,e1e687d4-f849-47b3-a53e-600cf5a719ad_04-18-week4-FAILING_AND_PASSING,1672,42,2,1,4,1721
370185902,apache/nifi,04/09/18 23:32,spirals-bears,e1e687d4-f849-47b3-a53e-600cf5a719ad_04-18-week4-FAILING_AND_PASSING,1638,38,2,8,3,1689
368348334,apache/nifi,04/09/18 23:39,spirals-bears,e1e687d4-f849-47b3-a53e-600cf5a719ad_04-18-week4-FAILING_AND_PASSING,1694,37,2,8,3,1744
369845548,INRIA/spoon,04/09/18 23:40,spirals-bears,e1e687d4-f849-47b3-a53e-600cf5a719ad_04-18-week4-FAILING_AND_PASSING,11,5,16
369841429,apache/nifi,04/09/18 23:46,spirals-bears,e1e687d4-f849-47b3-a53e-600cf5a719ad_04-18-week4-FAILING_AND_PASSING,1659,40,1,3,4,1707
371459369,EnMasseProject/enmasse,04/09/18 23:47,spirals-bears,e1e687d4-f849-47b3-a53e-600cf5a719ad_04-18-week4-FAILING_AND_PASSING,26,3,29
371457502,EnMasseProject/enmasse,04/09/18 23:48,spirals-bears,e1e687d4-f849-47b3-a53e-600cf5a719ad_04-18-week4-FAILING_AND_PASSING,29,0,29
372076368,EnMasseProject/enmasse,04/09/18 23:48,spirals-bears,e1e687d4-f849-47b3-a53e-600cf5a719ad_04-18-week4-FAILING_AND_PASSING,26,0,26
372076394,EnMasseProject/enmasse,04/09/18 23:49,spirals-bears,e1e687d4-f849-47b3-a53e-600cf5a719ad_04-18-week4-FAILING_AND_PASSING,25,3,28
371417197,EnMasseProject/enmasse,04/09/18 23:49,spirals-bears,e1e687d4-f849-47b3-a53e-600cf5a719ad_04-18-week4-FAILING_AND_PASSING,27,3,30
371915804,EnMasseProject/enmasse,04/09/18 23:50,spirals-bears,e1e687d4-f849-47b3-a53e-600cf5a719ad_04-18-week4-FAILING_AND_PASSING,27,3,30
371488155,EnMasseProject/enmasse,04/09/18 23:51,spirals-bears,e1e687d4-f849-47b3-a53e-600cf5a719ad_04-18-week4-FAILING_AND_PASSING,28,0,28
371456293,INRIA/spoon,04/09/18 23:53,spirals-bears,e1e687d4-f849-47b3-a53e-600cf5a719ad_04-18-week4-FAILING_AND_PASSING,8,0,5,0,1,5,0,572,21,3,560,59,10,0,1244
368873197,apache/nifi,04/09/18 23:53,spirals-bears,e1e687d4-f849-47b3-a53e-600cf5a719ad_04-18-week4-FAILING_AND_PASSING,1313,37,1,9,3,1363
373217432,batfish/batfish,04/09/18 23:54,spirals-bears,e1e687d4-f849-47b3-a53e-600cf5a719ad_04-18-week4-FAILING_AND_PASSING,64,3,67
373217407,batfish/batfish,04/09/18 23:55,spirals-bears,e1e687d4-f849-47b3-a53e-600cf5a719ad_04-18-week4-FAILING_AND_PASSING,71,0,71
370614656,EnMasseProject/enmasse,04/09/18 23:55,spirals-bears,e1e687d4-f849-47b3-a53e-600cf5a719ad_04-18-week4-FAILING_AND_PASSING,102,133,27,0,1,2,0,265
372566741,batfish/batfish,04/09/18 23:56,spirals-bears,e1e687d4-f849-47b3-a53e-600cf5a719ad_04-18-week4-FAILING_AND_PASSING,52,0,52
372563821,batfish/batfish,04/09/18 23:56,spirals-bears,e1e687d4-f849-47b3-a53e-600cf5a719ad_04-18-week4-FAILING_AND_PASSING,53,3,56
372554836,batfish/batfish,04/09/18 23:57,spirals-bears,e1e687d4-f849-47b3-a53e-600cf5a719ad_04-18-week4-FAILING_AND_PASSING,50,0,50
372466776,batfish/batfish,04/09/18 23:58,spirals-bears,e1e687d4-f849-47b3-a53e-600cf5a719ad_04-18-week4-FAILING_AND_PASSING,52,4,56
373198938,batfish/batfish,04/09/18 23:58,spirals-bears,e1e687d4-f849-47b3-a53e-600cf5a719ad_04-18-week4-FAILING_AND_PASSING,7,160,56,0,1,1,0,225
372553912,batfish/batfish,04/09/18 23:58,spirals-bears,e1e687d4-f849-47b3-a53e-600cf5a719ad_04-18-week4-FAILING_AND_PASSING,35,60,0,2,1,98
371784057,batfish/batfish,04/09/18 23:59,spirals-bears,e1e687d4-f849-47b3-a53e-600cf5a719ad_04-18-week4-FAILING_AND_PASSING,52,0,52
371780350,batfish/batfish,04/09/18 23:59,spirals-bears,e1e687d4-f849-47b3-a53e-600cf5a719ad_04-18-week4-FAILING_AND_PASSING,50,3,53
371767641,batfish/batfish,05/09/18 00:00,spirals-bears,e1e687d4-f849-47b3-a53e-600cf5a719ad_04-18-week4-FAILING_AND_PASSING,49,0,49
371725281,batfish/batfish,05/09/18 00:00,spirals-bears,e1e687d4-f849-47b3-a53e-600cf5a719ad_04-18-week4-FAILING_AND_PASSING,49,0,49
369997088,INRIA/spoon,05/09/18 00:01,spirals-bears,e1e687d4-f849-47b3-a53e-600cf5a719ad_04-18-week4-FAILING_AND_PASSING,10,0,6,0,0,5,0,590,22,3,561,61,10,1,1269
371869895,batfish/batfish,05/09/18 00:01,spirals-bears,e1e687d4-f849-47b3-a53e-600cf5a719ad_04-18-week4-FAILING_AND_PASSING,7,149,52,0,1,2,0,211
371423851,batfish/batfish,05/09/18 00:01,spirals-bears,e1e687d4-f849-47b3-a53e-600cf5a719ad_04-18-week4-FAILING_AND_PASSING,81,0,81
371339760,batfish/batfish,05/09/18 00:01,spirals-bears,e1e687d4-f849-47b3-a53e-600cf5a719ad_04-18-week4-FAILING_AND_PASSING,53,0,53
371339945,batfish/batfish,05/09/18 00:02,spirals-bears,e1e687d4-f849-47b3-a53e-600cf5a719ad_04-18-week4-FAILING_AND_PASSING,49,4,53
371271629,batfish/batfish,05/09/18 00:02,spirals-bears,e1e687d4-f849-47b3-a53e-600cf5a719ad_04-18-week4-FAILING_AND_PASSING,49,0,49
371339889,batfish/batfish,05/09/18 00:03,spirals-bears,e1e687d4-f849-47b3-a53e-600cf5a719ad_04-18-week4-FAILING_AND_PASSING,56,0,56
371328291,batfish/batfish,05/09/18 00:03,spirals-bears,e1e687d4-f849-47b3-a53e-600cf5a719ad_04-18-week4-FAILING_AND_PASSING,59,3,62
370845565,batfish/batfish,05/09/18 00:03,spirals-bears,e1e687d4-f849-47b3-a53e-600cf5a719ad_04-18-week4-FAILING_AND_PASSING,50,3,53
370417292,batfish/batfish,05/09/18 00:04,spirals-bears,e1e687d4-f849-47b3-a53e-600cf5a719ad_04-18-week4-FAILING_AND_PASSING,58,3,61
370361612,batfish/batfish,05/09/18 00:04,spirals-bears,e1e687d4-f849-47b3-a53e-600cf5a719ad_04-18-week4-FAILING_AND_PASSING,57,0,57
370805492,batfish/batfish,05/09/18 00:04,spirals-bears,e1e687d4-f849-47b3-a53e-600cf5a719ad_04-18-week4-FAILING_AND_PASSING,67,0,67
370335857,batfish/batfish,05/09/18 00:04,spirals-bears,e1e687d4-f849-47b3-a53e-600cf5a719ad_04-18-week4-FAILING_AND_PASSING,50,3,53
371831791,lucee/Lucee,05/09/18 00:05,spirals-bears,e1e687d4-f849-47b3-a53e-600cf5a719ad_04-18-week4-FAILING_AND_PASSING,3,6,25,0,0,0,0,34
369923498,batfish/batfish,05/09/18 00:05,spirals-bears,e1e687d4-f849-47b3-a53e-600cf5a719ad_04-18-week4-FAILING_AND_PASSING,78,0,78
370344048,lucee/Lucee,05/09/18 00:06,spirals-bears,e1e687d4-f849-47b3-a53e-600cf5a719ad_04-18-week4-FAILING_AND_PASSING,3,6,22,0,0,1,0,32
370098613,lucee/Lucee,05/09/18 00:06,spirals-bears,e1e687d4-f849-47b3-a53e-600cf5a719ad_04-18-week4-FAILING_AND_PASSING,3,7,27,0,5,0,0,42
370434395,apache/incubator-servicecomb-java-chassis,05/09/18 00:06,spirals-bears,e1e687d4-f849-47b3-a53e-600cf5a719ad_04-18-week4-FAILING_AND_PASSING,8,3,11
369056089,apache/incubator-servicecomb-java-chassis,05/09/18 00:06,spirals-bears,e1e687d4-f849-47b3-a53e-600cf5a719ad_04-18-week4-FAILING_AND_PASSING,9,1,10
369749178,apache/incubator-servicecomb-java-chassis,05/09/18 00:07,spirals-bears,e1e687d4-f849-47b3-a53e-600cf5a719ad_04-18-week4-FAILING_AND_PASSING,9,4,13
373200799,runelite/runelite,05/09/18 00:07,spirals-bears,e1e687d4-f849-47b3-a53e-600cf5a719ad_04-18-week4-FAILING_AND_PASSING,10,15,25
373116456,runelite/runelite,05/09/18 00:07,spirals-bears,e1e687d4-f849-47b3-a53e-600cf5a719ad_04-18-week4-FAILING_AND_PASSING,11,14,25
372960796,runelite/runelite,05/09/18 00:07,spirals-bears,e1e687d4-f849-47b3-a53e-600cf5a719ad_04-18-week4-FAILING_AND_PASSING,11,0,11
372862183,runelite/runelite,05/09/18 00:08,spirals-bears,e1e687d4-f849-47b3-a53e-600cf5a719ad_04-18-week4-FAILING_AND_PASSING,11,0,11
372855116,runelite/runelite,05/09/18 00:08,spirals-bears,e1e687d4-f849-47b3-a53e-600cf5a719ad_04-18-week4-FAILING_AND_PASSING,11,0,11
372852187,runelite/runelite,05/09/18 00:08,spirals-bears,e1e687d4-f849-47b3-a53e-600cf5a719ad_04-18-week4-FAILING_AND_PASSING,10,0,10
372842777,runelite/runelite,05/09/18 00:08,spirals-bears,e1e687d4-f849-47b3-a53e-600cf5a719ad_04-18-week4-FAILING_AND_PASSING,12,0,12
372717651,runelite/runelite,05/09/18 00:08,spirals-bears,e1e687d4-f849-47b3-a53e-600cf5a719ad_04-18-week4-FAILING_AND_PASSING,12,0,12
372786429,runelite/runelite,05/09/18 00:09,spirals-bears,e1e687d4-f849-47b3-a53e-600cf5a719ad_04-18-week4-FAILING_AND_PASSING,11,15,26
372523830,runelite/runelite,05/09/18 00:09,spirals-bears,e1e687d4-f849-47b3-a53e-600cf5a719ad_04-18-week4-FAILING_AND_PASSING,11,0,11
372521408,runelite/runelite,05/09/18 00:09,spirals-bears,e1e687d4-f849-47b3-a53e-600cf5a719ad_04-18-week4-FAILING_AND_PASSING,10,0,10
372382581,runelite/runelite,05/09/18 00:09,spirals-bears,e1e687d4-f849-47b3-a53e-600cf5a719ad_04-18-week4-FAILING_AND_PASSING,12,0,12
372121987,runelite/runelite,05/09/18 00:10,spirals-bears,e1e687d4-f849-47b3-a53e-600cf5a719ad_04-18-week4-FAILING_AND_PASSING,11,0,11
372192773,runelite/runelite,05/09/18 00:10,spirals-bears,e1e687d4-f849-47b3-a53e-600cf5a719ad_04-18-week4-FAILING_AND_PASSING,10,13,23
372188494,runelite/runelite,05/09/18 00:10,spirals-bears,e1e687d4-f849-47b3-a53e-600cf5a719ad_04-18-week4-FAILING_AND_PASSING,10,0,10
372195057,runelite/runelite,05/09/18 00:11,spirals-bears,e1e687d4-f849-47b3-a53e-600cf5a719ad_04-18-week4-FAILING_AND_PASSING,11,0,11
371930391,runelite/runelite,05/09/18 00:11,spirals-bears,e1e687d4-f849-47b3-a53e-600cf5a719ad_04-18-week4-FAILING_AND_PASSING,10,0,10
371853657,runelite/runelite,05/09/18 00:12,spirals-bears,e1e687d4-f849-47b3-a53e-600cf5a719ad_04-18-week4-FAILING_AND_PASSING,11,0,11
371832446,runelite/runelite,05/09/18 00:12,spirals-bears,e1e687d4-f849-47b3-a53e-600cf5a719ad_04-18-week4-FAILING_AND_PASSING,12,15,27
371827978,runelite/runelite,05/09/18 00:12,spirals-bears,e1e687d4-f849-47b3-a53e-600cf5a719ad_04-18-week4-FAILING_AND_PASSING,10,0,10
371815411,runelite/runelite,05/09/18 00:13,spirals-bears,e1e687d4-f849-47b3-a53e-600cf5a719ad_04-18-week4-FAILING_AND_PASSING,10,15,25
371413432,runelite/runelite,05/09/18 00:13,spirals-bears,e1e687d4-f849-47b3-a53e-600cf5a719ad_04-18-week4-FAILING_AND_PASSING,11,0,11
371749543,runelite/runelite,05/09/18 00:14,spirals-bears,e1e687d4-f849-47b3-a53e-600cf5a719ad_04-18-week4-FAILING_AND_PASSING,11,14,25
371690317,runelite/runelite,05/09/18 00:14,spirals-bears,e1e687d4-f849-47b3-a53e-600cf5a719ad_04-18-week4-FAILING_AND_PASSING,11,0,11
371627483,runelite/runelite,05/09/18 00:15,spirals-bears,e1e687d4-f849-47b3-a53e-600cf5a719ad_04-18-week4-FAILING_AND_PASSING,12,0,12
371519323,runelite/runelite,05/09/18 00:15,spirals-bears,e1e687d4-f849-47b3-a53e-600cf5a719ad_04-18-week4-FAILING_AND_PASSING,11,0,11
371426762,runelite/runelite,05/09/18 00:15,spirals-bears,e1e687d4-f849-47b3-a53e-600cf5a719ad_04-18-week4-FAILING_AND_PASSING,11,0,11
370857867,runelite/runelite,05/09/18 00:16,spirals-bears,e1e687d4-f849-47b3-a53e-600cf5a719ad_04-18-week4-FAILING_AND_PASSING,12,0,12
371232766,runelite/runelite,05/09/18 00:16,spirals-bears,e1e687d4-f849-47b3-a53e-600cf5a719ad_04-18-week4-FAILING_AND_PASSING,11,0,11
370883332,runelite/runelite,05/09/18 00:16,spirals-bears,e1e687d4-f849-47b3-a53e-600cf5a719ad_04-18-week4-FAILING_AND_PASSING,10,0,10
370854743,runelite/runelite,05/09/18 00:17,spirals-bears,e1e687d4-f849-47b3-a53e-600cf5a719ad_04-18-week4-FAILING_AND_PASSING,10,0,10
370853085,runelite/runelite,05/09/18 00:17,spirals-bears,e1e687d4-f849-47b3-a53e-600cf5a719ad_04-18-week4-FAILING_AND_PASSING,10,13,23
370808967,runelite/runelite,05/09/18 00:18,spirals-bears,e1e687d4-f849-47b3-a53e-600cf5a719ad_04-18-week4-FAILING_AND_PASSING,11,0,11
370818186,runelite/runelite,05/09/18 00:18,spirals-bears,e1e687d4-f849-47b3-a53e-600cf5a719ad_04-18-week4-FAILING_AND_PASSING,10,0,10
372389986,runelite/runelite,05/09/18 00:18,spirals-bears,e1e687d4-f849-47b3-a53e-600cf5a719ad_04-18-week4-FAILING_AND_PASSING,5,0,17,0,0,4,0,155,55,3,155,128,11,0,533
370797617,runelite/runelite,05/09/18 00:18,spirals-bears,e1e687d4-f849-47b3-a53e-600cf5a719ad_04-18-week4-FAILING_AND_PASSING,10,0,10
370445619,runelite/runelite,05/09/18 00:19,spirals-bears,e1e687d4-f849-47b3-a53e-600cf5a719ad_04-18-week4-FAILING_AND_PASSING,10,0,10
370618809,runelite/runelite,05/09/18 00:19,spirals-bears,e1e687d4-f849-47b3-a53e-600cf5a719ad_04-18-week4-FAILING_AND_PASSING,11,14,25
370325529,runelite/runelite,05/09/18 00:19,spirals-bears,e1e687d4-f849-47b3-a53e-600cf5a719ad_04-18-week4-FAILING_AND_PASSING,11,1,12
354346098,runelite/runelite,05/09/18 00:20,spirals-bears,e1e687d4-f849-47b3-a53e-600cf5a719ad_04-18-week4-FAILING_AND_PASSING,11,19,30
370039277,runelite/runelite,05/09/18 00:20,spirals-bears,e1e687d4-f849-47b3-a53e-600cf5a719ad_04-18-week4-FAILING_AND_PASSING,11,0,11
370003933,runelite/runelite,05/09/18 00:21,spirals-bears,e1e687d4-f849-47b3-a53e-600cf5a719ad_04-18-week4-FAILING_AND_PASSING,11,0,11
369865631,runelite/runelite,05/09/18 00:21,spirals-bears,e1e687d4-f849-47b3-a53e-600cf5a719ad_04-18-week4-FAILING_AND_PASSING,10,1,11
370335656,runelite/runelite,05/09/18 00:21,spirals-bears,e1e687d4-f849-47b3-a53e-600cf5a719ad_04-18-week4-FAILING_AND_PASSING,100,11,0,14,0,125
369790306,runelite/runelite,05/09/18 00:21,spirals-bears,e1e687d4-f849-47b3-a53e-600cf5a719ad_04-18-week4-FAILING_AND_PASSING,11,0,11
369708750,runelite/runelite,05/09/18 00:22,spirals-bears,e1e687d4-f849-47b3-a53e-600cf5a719ad_04-18-week4-FAILING_AND_PASSING,11,15,26
369688929,runelite/runelite,05/09/18 00:22,spirals-bears,e1e687d4-f849-47b3-a53e-600cf5a719ad_04-18-week4-FAILING_AND_PASSING,12,0,12
369626418,runelite/runelite,05/09/18 00:22,spirals-bears,e1e687d4-f849-47b3-a53e-600cf5a719ad_04-18-week4-FAILING_AND_PASSING,12,0,12
369682464,runelite/runelite,05/09/18 00:22,spirals-bears,e1e687d4-f849-47b3-a53e-600cf5a719ad_04-18-week4-FAILING_AND_PASSING,11,20,31
372249968,CorfuDB/CorfuDB,05/09/18 00:27,spirals-bears,e1e687d4-f849-47b3-a53e-600cf5a719ad_04-18-week4-FAILING_AND_PASSING,265,3,268
372142631,CorfuDB/CorfuDB,05/09/18 00:27,spirals-bears,e1e687d4-f849-47b3-a53e-600cf5a719ad_04-18-week4-FAILING_AND_PASSING,268,0,268
366195789,apache/calcite,05/09/18 00:27,spirals-bears,e1e687d4-f849-47b3-a53e-600cf5a719ad_04-18-week4-FAILING_AND_PASSING,23,4,27
369714967,ChargeTimeEU/Java-OCA-OCPP,05/09/18 00:28,spirals-bears,e1e687d4-f849-47b3-a53e-600cf5a719ad_04-18-week4-FAILING_AND_PASSING,17,42,3,0,0,0,0,62
368182753,apache/calcite,05/09/18 00:28,spirals-bears,e1e687d4-f849-47b3-a53e-600cf5a719ad_04-18-week4-FAILING_AND_PASSING,22,4,26
371698478,apache/storm,05/09/18 00:29,spirals-bears,e1e687d4-f849-47b3-a53e-600cf5a719ad_04-18-week4-FAILING_AND_PASSING,39,4,43
368732773,apache/storm,05/09/18 00:30,spirals-bears,e1e687d4-f849-47b3-a53e-600cf5a719ad_04-18-week4-FAILING_AND_PASSING,38,3,41
369143925,apache/storm,05/09/18 00:31,spirals-bears,e1e687d4-f849-47b3-a53e-600cf5a719ad_04-18-week4-FAILING_AND_PASSING,51,6,57
373191896,apache/activemq-artemis,05/09/18 00:32,spirals-bears,e1e687d4-f849-47b3-a53e-600cf5a719ad_04-18-week4-FAILING_AND_PASSING,30,49,79
371623025,apache/activemq-artemis,05/09/18 00:33,spirals-bears,e1e687d4-f849-47b3-a53e-600cf5a719ad_04-18-week4-FAILING_AND_PASSING,29,6,35
364140024,matsim-org/matsim,05/09/18 00:34,spirals-bears,e1e687d4-f849-47b3-a53e-600cf5a719ad_04-18-week4-FAILING_AND_PASSING,1611,165,0,2,0,1778
372667703,matsim-org/matsim,05/09/18 00:34,spirals-bears,e1e687d4-f849-47b3-a53e-600cf5a719ad_04-18-week4-FAILING_AND_PASSING,1620,156,0,2,0,1778
370112566,apache/activemq-artemis,05/09/18 00:34,spirals-bears,e1e687d4-f849-47b3-a53e-600cf5a719ad_04-18-week4-FAILING_AND_PASSING,32,6,38
371769211,linkedin/pinot,05/09/18 00:35,spirals-bears,e1e687d4-f849-47b3-a53e-600cf5a719ad_04-18-week4-FAILING_AND_PASSING,34,5,39
371351470,linkedin/pinot,05/09/18 00:35,spirals-bears,e1e687d4-f849-47b3-a53e-600cf5a719ad_04-18-week4-FAILING_AND_PASSING,36,3,39
371295728,linkedin/pinot,05/09/18 00:36,spirals-bears,e1e687d4-f849-47b3-a53e-600cf5a719ad_04-18-week4-FAILING_AND_PASSING,41,4,45
368902384,linkedin/pinot,05/09/18 00:37,spirals-bears,e1e687d4-f849-47b3-a53e-600cf5a719ad_04-18-week4-FAILING_AND_PASSING,38,4,42
372111103,Azure/azure-libraries-for-java,05/09/18 00:45,spirals-bears,e1e687d4-f849-47b3-a53e-600cf5a719ad_04-18-week4-FAILING_AND_PASSING,11,0,10,0,1,20,0,88,89,5,92,105,65,0,486
371722787,Azure/azure-libraries-for-java,05/09/18 00:53,spirals-bears,e1e687d4-f849-47b3-a53e-600cf5a719ad_04-18-week4-FAILING_AND_PASSING,11,0,9,0,0,26,0,90,87,4,93,101,61,0,482
372198058,apache/storm,05/09/18 01:00,spirals-bears,e1e687d4-f849-47b3-a53e-600cf5a719ad_04-18-week4-FAILING_AND_PASSING,9,0,1,0,2,17,0,57,529,0,587,676,38,0,1916
371121328,Azure/azure-libraries-for-java,05/09/18 01:02,spirals-bears,e1e687d4-f849-47b3-a53e-600cf5a719ad_04-18-week4-FAILING_AND_PASSING,12,0,9,0,0,18,0,91,86,4,93,101,75,0,489
369883489,Azure/azure-libraries-for-java,05/09/18 01:03,spirals-bears,e1e687d4-f849-47b3-a53e-600cf5a719ad_04-18-week4-FAILING_AND_PASSING,62,9,71
370343664,Azure/azure-libraries-for-java,05/09/18 01:08,spirals-bears,e1e687d4-f849-47b3-a53e-600cf5a719ad_04-18-week4-FAILING_AND_PASSING,10,0,10,0,0,19,0,89,83,4,94,106,66,0,481
372351076,raphw/byte-buddy,05/09/18 01:11,spirals-bears,e1e687d4-f849-47b3-a53e-600cf5a719ad_04-18-week4-FAILING_AND_PASSING,81,112,255,0,0,0,1,449
370253028,linkedin/pinot,05/09/18 01:17,spirals-bears,e1e687d4-f849-47b3-a53e-600cf5a719ad_04-18-week4-FAILING_AND_PASSING,2083,405,37,0,13,0,1,2539
372159628,raphw/byte-buddy,05/09/18 01:18,spirals-bears,e1e687d4-f849-47b3-a53e-600cf5a719ad_04-18-week4-FAILING_AND_PASSING,88,123,373,0,0,0,1,585
371128343,raphw/byte-buddy,05/09/18 01:19,spirals-bears,e1e687d4-f849-47b3-a53e-600cf5a719ad_04-18-week4-FAILING_AND_PASSING,87,119,257,0,2,0,0,465
371805778,linkedin/pinot,05/09/18 01:40,spirals-bears,e1e687d4-f849-47b3-a53e-600cf5a719ad_04-18-week4-FAILING_AND_PASSING,3474,423,49,0,2,0,16,3964
373145390,HubSpot/Singularity,05/09/18 01:47,spirals-bears,e1e687d4-f849-47b3-a53e-600cf5a719ad_04-18-week4-FAILING_AND_PASSING,18,0,2,2,1,144,4,329,355,18,372,420,18,11,1694
371080565,HubSpot/Singularity,05/09/18 01:47,spirals-bears,e1e687d4-f849-47b3-a53e-600cf5a719ad_04-18-week4-FAILING_AND_PASSING,14,0,1,2,1,126,3,304,355,4,394,429,21,20,1674
373145093,HubSpot/Singularity,05/09/18 01:55,spirals-bears,e1e687d4-f849-47b3-a53e-600cf5a719ad_04-18-week4-FAILING_AND_PASSING,17,0,0,1,59,2,944,375,2,358,416,24,14,2212
369263118,lettuce-io/lettuce-core,05/09/18 01:57,spirals-bears,e1e687d4-f849-47b3-a53e-600cf5a719ad_04-18-week4-FAILING_AND_PASSING,29,66,9,0,0,1,0,105
370599190,HubSpot/Singularity,05/09/18 02:03,spirals-bears,e1e687d4-f849-47b3-a53e-600cf5a719ad_04-18-week4-FAILING_AND_PASSING,9,0,0,0,1,30,0,257,344,0,284,389,18,0,1332
372374678,magefree/mage,05/09/18 02:06,spirals-bears,e1e687d4-f849-47b3-a53e-600cf5a719ad_04-18-week4-FAILING_AND_PASSING,163,0,163
368327305,HubSpot/Singularity,05/09/18 02:09,spirals-bears,e1e687d4-f849-47b3-a53e-600cf5a719ad_04-18-week4-FAILING_AND_PASSING,19,0,0,0,1,35,0,248,296,0,331,364,17,0,1311
370205703,HubSpot/Singularity,05/09/18 02:09,spirals-bears,e1e687d4-f849-47b3-a53e-600cf5a719ad_04-18-week4-FAILING_AND_PASSING,924,374,17,0,0,1,1316
373229229,magefree/mage,05/09/18 02:13,spirals-bears,e1e687d4-f849-47b3-a53e-600cf5a719ad_04-18-week4-FAILING_AND_PASSING,10,0,13,0,1,28,0,150,25,1,189,352,185,1,955
372577626,magefree/mage,05/09/18 02:23,spirals-bears,e1e687d4-f849-47b3-a53e-600cf5a719ad_04-18-week4-FAILING_AND_PASSING,7,0,21,0,1,29,0,178,35,4,205,358,171,1,1010
372384407,magefree/mage,05/09/18 02:26,spirals-bears,e1e687d4-f849-47b3-a53e-600cf5a719ad_04-18-week4-FAILING_AND_PASSING,8,0,13,0,1,36,0,184,35,1,197,346,170,1,992
371289970,magefree/mage,05/09/18 02:26,spirals-bears,e1e687d4-f849-47b3-a53e-600cf5a719ad_04-18-week4-FAILING_AND_PASSING,8,0,13,0,0,36,0,181,36,1,199,350,167,1,992
371094152,magefree/mage,05/09/18 02:30,spirals-bears,e1e687d4-f849-47b3-a53e-600cf5a719ad_04-18-week4-FAILING_AND_PASSING,8,0,12,0,1,29,0,173,36,1,198,358,169,1,986
370403843,magefree/mage,05/09/18 02:39,spirals-bears,e1e687d4-f849-47b3-a53e-600cf5a719ad_04-18-week4-FAILING_AND_PASSING,11,0,15,0,3,31,0,164,29,1,204,341,164,4,967
370527230,molgenis/molgenis,05/09/18 02:41,spirals-bears,e1e687d4-f849-47b3-a53e-600cf5a719ad_04-18-week4-FAILING_AND_PASSING,47,6,53
369615029,magefree/mage,05/09/18 02:43,spirals-bears,e1e687d4-f849-47b3-a53e-600cf5a719ad_04-18-week4-FAILING_AND_PASSING,8,0,15,0,1,29,0,182,31,1,179,353,174,1,974
369788546,magefree/mage,05/09/18 02:44,spirals-bears,e1e687d4-f849-47b3-a53e-600cf5a719ad_04-18-week4-FAILING_AND_PASSING,9,0,14,0,1,42,0,186,34,1,211,354,170,1,1023
370144946,molgenis/molgenis,05/09/18 02:51,spirals-bears,e1e687d4-f849-47b3-a53e-600cf5a719ad_04-18-week4-FAILING_AND_PASSING,394,43,1,10,4,452
370952543,molgenis/molgenis,05/09/18 03:01,spirals-bears,e1e687d4-f849-47b3-a53e-600cf5a719ad_04-18-week4-FAILING_AND_PASSING,1090,729,42,1,9,4,2,1877
372960458,apache/incubator-dubbo,05/09/18 03:02,spirals-bears,e1e687d4-f849-47b3-a53e-600cf5a719ad_04-18-week4-FAILING_AND_PASSING,8,0,8
369998563,molgenis/molgenis,05/09/18 03:12,spirals-bears,e1e687d4-f849-47b3-a53e-600cf5a719ad_04-18-week4-FAILING_AND_PASSING,1082,752,38,1,9,3,4,1889
372356327,apache/incubator-dubbo,05/09/18 03:13,spirals-bears,e1e687d4-f849-47b3-a53e-600cf5a719ad_04-18-week4-FAILING_AND_PASSING,8,0,8
371894323,apache/incubator-dubbo,05/09/18 03:13,spirals-bears,e1e687d4-f849-47b3-a53e-600cf5a719ad_04-18-week4-FAILING_AND_PASSING,8,3,11
369080923,molgenis/molgenis,05/09/18 03:15,spirals-bears,e1e687d4-f849-47b3-a53e-600cf5a719ad_04-18-week4-FAILING_AND_PASSING,1086,735,52,1,9,4,2,1889
372681580,apache/incubator-dubbo,05/09/18 03:25,spirals-bears,e1e687d4-f849-47b3-a53e-600cf5a719ad_04-18-week4-FAILING_AND_PASSING,9,0,1,0,1,4,0,311,54,0,299,685,9,0,1373
372454752,languagetool-org/languagetool,05/09/18 03:28,spirals-bears,e1e687d4-f849-47b3-a53e-600cf5a719ad_04-18-week4-FAILING_AND_PASSING,9,36,0,3,27,0,0,32,0,815,0,64,0,754,118,331,36,0,2225
372171212,ga4gh/dockstore,05/09/18 03:29,spirals-bears,e1e687d4-f849-47b3-a53e-600cf5a719ad_04-18-week4-FAILING_AND_PASSING,10,0,10
370647736,ga4gh/dockstore,05/09/18 03:29,spirals-bears,e1e687d4-f849-47b3-a53e-600cf5a719ad_04-18-week4-FAILING_AND_PASSING,9,0,9
370094296,apache/incubator-dubbo,05/09/18 03:30,spirals-bears,e1e687d4-f849-47b3-a53e-600cf5a719ad_04-18-week4-FAILING_AND_PASSING,285,679,9,0,1,1,0,975
369721908,apache/incubator-dubbo,05/09/18 03:33,spirals-bears,e1e687d4-f849-47b3-a53e-600cf5a719ad_04-18-week4-FAILING_AND_PASSING,284,707,9,0,5,2,0,1007
366714620,apache/incubator-dubbo,05/09/18 03:41,spirals-bears,e1e687d4-f849-47b3-a53e-600cf5a719ad_04-18-week4-FAILING_AND_PASSING,242,689,9,0,5,2,0,947
371101560,apache/jackrabbit-oak,05/09/18 04:32,spirals-bears,e1e687d4-f849-47b3-a53e-600cf5a719ad_04-18-week4-FAILING_AND_PASSING,11,0,2,3,1,12,0,1735,198,1,1509,291,37,1,3801
370985357,aliyun/fc-java-sdk,05/09/18 04:34,spirals-bears,e1e687d4-f849-47b3-a53e-600cf5a719ad_04-18-week4-FAILING_AND_PASSING,9,0,0,0,0,0,0,9,16,0,8,32,2,0,76
370985404,aliyun/fc-java-sdk,05/09/18 04:36,spirals-bears,e1e687d4-f849-47b3-a53e-600cf5a719ad_04-18-week4-FAILING_AND_PASSING,10,0,2,0,0,0,0,7,14,2,9,33,2,0,79
371432038,apache/jackrabbit-oak,05/09/18 04:36,spirals-bears,e1e687d4-f849-47b3-a53e-600cf5a719ad_04-18-week4-FAILING_AND_PASSING,11,0,1,1,2,17,0,1776,382,1,1100,467,36,1,3795
373098445,openzipkin/zipkin,05/09/18 04:37,spirals-bears,e1e687d4-f849-47b3-a53e-600cf5a719ad_04-18-week4-FAILING_AND_PASSING,25,0,25
372146518,dropwizard/metrics,05/09/18 04:39,spirals-bears,e1e687d4-f849-47b3-a53e-600cf5a719ad_04-18-week4-FAILING_AND_PASSING,81,121,7,3,3,5,0,220
372619854,openzipkin/zipkin,05/09/18 04:40,spirals-bears,e1e687d4-f849-47b3-a53e-600cf5a719ad_04-18-week4-FAILING_AND_PASSING,24,2,26
371543123,apache/jackrabbit-oak,05/09/18 04:44,spirals-bears,e1e687d4-f849-47b3-a53e-600cf5a719ad_04-18-week4-FAILING_AND_PASSING,9,0,2,1,2,35,0,1771,379,1,1746,466,36,1,4449
372625585,openzipkin/zipkin,05/09/18 04:47,spirals-bears,e1e687d4-f849-47b3-a53e-600cf5a719ad_04-18-week4-FAILING_AND_PASSING,246,298,24,0,0,2,0,570
371609620,openzipkin/zipkin,05/09/18 04:47,spirals-bears,e1e687d4-f849-47b3-a53e-600cf5a719ad_04-18-week4-FAILING_AND_PASSING,24,0,24
371797536,openzipkin/zipkin,05/09/18 04:48,spirals-bears,e1e687d4-f849-47b3-a53e-600cf5a719ad_04-18-week4-FAILING_AND_PASSING,25,3,28
371577447,openzipkin/zipkin,05/09/18 04:48,spirals-bears,e1e687d4-f849-47b3-a53e-600cf5a719ad_04-18-week4-FAILING_AND_PASSING,25,0,25
372602451,openzipkin/zipkin,05/09/18 04:50,spirals-bears,e1e687d4-f849-47b3-a53e-600cf5a719ad_04-18-week4-FAILING_AND_PASSING,244,293,24,0,4,2,0,567
371434547,openzipkin/zipkin,05/09/18 04:50,spirals-bears,e1e687d4-f849-47b3-a53e-600cf5a719ad_04-18-week4-FAILING_AND_PASSING,24,0,24
371434570,openzipkin/zipkin,05/09/18 04:51,spirals-bears,e1e687d4-f849-47b3-a53e-600cf5a719ad_04-18-week4-FAILING_AND_PASSING,23,2,25
371425516,openzipkin/zipkin,05/09/18 04:51,spirals-bears,e1e687d4-f849-47b3-a53e-600cf5a719ad_04-18-week4-FAILING_AND_PASSING,25,0,25
370870385,openzipkin/zipkin,05/09/18 04:52,spirals-bears,e1e687d4-f849-47b3-a53e-600cf5a719ad_04-18-week4-FAILING_AND_PASSING,30,0,30
371837132,openzipkin/zipkin,05/09/18 04:54,spirals-bears,e1e687d4-f849-47b3-a53e-600cf5a719ad_04-18-week4-FAILING_AND_PASSING,231,289,25,0,0,2,0,547
372124168,resteasy/Resteasy,05/09/18 04:54,spirals-bears,e1e687d4-f849-47b3-a53e-600cf5a719ad_04-18-week4-FAILING_AND_PASSING,18,5,23
370937622,apache/jackrabbit-oak,05/09/18 04:56,spirals-bears,e1e687d4-f849-47b3-a53e-600cf5a719ad_04-18-week4-FAILING_AND_PASSING,15,0,2,0,2,23,0,1788,382,0,1744,457,35,1,4449
371159335,resteasy/Resteasy,05/09/18 04:56,spirals-bears,e1e687d4-f849-47b3-a53e-600cf5a719ad_04-18-week4-FAILING_AND_PASSING,17,5,22
371305634,resteasy/Resteasy,05/09/18 04:57,spirals-bears,e1e687d4-f849-47b3-a53e-600cf5a719ad_04-18-week4-FAILING_AND_PASSING,18,6,24
370632642,resteasy/Resteasy,05/09/18 04:57,spirals-bears,e1e687d4-f849-47b3-a53e-600cf5a719ad_04-18-week4-FAILING_AND_PASSING,19,6,25
370548934,resteasy/Resteasy,05/09/18 04:58,spirals-bears,e1e687d4-f849-47b3-a53e-600cf5a719ad_04-18-week4-FAILING_AND_PASSING,19,5,24
370058826,resteasy/Resteasy,05/09/18 04:58,spirals-bears,e1e687d4-f849-47b3-a53e-600cf5a719ad_04-18-week4-FAILING_AND_PASSING,18,5,23
369638473,openzipkin/zipkin,05/09/18 05:01,spirals-bears,e1e687d4-f849-47b3-a53e-600cf5a719ad_04-18-week4-FAILING_AND_PASSING,205,289,24,0,1,2,0,521
371536704,openzipkin/zipkin,05/09/18 05:04,spirals-bears,e1e687d4-f849-47b3-a53e-600cf5a719ad_04-18-week4-FAILING_AND_PASSING,7,7,0,0,7,0,2,3,0,209,0,149,1,196,285,23,7,0,896
370763477,geoserver/geoserver,05/09/18 05:05,spirals-bears,e1e687d4-f849-47b3-a53e-600cf5a719ad_04-18-week4-FAILING_AND_PASSING,7,53,0,13,0,73
372147774,geoserver/geoserver,05/09/18 05:08,spirals-bears,e1e687d4-f849-47b3-a53e-600cf5a719ad_04-18-week4-FAILING_AND_PASSING,333,54,0,5,1,393
372118472,geoserver/geoserver,05/09/18 05:09,spirals-bears,e1e687d4-f849-47b3-a53e-600cf5a719ad_04-18-week4-FAILING_AND_PASSING,136,51,0,14,0,201
370650414,geoserver/geoserver,05/09/18 05:11,spirals-bears,e1e687d4-f849-47b3-a53e-600cf5a719ad_04-18-week4-FAILING_AND_PASSING,128,56,1,4,1,190
369961073,geoserver/geoserver,05/09/18 05:12,spirals-bears,e1e687d4-f849-47b3-a53e-600cf5a719ad_04-18-week4-FAILING_AND_PASSING,130,56,0,6,1,193
369233221,geoserver/geoserver,05/09/18 05:12,spirals-bears,e1e687d4-f849-47b3-a53e-600cf5a719ad_04-18-week4-FAILING_AND_PASSING,57,5,62
372142770,geoserver/geoserver,05/09/18 05:28,spirals-bears,e1e687d4-f849-47b3-a53e-600cf5a719ad_04-18-week4-FAILING_AND_PASSING,12,0,6,0,1,30,0,477,45,0,488,635,52,0,1746
371512925,aicis/fresco,05/09/18 05:36,spirals-bears,e1e687d4-f849-47b3-a53e-600cf5a719ad_04-18-week4-FAILING_AND_PASSING,1258,96,9,0,0,0,0,1363
371143404,aicis/fresco,05/09/18 05:40,spirals-bears,e1e687d4-f849-47b3-a53e-600cf5a719ad_04-18-week4-FAILING_AND_PASSING,8,0,0,0,0,4,0,332,32,0,235,110,9,0,730
372937909,aicis/fresco,05/09/18 05:41,spirals-bears,e1e687d4-f849-47b3-a53e-600cf5a719ad_04-18-week4-FAILING_AND_PASSING,9,5,0,0,6,0,0,4,0,1193,0,36,0,347,99,10,5,0,1714
371531351,resteasy/Resteasy,05/09/18 05:46,spirals-bears,e1e687d4-f849-47b3-a53e-600cf5a719ad_04-18-week4-FAILING_AND_PASSING,9,20,1,1,8,1,2,20,0,1953,0,73,1,58,904,19,17,0,3087
370482661,aicis/fresco,05/09/18 06:04,spirals-bears,e1e687d4-f849-47b3-a53e-600cf5a719ad_04-18-week4-FAILING_AND_PASSING,1285,95,8,0,0,0,0,1388
370117466,aicis/fresco,05/09/18 06:05,spirals-bears,e1e687d4-f849-47b3-a53e-600cf5a719ad_04-18-week4-FAILING_AND_PASSING,1312,98,9,0,0,0,0,1419
370086425,aicis/fresco,05/09/18 06:09,spirals-bears,e1e687d4-f849-47b3-a53e-600cf5a719ad_04-18-week4-FAILING_AND_PASSING,1268,94,9,0,0,0,0,1371
370307777,arcao/geocaching-api,05/09/18 06:14,spirals-bears,e1e687d4-f849-47b3-a53e-600cf5a719ad_04-18-week4-FAILING_AND_PASSING,527,4,10,0,10,551
350525365,swagger-api/swagger-codegen,05/09/18 06:15,spirals-bears,e1e687d4-f849-47b3-a53e-600cf5a719ad_04-18-week4-FAILING_AND_PASSING,51,266,33,0,8,0,0,358
371762370,spring-cloud/spring-cloud-gcp,05/09/18 06:16,spirals-bears,e1e687d4-f849-47b3-a53e-600cf5a719ad_04-18-week4-FAILING_AND_PASSING,4,2,6
363136553,rabbitmq/rabbitmq-perf-test,05/09/18 06:16,spirals-bears,e1e687d4-f849-47b3-a53e-600cf5a719ad_04-18-week4-FAILING_AND_PASSING,52,23,4,0,0,0,0,79
371579735,spring-cloud/spring-cloud-gcp,05/09/18 06:16,spirals-bears,e1e687d4-f849-47b3-a53e-600cf5a719ad_04-18-week4-FAILING_AND_PASSING,5,2,7
371151916,spring-cloud/spring-cloud-gcp,05/09/18 06:16,spirals-bears,e1e687d4-f849-47b3-a53e-600cf5a719ad_04-18-week4-FAILING_AND_PASSING,4,2,6
370704983,spring-cloud/spring-cloud-gcp,05/09/18 06:16,spirals-bears,e1e687d4-f849-47b3-a53e-600cf5a719ad_04-18-week4-FAILING_AND_PASSING,4,2,6
370610565,spring-cloud/spring-cloud-gcp,05/09/18 06:17,spirals-bears,e1e687d4-f849-47b3-a53e-600cf5a719ad_04-18-week4-FAILING_AND_PASSING,4,2,6
370615083,spring-cloud/spring-cloud-gcp,05/09/18 06:17,spirals-bears,e1e687d4-f849-47b3-a53e-600cf5a719ad_04-18-week4-FAILING_AND_PASSING,5,2,7
370784321,datastax/java-driver,05/09/18 06:17,spirals-bears,e1e687d4-f849-47b3-a53e-600cf5a719ad_04-18-week4-FAILING_AND_PASSING,17,2,19
365376200,datastax/java-driver,05/09/18 06:18,spirals-bears,e1e687d4-f849-47b3-a53e-600cf5a719ad_04-18-week4-FAILING_AND_PASSING,17,0,17
370609405,aicis/fresco,05/09/18 06:18,spirals-bears,e1e687d4-f849-47b3-a53e-600cf5a719ad_04-18-week4-FAILING_AND_PASSING,12,6,0,0,7,0,0,6,0,1212,0,42,0,1141,92,8,5,0,2531
373017611,heptastique/onlygo,05/09/18 06:24,spirals-bears,e1e687d4-f849-47b3-a53e-600cf5a719ad_04-18-week4-FAILING_AND_PASSING,11,0,0,0,2,0,0,148,12,0,151,34,4,0,362
373017621,heptastique/onlygo,05/09/18 06:24,spirals-bears,e1e687d4-f849-47b3-a53e-600cf5a719ad_04-18-week4-FAILING_AND_PASSING,10,0,2,0,2,0,0,149,13,3,152,32,4,0,367
370709312,spring-cloud/spring-cloud-gcp,05/09/18 06:25,spirals-bears,e1e687d4-f849-47b3-a53e-600cf5a719ad_04-18-week4-FAILING_AND_PASSING,68,460,4,5,0,10,0,547
372924439,heptastique/onlygo,05/09/18 06:30,spirals-bears,e1e687d4-f849-47b3-a53e-600cf5a719ad_04-18-week4-FAILING_AND_PASSING,11,0,2,0,2,0,0,154,12,2,141,28,4,0,356
372924414,heptastique/onlygo,05/09/18 06:30,spirals-bears,e1e687d4-f849-47b3-a53e-600cf5a719ad_04-18-week4-FAILING_AND_PASSING,11,0,0,0,2,0,0,151,15,0,140,30,4,0,353
372926384,heptastique/onlygo,05/09/18 06:31,spirals-bears,e1e687d4-f849-47b3-a53e-600cf5a719ad_04-18-week4-FAILING_AND_PASSING,10,0,0,0,2,0,0,145,12,0,142,27,3,0,341
370035180,aicis/fresco,05/09/18 06:32,spirals-bears,e1e687d4-f849-47b3-a53e-600cf5a719ad_04-18-week4-FAILING_AND_PASSING,8,6,0,0,7,0,0,4,0,1269,0,36,0,225,112,10,6,0,1683
372903641,heptastique/onlygo,05/09/18 06:36,spirals-bears,e1e687d4-f849-47b3-a53e-600cf5a719ad_04-18-week4-FAILING_AND_PASSING,10,0,0,0,2,0,0,135,12,0,138,27,4,0,328
372921172,heptastique/onlygo,05/09/18 06:36,spirals-bears,e1e687d4-f849-47b3-a53e-600cf5a719ad_04-18-week4-FAILING_AND_PASSING,11,0,3,0,2,0,0,136,10,3,142,28,5,0,340
372784586,heptastique/onlygo,05/09/18 06:36,spirals-bears,e1e687d4-f849-47b3-a53e-600cf5a719ad_04-18-week4-FAILING_AND_PASSING,10,0,0,0,2,0,0,122,12,0,126,30,3,0,305
372784639,heptastique/onlygo,05/09/18 06:37,spirals-bears,e1e687d4-f849-47b3-a53e-600cf5a719ad_04-18-week4-FAILING_AND_PASSING,11,0,2,0,2,0,0,122,12,2,123,28,4,0,306
371674161,heptastique/onlygo,05/09/18 06:39,spirals-bears,e1e687d4-f849-47b3-a53e-600cf5a719ad_04-18-week4-FAILING_AND_PASSING,109,28,11,4,0,0,2,0,0,0,0,154
371674189,heptastique/onlygo,05/09/18 06:40,spirals-bears,e1e687d4-f849-47b3-a53e-600cf5a719ad_04-18-week4-FAILING_AND_PASSING,114,27,11,3,0,2,2,0,0,0,2,161
372080348,heptastique/onlygo,05/09/18 06:41,spirals-bears,e1e687d4-f849-47b3-a53e-600cf5a719ad_04-18-week4-FAILING_AND_PASSING,12,0,0,0,2,0,0,124,11,0,127,29,4,0,309
371925044,heptastique/onlygo,05/09/18 06:42,spirals-bears,e1e687d4-f849-47b3-a53e-600cf5a719ad_04-18-week4-FAILING_AND_PASSING,11,0,0,0,2,0,0,124,12,0,127,30,5,0,311
371522040,heptastique/onlygo,05/09/18 06:42,spirals-bears,e1e687d4-f849-47b3-a53e-600cf5a719ad_04-18-week4-FAILING_AND_PASSING,11,0,0,0,2,0,0,52,11,0,54,26,4,0,160
371497061,heptastique/onlygo,05/09/18 06:45,spirals-bears,e1e687d4-f849-47b3-a53e-600cf5a719ad_04-18-week4-FAILING_AND_PASSING,11,0,0,0,2,1,0,98,12,0,100,28,4,0,256
371245307,heptastique/onlygo,05/09/18 06:45,spirals-bears,e1e687d4-f849-47b3-a53e-600cf5a719ad_04-18-week4-FAILING_AND_PASSING,4,0,4
371497067,heptastique/onlygo,05/09/18 06:46,spirals-bears,e1e687d4-f849-47b3-a53e-600cf5a719ad_04-18-week4-FAILING_AND_PASSING,11,0,2,0,2,0,0,100,12,2,101,29,4,0,263
371476937,heptastique/onlygo,05/09/18 06:46,spirals-bears,e1e687d4-f849-47b3-a53e-600cf5a719ad_04-18-week4-FAILING_AND_PASSING,10,0,2,0,2,0,0,101,10,2,101,29,4,0,261
371476532,heptastique/onlygo,05/09/18 06:46,spirals-bears,e1e687d4-f849-47b3-a53e-600cf5a719ad_04-18-week4-FAILING_AND_PASSING,10,0,0,0,2,0,0,101,11,0,100,27,4,0,255
371078964,heptastique/onlygo,05/09/18 06:47,spirals-bears,e1e687d4-f849-47b3-a53e-600cf5a719ad_04-18-week4-FAILING_AND_PASSING,11,0,2,0,2,0,0,43,12,2,44,26,3,0,145
371078952,heptastique/onlygo,05/09/18 06:49,spirals-bears,e1e687d4-f849-47b3-a53e-600cf5a719ad_04-18-week4-FAILING_AND_PASSING,9,0,0,0,2,0,0,44,12,0,46,28,4,0,145
371069661,heptastique/onlygo,05/09/18 06:49,spirals-bears,e1e687d4-f849-47b3-a53e-600cf5a719ad_04-18-week4-FAILING_AND_PASSING,11,0,3,0,2,0,0,42,12,2,41,28,16,0,157
371051792,heptastique/onlygo,05/09/18 06:49,spirals-bears,e1e687d4-f849-47b3-a53e-600cf5a719ad_04-18-week4-FAILING_AND_PASSING,11,0,2,0,2,0,0,39,13,2,39,29,4,0,141
371051788,heptastique/onlygo,05/09/18 06:50,spirals-bears,e1e687d4-f849-47b3-a53e-600cf5a719ad_04-18-week4-FAILING_AND_PASSING,12,0,0,0,2,0,0,38,11,0,42,27,4,0,136
372299762,SzFMV2018-Tavasz/AutomatedCar,05/09/18 06:51,spirals-bears,e1e687d4-f849-47b3-a53e-600cf5a719ad_04-18-week4-FAILING_AND_PASSING,10,0,0,3,4,0,0,0,0,13,0,10,2,14,23,10,0,0,89
371015260,heptastique/onlygo,05/09/18 06:51,spirals-bears,e1e687d4-f849-47b3-a53e-600cf5a719ad_04-18-week4-FAILING_AND_PASSING,11,0,2,0,2,0,0,36,13,2,38,27,4,0,135
371015258,heptastique/onlygo,05/09/18 06:51,spirals-bears,e1e687d4-f849-47b3-a53e-600cf5a719ad_04-18-week4-FAILING_AND_PASSING,11,0,0,0,2,0,0,35,12,0,37,27,4,0,128
372299640,SzFMV2018-Tavasz/AutomatedCar,05/09/18 06:51,spirals-bears,e1e687d4-f849-47b3-a53e-600cf5a719ad_04-18-week4-FAILING_AND_PASSING,10,0,0,0,4,0,0,0,0,12,0,9,0,14,22,8,0,0,79
370079227,dhis2/dhis2-core,05/09/18 06:52,spirals-bears,e1e687d4-f849-47b3-a53e-600cf5a719ad_04-18-week4-FAILING_AND_PASSING,22,3,25
371397394,bmwcarit/barefoot,05/09/18 06:53,spirals-bears,e1e687d4-f849-47b3-a53e-600cf5a719ad_04-18-week4-FAILING_AND_PASSING,35,25,7,0,2,0,0,69
371397361,bmwcarit/barefoot,05/09/18 06:54,spirals-bears,e1e687d4-f849-47b3-a53e-600cf5a719ad_04-18-week4-FAILING_AND_PASSING,34,23,7,0,0,0,0,64
370083532,jcabi/jcabi-github,05/09/18 07:00,spirals-bears,e1e687d4-f849-47b3-a53e-600cf5a719ad_04-18-week4-FAILING_AND_PASSING,75,432,21,0,2,0,0,530
372697186,debezium/debezium,05/09/18 07:01,spirals-bears,e1e687d4-f849-47b3-a53e-600cf5a719ad_04-18-week4-FAILING_AND_PASSING,60,285,7,0,4,1,0,357
371697408,debezium/debezium,05/09/18 07:01,spirals-bears,e1e687d4-f849-47b3-a53e-600cf5a719ad_04-18-week4-FAILING_AND_PASSING,6,4,10
372635040,debezium/debezium,05/09/18 07:03,spirals-bears,e1e687d4-f849-47b3-a53e-600cf5a719ad_04-18-week4-FAILING_AND_PASSING,62,109,6,0,4,0,0,181
369995754,dhis2/dhis2-core,05/09/18 07:03,spirals-bears,e1e687d4-f849-47b3-a53e-600cf5a719ad_04-18-week4-FAILING_AND_PASSING,473,198,24,0,10,0,0,705
370889052,2018swecapstone/h2ms,05/09/18 07:07,spirals-bears,e1e687d4-f849-47b3-a53e-600cf5a719ad_04-18-week4-FAILING_AND_PASSING,122,72,11,4,0,2,2,0,0,0,2,215
370889044,2018swecapstone/h2ms,05/09/18 07:07,spirals-bears,e1e687d4-f849-47b3-a53e-600cf5a719ad_04-18-week4-FAILING_AND_PASSING,124,72,13,3,0,0,1,0,0,0,0,213
371966017,alipay/sofa-rpc,05/09/18 07:07,spirals-bears,e1e687d4-f849-47b3-a53e-600cf5a719ad_04-18-week4-FAILING_AND_PASSING,3,0,3
371456164,alipay/sofa-rpc,05/09/18 07:07,spirals-bears,e1e687d4-f849-47b3-a53e-600cf5a719ad_04-18-week4-FAILING_AND_PASSING,3,3,6
371957748,alipay/sofa-rpc,05/09/18 07:09,spirals-bears,e1e687d4-f849-47b3-a53e-600cf5a719ad_04-18-week4-FAILING_AND_PASSING,4,7,0,0,6,1,5,14,21,0,13,46,6,0,123
371427814,alipay/sofa-rpc,05/09/18 07:10,spirals-bears,e1e687d4-f849-47b3-a53e-600cf5a719ad_04-18-week4-FAILING_AND_PASSING,4,5,0,0,6,1,5,12,19,0,15,45,4,0,116
369657643,fabric8io/fabric8-maven-plugin,05/09/18 07:10,spirals-bears,e1e687d4-f849-47b3-a53e-600cf5a719ad_04-18-week4-FAILING_AND_PASSING,29,5,34
371988688,Activiti/Activiti,05/09/18 07:10,spirals-bears,e1e687d4-f849-47b3-a53e-600cf5a719ad_04-18-week4-FAILING_AND_PASSING,31,3,34
371988668,Activiti/Activiti,05/09/18 07:10,spirals-bears,e1e687d4-f849-47b3-a53e-600cf5a719ad_04-18-week4-FAILING_AND_PASSING,31,0,31
372227533,jdbi/jdbi,05/09/18 07:11,spirals-bears,e1e687d4-f849-47b3-a53e-600cf5a719ad_04-18-week4-FAILING_AND_PASSING,9,3,12
371117370,jdbi/jdbi,05/09/18 07:14,spirals-bears,e1e687d4-f849-47b3-a53e-600cf5a719ad_04-18-week4-FAILING_AND_PASSING,160,8,0,4,1,173
370810245,jdbi/jdbi,05/09/18 07:14,spirals-bears,e1e687d4-f849-47b3-a53e-600cf5a719ad_04-18-week4-FAILING_AND_PASSING,8,3,11
370594868,jdbi/jdbi,05/09/18 07:14,spirals-bears,e1e687d4-f849-47b3-a53e-600cf5a719ad_04-18-week4-FAILING_AND_PASSING,8,3,11
373137938,jdbi/jdbi,05/09/18 07:15,spirals-bears,e1e687d4-f849-47b3-a53e-600cf5a719ad_04-18-week4-FAILING_AND_PASSING,234,8,0,3,1,246
370699500,jdbi/jdbi,05/09/18 07:17,spirals-bears,e1e687d4-f849-47b3-a53e-600cf5a719ad_04-18-week4-FAILING_AND_PASSING,153,9,0,4,1,167
369833200,jdbi/jdbi,05/09/18 07:18,spirals-bears,e1e687d4-f849-47b3-a53e-600cf5a719ad_04-18-week4-FAILING_AND_PASSING,8,2,10
369831228,jdbi/jdbi,05/09/18 07:18,spirals-bears,e1e687d4-f849-47b3-a53e-600cf5a719ad_04-18-week4-FAILING_AND_PASSING,8,0,8
371284578,zalando/zalenium,05/09/18 07:24,spirals-bears,e1e687d4-f849-47b3-a53e-600cf5a719ad_04-18-week4-FAILING_AND_PASSING,10,0,2,0,0,1,0,130,36,2,120,58,5,0,364
369831693,MyCoRe-Org/mycore,05/09/18 07:26,spirals-bears,e1e687d4-f849-47b3-a53e-600cf5a719ad_04-18-week4-FAILING_AND_PASSING,6,0,2,0,1,24,0,391,236,1,404,408,46,1,1520
370279552,jdbi/jdbi,05/09/18 07:29,spirals-bears,e1e687d4-f849-47b3-a53e-600cf5a719ad_04-18-week4-FAILING_AND_PASSING,7,0,4,0,1,2,0,22,178,3,25,579,8,0,829
371446918,B3Partners/brmo,05/09/18 07:29,spirals-bears,e1e687d4-f849-47b3-a53e-600cf5a719ad_04-18-week4-FAILING_AND_PASSING,154,66,77,0,3,0,0,300
371446926,B3Partners/brmo,05/09/18 07:32,spirals-bears,e1e687d4-f849-47b3-a53e-600cf5a719ad_04-18-week4-FAILING_AND_PASSING,151,54,72,0,4,0,0,281
372645082,jnidzwetzki/bboxdb,05/09/18 07:32,spirals-bears,e1e687d4-f849-47b3-a53e-600cf5a719ad_04-18-week4-FAILING_AND_PASSING,4,0,0,0,0,1,0,35,15,0,35,86,8,0,184
371252744,MariaDB/mariadb-connector-j,05/09/18 07:54,spirals-bears,e1e687d4-f849-47b3-a53e-600cf5a719ad_04-18-week4-FAILING_AND_PASSING,10,0,0,0,0,1,0,1817,32,0,1820,56,10,0,3746
