371831155,apache/flink,05/09/18 13:05,spirals-bears,7f781b86-edd9-4c2c-8d35-0759e20819d2_04-18-week4-PASSING_AND_PASSING,69,5,74
372367394,apache/flink,05/09/18 13:05,spirals-bears,7f781b86-edd9-4c2c-8d35-0759e20819d2_04-18-week4-PASSING_AND_PASSING,63,0,2,7,10,82
366456016,apache/flink,05/09/18 13:06,spirals-bears,7f781b86-edd9-4c2c-8d35-0759e20819d2_04-18-week4-PASSING_AND_PASSING,118,7,125
372016498,apache/flink,05/09/18 13:06,spirals-bears,7f781b86-edd9-4c2c-8d35-0759e20819d2_04-18-week4-PASSING_AND_PASSING,62,6,68
364571033,apache/flink,05/09/18 13:08,spirals-bears,7f781b86-edd9-4c2c-8d35-0759e20819d2_04-18-week4-PASSING_AND_PASSING,61,0,1,5,10,77
372270275,apache/flink,05/09/18 13:09,spirals-bears,7f781b86-edd9-4c2c-8d35-0759e20819d2_04-18-week4-PASSING_AND_PASSING,67,0,1,7,213,12,300
371200135,apache/flink,05/09/18 13:09,spirals-bears,7f781b86-edd9-4c2c-8d35-0759e20819d2_04-18-week4-PASSING_AND_PASSING,61,6,67
372053488,apache/flink,05/09/18 13:10,spirals-bears,7f781b86-edd9-4c2c-8d35-0759e20819d2_04-18-week4-PASSING_AND_PASSING,66,0,2,1,215,3,287
367853512,apache/flink,05/09/18 13:10,spirals-bears,7f781b86-edd9-4c2c-8d35-0759e20819d2_04-18-week4-PASSING_AND_PASSING,61,6,67
371288540,apache/flink,05/09/18 13:14,spirals-bears,7f781b86-edd9-4c2c-8d35-0759e20819d2_04-18-week4-PASSING_AND_PASSING,70,0,1,1,215,2,289
367752412,apache/flink,05/09/18 13:14,spirals-bears,7f781b86-edd9-4c2c-8d35-0759e20819d2_04-18-week4-PASSING_AND_PASSING,60,0,1,8,127,12,208
369694560,apache/flink,05/09/18 13:17,spirals-bears,7f781b86-edd9-4c2c-8d35-0759e20819d2_04-18-week4-PASSING_AND_PASSING,60,0,1,8,123,10,202
367155150,apache/flink,05/09/18 13:19,spirals-bears,7f781b86-edd9-4c2c-8d35-0759e20819d2_04-18-week4-PASSING_AND_PASSING,72,0,1,5,7,85
370399236,apache/flink,05/09/18 13:32,spirals-bears,7f781b86-edd9-4c2c-8d35-0759e20819d2_04-18-week4-PASSING_AND_PASSING,111,0,2,7,904,9,1033
361683930,apache/flink,05/09/18 13:33,spirals-bears,7f781b86-edd9-4c2c-8d35-0759e20819d2_04-18-week4-PASSING_AND_PASSING,73,0,1,5,7,86
371766487,apache/flink,05/09/18 13:49,spirals-bears,7f781b86-edd9-4c2c-8d35-0759e20819d2_04-18-week4-PASSING_AND_PASSING,9,0,0,45,0,2,69,0,58,5,1,725,1,61,44,1580,2600
370457634,apache/flink,05/09/18 13:50,spirals-bears,7f781b86-edd9-4c2c-8d35-0759e20819d2_04-18-week4-PASSING_AND_PASSING,59,0,1,1,937,2,1000
355737340,apache/flink,05/09/18 13:52,spirals-bears,7f781b86-edd9-4c2c-8d35-0759e20819d2_04-18-week4-PASSING_AND_PASSING,66,0,2,6,9,83
369694134,apache/flink,05/09/18 13:54,spirals-bears,7f781b86-edd9-4c2c-8d35-0759e20819d2_04-18-week4-PASSING_AND_PASSING,59,0,1,6,7,73
371100265,apache/flink,05/09/18 13:54,spirals-bears,7f781b86-edd9-4c2c-8d35-0759e20819d2_04-18-week4-PASSING_AND_PASSING,11,0,0,54,0,1,98,0,65,3,1,710,1,61,51,1595,2651
373197078,prestodb/presto,05/09/18 13:59,spirals-bears,7f781b86-edd9-4c2c-8d35-0759e20819d2_04-18-week4-PASSING_AND_PASSING,45,0,1,1,217,1,265
373173915,prestodb/presto,05/09/18 14:04,spirals-bears,7f781b86-edd9-4c2c-8d35-0759e20819d2_04-18-week4-PASSING_AND_PASSING,44,0,2,1,202,2,251
370488268,apache/flink,05/09/18 14:04,spirals-bears,7f781b86-edd9-4c2c-8d35-0759e20819d2_04-18-week4-PASSING_AND_PASSING,7,0,5,55,0,2,107,0,42,9,6,702,6,62,43,1644,2690
371336784,prestodb/presto,05/09/18 14:06,spirals-bears,7f781b86-edd9-4c2c-8d35-0759e20819d2_04-18-week4-PASSING_AND_PASSING,47,8,55
369213109,apache/flink,05/09/18 14:07,spirals-bears,7f781b86-edd9-4c2c-8d35-0759e20819d2_04-18-week4-PASSING_AND_PASSING,81,0,1,1,914,5,1002
371825840,prestodb/presto,05/09/18 14:07,spirals-bears,7f781b86-edd9-4c2c-8d35-0759e20819d2_04-18-week4-PASSING_AND_PASSING,46,7,53
373121505,prestodb/presto,05/09/18 14:12,spirals-bears,7f781b86-edd9-4c2c-8d35-0759e20819d2_04-18-week4-PASSING_AND_PASSING,49,0,1,1,242,1,294
372473859,prestodb/presto,05/09/18 14:13,spirals-bears,7f781b86-edd9-4c2c-8d35-0759e20819d2_04-18-week4-PASSING_AND_PASSING,45,6,51
372511210,prestodb/presto,05/09/18 14:14,spirals-bears,7f781b86-edd9-4c2c-8d35-0759e20819d2_04-18-week4-PASSING_AND_PASSING,43,6,49
373201679,prestodb/presto,05/09/18 14:23,spirals-bears,7f781b86-edd9-4c2c-8d35-0759e20819d2_04-18-week4-PASSING_AND_PASSING,45,0,788,1,1,883,1,1719
372512043,prestodb/presto,05/09/18 14:27,spirals-bears,7f781b86-edd9-4c2c-8d35-0759e20819d2_04-18-week4-PASSING_AND_PASSING,42,0,1,1,706,1,751
372325493,prestodb/presto,05/09/18 14:27,spirals-bears,7f781b86-edd9-4c2c-8d35-0759e20819d2_04-18-week4-PASSING_AND_PASSING,46,0,1,1,182,2,232
365314326,prestodb/presto,05/09/18 14:28,spirals-bears,7f781b86-edd9-4c2c-8d35-0759e20819d2_04-18-week4-PASSING_AND_PASSING,43,6,49
372246664,prestodb/presto,05/09/18 14:28,spirals-bears,7f781b86-edd9-4c2c-8d35-0759e20819d2_04-18-week4-PASSING_AND_PASSING,42,4,46
371874277,prestodb/presto,05/09/18 14:29,spirals-bears,7f781b86-edd9-4c2c-8d35-0759e20819d2_04-18-week4-PASSING_AND_PASSING,48,4,52
372152532,prestodb/presto,05/09/18 14:32,spirals-bears,7f781b86-edd9-4c2c-8d35-0759e20819d2_04-18-week4-PASSING_AND_PASSING,46,0,1,1,190,1,239
363368911,prestodb/presto,05/09/18 14:33,spirals-bears,7f781b86-edd9-4c2c-8d35-0759e20819d2_04-18-week4-PASSING_AND_PASSING,41,4,45
373157179,prestodb/presto,05/09/18 14:34,spirals-bears,7f781b86-edd9-4c2c-8d35-0759e20819d2_04-18-week4-PASSING_AND_PASSING,45,0,832,2,1,930,3,1813
372085072,prestodb/presto,05/09/18 14:34,spirals-bears,7f781b86-edd9-4c2c-8d35-0759e20819d2_04-18-week4-PASSING_AND_PASSING,43,0,1,0,286,1,331
372536935,prestodb/presto,05/09/18 14:36,spirals-bears,7f781b86-edd9-4c2c-8d35-0759e20819d2_04-18-week4-PASSING_AND_PASSING,41,0,799,1,1,924,1,1767
371856904,prestodb/presto,05/09/18 14:41,spirals-bears,7f781b86-edd9-4c2c-8d35-0759e20819d2_04-18-week4-PASSING_AND_PASSING,43,0,2,1,183,1,230
371841877,prestodb/presto,05/09/18 14:43,spirals-bears,7f781b86-edd9-4c2c-8d35-0759e20819d2_04-18-week4-PASSING_AND_PASSING,43,0,1,1,61,1,107
371694532,prestodb/presto,05/09/18 14:44,spirals-bears,7f781b86-edd9-4c2c-8d35-0759e20819d2_04-18-week4-PASSING_AND_PASSING,54,8,62
370360656,prestodb/presto,05/09/18 14:45,spirals-bears,7f781b86-edd9-4c2c-8d35-0759e20819d2_04-18-week4-PASSING_AND_PASSING,43,7,50
370335248,prestodb/presto,05/09/18 14:46,spirals-bears,7f781b86-edd9-4c2c-8d35-0759e20819d2_04-18-week4-PASSING_AND_PASSING,44,18,62
371308933,prestodb/presto,05/09/18 14:47,spirals-bears,7f781b86-edd9-4c2c-8d35-0759e20819d2_04-18-week4-PASSING_AND_PASSING,48,6,54
371422170,prestodb/presto,05/09/18 14:49,spirals-bears,7f781b86-edd9-4c2c-8d35-0759e20819d2_04-18-week4-PASSING_AND_PASSING,43,5,48
370861111,prestodb/presto,05/09/18 14:50,spirals-bears,7f781b86-edd9-4c2c-8d35-0759e20819d2_04-18-week4-PASSING_AND_PASSING,53,0,2,6,13,74
371417682,prestodb/presto,05/09/18 14:51,spirals-bears,7f781b86-edd9-4c2c-8d35-0759e20819d2_04-18-week4-PASSING_AND_PASSING,51,6,57
345478972,prestodb/presto,05/09/18 14:52,spirals-bears,7f781b86-edd9-4c2c-8d35-0759e20819d2_04-18-week4-PASSING_AND_PASSING,44,4,48
371415755,prestodb/presto,05/09/18 14:53,spirals-bears,7f781b86-edd9-4c2c-8d35-0759e20819d2_04-18-week4-PASSING_AND_PASSING,43,5,48
371387529,prestodb/presto,05/09/18 14:54,spirals-bears,7f781b86-edd9-4c2c-8d35-0759e20819d2_04-18-week4-PASSING_AND_PASSING,44,4,48
371340700,prestodb/presto,05/09/18 14:55,spirals-bears,7f781b86-edd9-4c2c-8d35-0759e20819d2_04-18-week4-PASSING_AND_PASSING,59,3,62
368852020,prestodb/presto,05/09/18 14:56,spirals-bears,7f781b86-edd9-4c2c-8d35-0759e20819d2_04-18-week4-PASSING_AND_PASSING,43,4,47
371306912,prestodb/presto,05/09/18 14:57,spirals-bears,7f781b86-edd9-4c2c-8d35-0759e20819d2_04-18-week4-PASSING_AND_PASSING,42,6,48
371317725,prestodb/presto,05/09/18 14:58,spirals-bears,7f781b86-edd9-4c2c-8d35-0759e20819d2_04-18-week4-PASSING_AND_PASSING,42,4,46
371295309,prestodb/presto,05/09/18 14:59,spirals-bears,7f781b86-edd9-4c2c-8d35-0759e20819d2_04-18-week4-PASSING_AND_PASSING,44,5,49
371210276,prestodb/presto,05/09/18 15:00,spirals-bears,7f781b86-edd9-4c2c-8d35-0759e20819d2_04-18-week4-PASSING_AND_PASSING,47,6,53
368910029,prestodb/presto,05/09/18 15:01,spirals-bears,7f781b86-edd9-4c2c-8d35-0759e20819d2_04-18-week4-PASSING_AND_PASSING,42,4,46
370860374,prestodb/presto,05/09/18 15:02,spirals-bears,7f781b86-edd9-4c2c-8d35-0759e20819d2_04-18-week4-PASSING_AND_PASSING,42,6,48
372029987,prestodb/presto,05/09/18 15:02,spirals-bears,7f781b86-edd9-4c2c-8d35-0759e20819d2_04-18-week4-PASSING_AND_PASSING,41,0,822,1,0,888,2,1754
371955533,prestodb/presto,05/09/18 15:04,spirals-bears,7f781b86-edd9-4c2c-8d35-0759e20819d2_04-18-week4-PASSING_AND_PASSING,43,0,799,1,1,903,1,1748
370185910,prestodb/presto,05/09/18 15:04,spirals-bears,7f781b86-edd9-4c2c-8d35-0759e20819d2_04-18-week4-PASSING_AND_PASSING,46,6,52
371873883,prestodb/presto,05/09/18 15:04,spirals-bears,7f781b86-edd9-4c2c-8d35-0759e20819d2_04-18-week4-PASSING_AND_PASSING,43,0,804,1,1,909,1,1759
367421209,prestodb/presto,05/09/18 15:05,spirals-bears,7f781b86-edd9-4c2c-8d35-0759e20819d2_04-18-week4-PASSING_AND_PASSING,44,6,50
370851002,prestodb/presto,05/09/18 15:08,spirals-bears,7f781b86-edd9-4c2c-8d35-0759e20819d2_04-18-week4-PASSING_AND_PASSING,45,0,1,1,196,1,244
370837568,prestodb/presto,05/09/18 15:09,spirals-bears,7f781b86-edd9-4c2c-8d35-0759e20819d2_04-18-week4-PASSING_AND_PASSING,43,0,1,1,204,1,250
370827936,prestodb/presto,05/09/18 15:12,spirals-bears,7f781b86-edd9-4c2c-8d35-0759e20819d2_04-18-week4-PASSING_AND_PASSING,46,0,2,0,194,2,244
370886273,prestodb/presto,05/09/18 15:31,spirals-bears,7f781b86-edd9-4c2c-8d35-0759e20819d2_04-18-week4-PASSING_AND_PASSING,42,0,801,1,1,878,2,1725
370759182,prestodb/presto,05/09/18 15:32,spirals-bears,7f781b86-edd9-4c2c-8d35-0759e20819d2_04-18-week4-PASSING_AND_PASSING,43,6,49
370757307,prestodb/presto,05/09/18 15:33,spirals-bears,7f781b86-edd9-4c2c-8d35-0759e20819d2_04-18-week4-PASSING_AND_PASSING,43,5,48
370263909,prestodb/presto,05/09/18 15:34,spirals-bears,7f781b86-edd9-4c2c-8d35-0759e20819d2_04-18-week4-PASSING_AND_PASSING,42,0,1,5,9,57
370837411,prestodb/presto,05/09/18 15:35,spirals-bears,7f781b86-edd9-4c2c-8d35-0759e20819d2_04-18-week4-PASSING_AND_PASSING,43,0,818,2,1,911,2,1777
370210134,prestodb/presto,05/09/18 15:35,spirals-bears,7f781b86-edd9-4c2c-8d35-0759e20819d2_04-18-week4-PASSING_AND_PASSING,41,4,45
370334495,prestodb/presto,05/09/18 15:36,spirals-bears,7f781b86-edd9-4c2c-8d35-0759e20819d2_04-18-week4-PASSING_AND_PASSING,43,9,52
370252445,prestodb/presto,05/09/18 15:36,spirals-bears,7f781b86-edd9-4c2c-8d35-0759e20819d2_04-18-week4-PASSING_AND_PASSING,44,5,49
370316470,prestodb/presto,05/09/18 15:37,spirals-bears,7f781b86-edd9-4c2c-8d35-0759e20819d2_04-18-week4-PASSING_AND_PASSING,48,6,54
369261268,prestodb/presto,05/09/18 15:38,spirals-bears,7f781b86-edd9-4c2c-8d35-0759e20819d2_04-18-week4-PASSING_AND_PASSING,63,8,71
370168204,prestodb/presto,05/09/18 15:39,spirals-bears,7f781b86-edd9-4c2c-8d35-0759e20819d2_04-18-week4-PASSING_AND_PASSING,41,5,46
370786852,prestodb/presto,05/09/18 15:39,spirals-bears,7f781b86-edd9-4c2c-8d35-0759e20819d2_04-18-week4-PASSING_AND_PASSING,43,0,822,2,0,957,2,1826
370210921,prestodb/presto,05/09/18 15:40,spirals-bears,7f781b86-edd9-4c2c-8d35-0759e20819d2_04-18-week4-PASSING_AND_PASSING,45,5,50
369294761,prestodb/presto,05/09/18 15:40,spirals-bears,7f781b86-edd9-4c2c-8d35-0759e20819d2_04-18-week4-PASSING_AND_PASSING,44,4,48
373130363,apache/incubator-druid,05/09/18 15:41,spirals-bears,7f781b86-edd9-4c2c-8d35-0759e20819d2_04-18-week4-PASSING_AND_PASSING,35,5,40
369495471,prestodb/presto,05/09/18 15:41,spirals-bears,7f781b86-edd9-4c2c-8d35-0759e20819d2_04-18-week4-PASSING_AND_PASSING,45,5,50
371664499,apache/incubator-druid,05/09/18 15:42,spirals-bears,7f781b86-edd9-4c2c-8d35-0759e20819d2_04-18-week4-PASSING_AND_PASSING,39,5,44
370767407,prestodb/presto,05/09/18 15:43,spirals-bears,7f781b86-edd9-4c2c-8d35-0759e20819d2_04-18-week4-PASSING_AND_PASSING,43,0,795,2,1,981,1,1823
372876570,apache/incubator-druid,05/09/18 15:46,spirals-bears,7f781b86-edd9-4c2c-8d35-0759e20819d2_04-18-week4-PASSING_AND_PASSING,41,0,1,1,263,3,309
371758059,apache/incubator-druid,05/09/18 15:47,spirals-bears,7f781b86-edd9-4c2c-8d35-0759e20819d2_04-18-week4-PASSING_AND_PASSING,43,0,1,1,191,3,239
363999195,apache/incubator-druid,05/09/18 15:47,spirals-bears,7f781b86-edd9-4c2c-8d35-0759e20819d2_04-18-week4-PASSING_AND_PASSING,44,4,48
371149514,apache/incubator-druid,05/09/18 15:48,spirals-bears,7f781b86-edd9-4c2c-8d35-0759e20819d2_04-18-week4-PASSING_AND_PASSING,46,5,51
371349569,apache/incubator-druid,05/09/18 15:53,spirals-bears,7f781b86-edd9-4c2c-8d35-0759e20819d2_04-18-week4-PASSING_AND_PASSING,51,0,1,9,271,12,344
370411100,apache/incubator-druid,05/09/18 15:58,spirals-bears,7f781b86-edd9-4c2c-8d35-0759e20819d2_04-18-week4-PASSING_AND_PASSING,36,0,1,8,192,16,253
370666637,apache/incubator-druid,05/09/18 16:01,spirals-bears,7f781b86-edd9-4c2c-8d35-0759e20819d2_04-18-week4-PASSING_AND_PASSING,54,0,1,7,128,13,203
371736653,apache/incubator-druid,05/09/18 16:03,spirals-bears,7f781b86-edd9-4c2c-8d35-0759e20819d2_04-18-week4-PASSING_AND_PASSING,59,0,1,0,797,2,859
370159506,prestodb/presto,05/09/18 16:05,spirals-bears,7f781b86-edd9-4c2c-8d35-0759e20819d2_04-18-week4-PASSING_AND_PASSING,42,0,799,1,0,854,2,1698
370259074,apache/incubator-druid,05/09/18 16:05,spirals-bears,7f781b86-edd9-4c2c-8d35-0759e20819d2_04-18-week4-PASSING_AND_PASSING,35,0,1,1,190,2,229
367279340,apache/incubator-druid,05/09/18 16:05,spirals-bears,7f781b86-edd9-4c2c-8d35-0759e20819d2_04-18-week4-PASSING_AND_PASSING,36,4,40
371109840,thelastpickle/cassandra-reaper,05/09/18 16:06,spirals-bears,7f781b86-edd9-4c2c-8d35-0759e20819d2_04-18-week4-PASSING_AND_PASSING,8,0,8
371109871,thelastpickle/cassandra-reaper,05/09/18 16:06,spirals-bears,7f781b86-edd9-4c2c-8d35-0759e20819d2_04-18-week4-PASSING_AND_PASSING,7,3,10
372412358,thelastpickle/cassandra-reaper,05/09/18 16:06,spirals-bears,7f781b86-edd9-4c2c-8d35-0759e20819d2_04-18-week4-PASSING_AND_PASSING,7,3,10
369982015,thelastpickle/cassandra-reaper,05/09/18 16:07,spirals-bears,7f781b86-edd9-4c2c-8d35-0759e20819d2_04-18-week4-PASSING_AND_PASSING,8,0,0,0,51,0,59
372412340,thelastpickle/cassandra-reaper,05/09/18 16:07,spirals-bears,7f781b86-edd9-4c2c-8d35-0759e20819d2_04-18-week4-PASSING_AND_PASSING,8,0,8
369513727,thelastpickle/cassandra-reaper,05/09/18 16:07,spirals-bears,7f781b86-edd9-4c2c-8d35-0759e20819d2_04-18-week4-PASSING_AND_PASSING,8,0,8
369503397,JMRI/JMRI,05/09/18 16:35,spirals-bears,7f781b86-edd9-4c2c-8d35-0759e20819d2_04-18-week4-PASSING_AND_PASSING,382,0,1160,0,11,112,36,1701
369861940,JMRI/JMRI,05/09/18 16:36,spirals-bears,7f781b86-edd9-4c2c-8d35-0759e20819d2_04-18-week4-PASSING_AND_PASSING,371,0,1171,0,12,113,34,1701
371573088,apache/nifi,05/09/18 16:37,spirals-bears,7f781b86-edd9-4c2c-8d35-0759e20819d2_04-18-week4-PASSING_AND_PASSING,52,5,57
372085958,apache/nifi,05/09/18 16:37,spirals-bears,7f781b86-edd9-4c2c-8d35-0759e20819d2_04-18-week4-PASSING_AND_PASSING,37,7,44
372103405,apache/nifi,05/09/18 16:38,spirals-bears,7f781b86-edd9-4c2c-8d35-0759e20819d2_04-18-week4-PASSING_AND_PASSING,34,9,43
372172177,apache/nifi,05/09/18 16:45,spirals-bears,7f781b86-edd9-4c2c-8d35-0759e20819d2_04-18-week4-PASSING_AND_PASSING,38,1,3,9,457,8,516
372157263,apache/nifi,05/09/18 16:46,spirals-bears,7f781b86-edd9-4c2c-8d35-0759e20819d2_04-18-week4-PASSING_AND_PASSING,36,1,4,8,449,7,505
371030056,apache/nifi,05/09/18 16:48,spirals-bears,7f781b86-edd9-4c2c-8d35-0759e20819d2_04-18-week4-PASSING_AND_PASSING,37,21,58
370636478,apache/nifi,05/09/18 16:50,spirals-bears,7f781b86-edd9-4c2c-8d35-0759e20819d2_04-18-week4-PASSING_AND_PASSING,53,5,58
371246759,apache/nifi,05/09/18 16:51,spirals-bears,7f781b86-edd9-4c2c-8d35-0759e20819d2_04-18-week4-PASSING_AND_PASSING,35,4,39
372124773,apache/nifi,05/09/18 16:56,spirals-bears,7f781b86-edd9-4c2c-8d35-0759e20819d2_04-18-week4-PASSING_AND_PASSING,40,2,5,10,557,11,625
372284199,apache/incubator-druid,05/09/18 17:02,spirals-bears,7f781b86-edd9-4c2c-8d35-0759e20819d2_04-18-week4-PASSING_AND_PASSING,9,0,1,1588,0,1,47,0,1512,1,3,587,0,36,20,946,4751
364687877,apache/nifi,05/09/18 17:03,spirals-bears,7f781b86-edd9-4c2c-8d35-0759e20819d2_04-18-week4-PASSING_AND_PASSING,53,5,58
353699141,apache/nifi,05/09/18 17:04,spirals-bears,7f781b86-edd9-4c2c-8d35-0759e20819d2_04-18-week4-PASSING_AND_PASSING,40,1,3,6,10,60
364571624,apache/nifi,05/09/18 17:06,spirals-bears,7f781b86-edd9-4c2c-8d35-0759e20819d2_04-18-week4-PASSING_AND_PASSING,91,12,103
371137823,apache/nifi,05/09/18 17:12,spirals-bears,7f781b86-edd9-4c2c-8d35-0759e20819d2_04-18-week4-PASSING_AND_PASSING,39,1,3,1,874,3,921
357271461,apache/nifi,05/09/18 17:13,spirals-bears,7f781b86-edd9-4c2c-8d35-0759e20819d2_04-18-week4-PASSING_AND_PASSING,35,1,3,6,12,57
370258717,apache/nifi,05/09/18 17:16,spirals-bears,7f781b86-edd9-4c2c-8d35-0759e20819d2_04-18-week4-PASSING_AND_PASSING,45,1,3,1,482,4,536
371251705,apache/nifi,05/09/18 17:18,spirals-bears,7f781b86-edd9-4c2c-8d35-0759e20819d2_04-18-week4-PASSING_AND_PASSING,35,1,3,1,1618,1,1659
370258073,apache/incubator-druid,05/09/18 17:19,spirals-bears,7f781b86-edd9-4c2c-8d35-0759e20819d2_04-18-week4-PASSING_AND_PASSING,10,0,1,1485,1,1,53,0,1396,2,3,493,0,35,18,1030,4528
357493416,apache/nifi,05/09/18 17:20,spirals-bears,7f781b86-edd9-4c2c-8d35-0759e20819d2_04-18-week4-PASSING_AND_PASSING,38,2,4,6,7,57
370062844,apache/nifi,05/09/18 17:21,spirals-bears,7f781b86-edd9-4c2c-8d35-0759e20819d2_04-18-week4-PASSING_AND_PASSING,37,7,44
369290866,apache/nifi,05/09/18 17:22,spirals-bears,7f781b86-edd9-4c2c-8d35-0759e20819d2_04-18-week4-PASSING_AND_PASSING,35,5,40
370127702,apache/nifi,05/09/18 17:25,spirals-bears,7f781b86-edd9-4c2c-8d35-0759e20819d2_04-18-week4-PASSING_AND_PASSING,36,1,3,1,496,1,538
359699350,apache/nifi,05/09/18 17:26,spirals-bears,7f781b86-edd9-4c2c-8d35-0759e20819d2_04-18-week4-PASSING_AND_PASSING,38,2,6,8,164,9,227
370235744,apache/nifi,05/09/18 17:28,spirals-bears,7f781b86-edd9-4c2c-8d35-0759e20819d2_04-18-week4-PASSING_AND_PASSING,33,1,3,1,857,1,896
370043934,apache/nifi,05/09/18 17:42,spirals-bears,7f781b86-edd9-4c2c-8d35-0759e20819d2_04-18-week4-PASSING_AND_PASSING,40,1,4,1,1315,2,1363
372144380,EnMasseProject/enmasse,05/09/18 17:42,spirals-bears,7f781b86-edd9-4c2c-8d35-0759e20819d2_04-18-week4-PASSING_AND_PASSING,27,3,30
370558929,INRIA/spoon,05/09/18 17:46,spirals-bears,7f781b86-edd9-4c2c-8d35-0759e20819d2_04-18-week4-PASSING_AND_PASSING,7,0,0,552,0,0,4,0,569,0,0,20,0,10,3,70,1235
370122057,INRIA/spoon,05/09/18 17:46,spirals-bears,7f781b86-edd9-4c2c-8d35-0759e20819d2_04-18-week4-PASSING_AND_PASSING,7,0,0,538,0,0,4,0,561,0,0,21,0,9,4,62,1206
372900360,EnMasseProject/enmasse,05/09/18 17:46,spirals-bears,7f781b86-edd9-4c2c-8d35-0759e20819d2_04-18-week4-PASSING_AND_PASSING,26,0,94,1,1,101,0,0,223
371914184,EnMasseProject/enmasse,05/09/18 17:47,spirals-bears,7f781b86-edd9-4c2c-8d35-0759e20819d2_04-18-week4-PASSING_AND_PASSING,26,2,28
371914150,EnMasseProject/enmasse,05/09/18 17:48,spirals-bears,7f781b86-edd9-4c2c-8d35-0759e20819d2_04-18-week4-PASSING_AND_PASSING,28,0,28
371905191,EnMasseProject/enmasse,05/09/18 17:48,spirals-bears,7f781b86-edd9-4c2c-8d35-0759e20819d2_04-18-week4-PASSING_AND_PASSING,28,0,2,1,84,1,116
371891657,EnMasseProject/enmasse,05/09/18 17:48,spirals-bears,7f781b86-edd9-4c2c-8d35-0759e20819d2_04-18-week4-PASSING_AND_PASSING,28,3,31
367805071,INRIA/spoon,05/09/18 17:48,spirals-bears,7f781b86-edd9-4c2c-8d35-0759e20819d2_04-18-week4-PASSING_AND_PASSING,8,0,0,533,0,0,5,0,561,0,0,20,0,9,5,67,1208
371447389,EnMasseProject/enmasse,05/09/18 17:49,spirals-bears,7f781b86-edd9-4c2c-8d35-0759e20819d2_04-18-week4-PASSING_AND_PASSING,28,0,28
371499013,EnMasseProject/enmasse,05/09/18 17:49,spirals-bears,7f781b86-edd9-4c2c-8d35-0759e20819d2_04-18-week4-PASSING_AND_PASSING,34,0,34
371058815,EnMasseProject/enmasse,05/09/18 17:49,spirals-bears,7f781b86-edd9-4c2c-8d35-0759e20819d2_04-18-week4-PASSING_AND_PASSING,31,0,31
370905144,EnMasseProject/enmasse,05/09/18 17:50,spirals-bears,7f781b86-edd9-4c2c-8d35-0759e20819d2_04-18-week4-PASSING_AND_PASSING,34,3,37
370894184,EnMasseProject/enmasse,05/09/18 17:50,spirals-bears,7f781b86-edd9-4c2c-8d35-0759e20819d2_04-18-week4-PASSING_AND_PASSING,36,0,36
370611489,EnMasseProject/enmasse,05/09/18 17:50,spirals-bears,7f781b86-edd9-4c2c-8d35-0759e20819d2_04-18-week4-PASSING_AND_PASSING,30,0,30
370053370,EnMasseProject/enmasse,05/09/18 17:51,spirals-bears,7f781b86-edd9-4c2c-8d35-0759e20819d2_04-18-week4-PASSING_AND_PASSING,28,3,31
370925881,EnMasseProject/enmasse,05/09/18 17:52,spirals-bears,7f781b86-edd9-4c2c-8d35-0759e20819d2_04-18-week4-PASSING_AND_PASSING,33,0,2,1,102,1,139
358321117,EnMasseProject/enmasse,05/09/18 17:52,spirals-bears,7f781b86-edd9-4c2c-8d35-0759e20819d2_04-18-week4-PASSING_AND_PASSING,28,0,28
358321249,EnMasseProject/enmasse,05/09/18 17:52,spirals-bears,7f781b86-edd9-4c2c-8d35-0759e20819d2_04-18-week4-PASSING_AND_PASSING,29,3,32
370041623,EnMasseProject/enmasse,05/09/18 17:52,spirals-bears,7f781b86-edd9-4c2c-8d35-0759e20819d2_04-18-week4-PASSING_AND_PASSING,28,3,31
370030355,EnMasseProject/enmasse,05/09/18 17:53,spirals-bears,7f781b86-edd9-4c2c-8d35-0759e20819d2_04-18-week4-PASSING_AND_PASSING,34,3,37
372120547,EnMasseProject/enmasse,05/09/18 17:53,spirals-bears,7f781b86-edd9-4c2c-8d35-0759e20819d2_04-18-week4-PASSING_AND_PASSING,7,15,0,0,10,62,0,2,13,0,106,0,0,0,53,0,27,14,16,107,432
370004852,EnMasseProject/enmasse,05/09/18 17:53,spirals-bears,7f781b86-edd9-4c2c-8d35-0759e20819d2_04-18-week4-PASSING_AND_PASSING,33,3,36
369115265,EnMasseProject/enmasse,05/09/18 17:54,spirals-bears,7f781b86-edd9-4c2c-8d35-0759e20819d2_04-18-week4-PASSING_AND_PASSING,28,3,31
369989964,EnMasseProject/enmasse,05/09/18 17:54,spirals-bears,7f781b86-edd9-4c2c-8d35-0759e20819d2_04-18-week4-PASSING_AND_PASSING,29,3,32
369115110,EnMasseProject/enmasse,05/09/18 17:54,spirals-bears,7f781b86-edd9-4c2c-8d35-0759e20819d2_04-18-week4-PASSING_AND_PASSING,30,0,30
369983642,EnMasseProject/enmasse,05/09/18 17:54,spirals-bears,7f781b86-edd9-4c2c-8d35-0759e20819d2_04-18-week4-PASSING_AND_PASSING,29,3,32
370438635,EnMasseProject/enmasse,05/09/18 17:55,spirals-bears,7f781b86-edd9-4c2c-8d35-0759e20819d2_04-18-week4-PASSING_AND_PASSING,31,0,114,1,1,115,0,1,263
373155225,batfish/batfish,05/09/18 17:55,spirals-bears,7f781b86-edd9-4c2c-8d35-0759e20819d2_04-18-week4-PASSING_AND_PASSING,52,3,55
373113212,batfish/batfish,05/09/18 17:56,spirals-bears,7f781b86-edd9-4c2c-8d35-0759e20819d2_04-18-week4-PASSING_AND_PASSING,53,0,53
369979543,EnMasseProject/enmasse,05/09/18 17:56,spirals-bears,7f781b86-edd9-4c2c-8d35-0759e20819d2_04-18-week4-PASSING_AND_PASSING,34,0,1,1,85,1,122
371468439,batfish/batfish,05/09/18 17:57,spirals-bears,7f781b86-edd9-4c2c-8d35-0759e20819d2_04-18-week4-PASSING_AND_PASSING,53,4,57
373175986,batfish/batfish,05/09/18 17:57,spirals-bears,7f781b86-edd9-4c2c-8d35-0759e20819d2_04-18-week4-PASSING_AND_PASSING,81,4,85
371468421,batfish/batfish,05/09/18 17:57,spirals-bears,7f781b86-edd9-4c2c-8d35-0759e20819d2_04-18-week4-PASSING_AND_PASSING,54,0,2,0,1,57
373156190,batfish/batfish,05/09/18 17:58,spirals-bears,7f781b86-edd9-4c2c-8d35-0759e20819d2_04-18-week4-PASSING_AND_PASSING,51,0,51
373175974,batfish/batfish,05/09/18 17:58,spirals-bears,7f781b86-edd9-4c2c-8d35-0759e20819d2_04-18-week4-PASSING_AND_PASSING,60,0,60
373215691,batfish/batfish,05/09/18 17:58,spirals-bears,7f781b86-edd9-4c2c-8d35-0759e20819d2_04-18-week4-PASSING_AND_PASSING,50,0,7,2,1,159,0,1,220
372573136,batfish/batfish,05/09/18 17:59,spirals-bears,7f781b86-edd9-4c2c-8d35-0759e20819d2_04-18-week4-PASSING_AND_PASSING,55,4,59
372566101,batfish/batfish,05/09/18 17:59,spirals-bears,7f781b86-edd9-4c2c-8d35-0759e20819d2_04-18-week4-PASSING_AND_PASSING,59,0,59
372271664,batfish/batfish,05/09/18 18:00,spirals-bears,7f781b86-edd9-4c2c-8d35-0759e20819d2_04-18-week4-PASSING_AND_PASSING,55,6,61
370849875,batfish/batfish,05/09/18 18:00,spirals-bears,7f781b86-edd9-4c2c-8d35-0759e20819d2_04-18-week4-PASSING_AND_PASSING,54,6,60
373155330,batfish/batfish,05/09/18 18:00,spirals-bears,7f781b86-edd9-4c2c-8d35-0759e20819d2_04-18-week4-PASSING_AND_PASSING,59,0,1,0,46,2,108
372511336,batfish/batfish,05/09/18 18:00,spirals-bears,7f781b86-edd9-4c2c-8d35-0759e20819d2_04-18-week4-PASSING_AND_PASSING,53,0,53
372279901,batfish/batfish,05/09/18 18:01,spirals-bears,7f781b86-edd9-4c2c-8d35-0759e20819d2_04-18-week4-PASSING_AND_PASSING,62,3,65
372563817,batfish/batfish,05/09/18 18:01,spirals-bears,7f781b86-edd9-4c2c-8d35-0759e20819d2_04-18-week4-PASSING_AND_PASSING,52,0,52
372564413,batfish/batfish,05/09/18 18:02,spirals-bears,7f781b86-edd9-4c2c-8d35-0759e20819d2_04-18-week4-PASSING_AND_PASSING,51,0,0,0,51,1,103
372522193,batfish/batfish,05/09/18 18:02,spirals-bears,7f781b86-edd9-4c2c-8d35-0759e20819d2_04-18-week4-PASSING_AND_PASSING,51,0,51
327828714,batfish/batfish,05/09/18 18:02,spirals-bears,7f781b86-edd9-4c2c-8d35-0759e20819d2_04-18-week4-PASSING_AND_PASSING,51,0,51
370849864,batfish/batfish,05/09/18 18:03,spirals-bears,7f781b86-edd9-4c2c-8d35-0759e20819d2_04-18-week4-PASSING_AND_PASSING,57,0,57
372200106,batfish/batfish,05/09/18 18:03,spirals-bears,7f781b86-edd9-4c2c-8d35-0759e20819d2_04-18-week4-PASSING_AND_PASSING,48,0,48
373112706,batfish/batfish,05/09/18 18:04,spirals-bears,7f781b86-edd9-4c2c-8d35-0759e20819d2_04-18-week4-PASSING_AND_PASSING,68,0,8,2,0,156,0,2,236
372204130,batfish/batfish,05/09/18 18:04,spirals-bears,7f781b86-edd9-4c2c-8d35-0759e20819d2_04-18-week4-PASSING_AND_PASSING,53,3,56
372250368,batfish/batfish,05/09/18 18:04,spirals-bears,7f781b86-edd9-4c2c-8d35-0759e20819d2_04-18-week4-PASSING_AND_PASSING,49,0,1,0,48,2,100
372265252,batfish/batfish,05/09/18 18:04,spirals-bears,7f781b86-edd9-4c2c-8d35-0759e20819d2_04-18-week4-PASSING_AND_PASSING,52,2,54
372141250,batfish/batfish,05/09/18 18:05,spirals-bears,7f781b86-edd9-4c2c-8d35-0759e20819d2_04-18-week4-PASSING_AND_PASSING,52,0,52
372212306,batfish/batfish,05/09/18 18:05,spirals-bears,7f781b86-edd9-4c2c-8d35-0759e20819d2_04-18-week4-PASSING_AND_PASSING,54,0,54
372141275,batfish/batfish,05/09/18 18:05,spirals-bears,7f781b86-edd9-4c2c-8d35-0759e20819d2_04-18-week4-PASSING_AND_PASSING,59,4,63
372265227,batfish/batfish,05/09/18 18:06,spirals-bears,7f781b86-edd9-4c2c-8d35-0759e20819d2_04-18-week4-PASSING_AND_PASSING,89,0,89
372139914,batfish/batfish,05/09/18 18:06,spirals-bears,7f781b86-edd9-4c2c-8d35-0759e20819d2_04-18-week4-PASSING_AND_PASSING,52,2,54
372139871,batfish/batfish,05/09/18 18:06,spirals-bears,7f781b86-edd9-4c2c-8d35-0759e20819d2_04-18-week4-PASSING_AND_PASSING,61,0,61
371336870,batfish/batfish,05/09/18 18:07,spirals-bears,7f781b86-edd9-4c2c-8d35-0759e20819d2_04-18-week4-PASSING_AND_PASSING,50,0,50
371431495,batfish/batfish,05/09/18 18:07,spirals-bears,7f781b86-edd9-4c2c-8d35-0759e20819d2_04-18-week4-PASSING_AND_PASSING,58,0,58
371435950,batfish/batfish,05/09/18 18:08,spirals-bears,7f781b86-edd9-4c2c-8d35-0759e20819d2_04-18-week4-PASSING_AND_PASSING,54,5,59
371342657,batfish/batfish,05/09/18 18:09,spirals-bears,7f781b86-edd9-4c2c-8d35-0759e20819d2_04-18-week4-PASSING_AND_PASSING,54,0,54
371446188,batfish/batfish,05/09/18 18:09,spirals-bears,7f781b86-edd9-4c2c-8d35-0759e20819d2_04-18-week4-PASSING_AND_PASSING,81,0,1,0,118,2,202
371413879,batfish/batfish,05/09/18 18:10,spirals-bears,7f781b86-edd9-4c2c-8d35-0759e20819d2_04-18-week4-PASSING_AND_PASSING,58,0,1,1,53,2,115
371342663,batfish/batfish,05/09/18 18:10,spirals-bears,7f781b86-edd9-4c2c-8d35-0759e20819d2_04-18-week4-PASSING_AND_PASSING,59,5,64
371351743,batfish/batfish,05/09/18 18:10,spirals-bears,7f781b86-edd9-4c2c-8d35-0759e20819d2_04-18-week4-PASSING_AND_PASSING,62,0,62
371445264,batfish/batfish,05/09/18 18:10,spirals-bears,7f781b86-edd9-4c2c-8d35-0759e20819d2_04-18-week4-PASSING_AND_PASSING,52,0,7,1,0,159,0,1,220
371351770,batfish/batfish,05/09/18 18:11,spirals-bears,7f781b86-edd9-4c2c-8d35-0759e20819d2_04-18-week4-PASSING_AND_PASSING,50,4,54
371375743,batfish/batfish,05/09/18 18:11,spirals-bears,7f781b86-edd9-4c2c-8d35-0759e20819d2_04-18-week4-PASSING_AND_PASSING,55,0,55
371376142,batfish/batfish,05/09/18 18:11,spirals-bears,7f781b86-edd9-4c2c-8d35-0759e20819d2_04-18-week4-PASSING_AND_PASSING,53,4,57
371340720,batfish/batfish,05/09/18 18:11,spirals-bears,7f781b86-edd9-4c2c-8d35-0759e20819d2_04-18-week4-PASSING_AND_PASSING,49,0,49
371340725,batfish/batfish,05/09/18 18:12,spirals-bears,7f781b86-edd9-4c2c-8d35-0759e20819d2_04-18-week4-PASSING_AND_PASSING,50,4,54
371332121,batfish/batfish,05/09/18 18:12,spirals-bears,7f781b86-edd9-4c2c-8d35-0759e20819d2_04-18-week4-PASSING_AND_PASSING,50,0,50
371332152,batfish/batfish,05/09/18 18:12,spirals-bears,7f781b86-edd9-4c2c-8d35-0759e20819d2_04-18-week4-PASSING_AND_PASSING,57,2,59
370849444,batfish/batfish,05/09/18 18:13,spirals-bears,7f781b86-edd9-4c2c-8d35-0759e20819d2_04-18-week4-PASSING_AND_PASSING,52,4,56
371215372,batfish/batfish,05/09/18 18:13,spirals-bears,7f781b86-edd9-4c2c-8d35-0759e20819d2_04-18-week4-PASSING_AND_PASSING,52,3,55
370848584,batfish/batfish,05/09/18 18:13,spirals-bears,7f781b86-edd9-4c2c-8d35-0759e20819d2_04-18-week4-PASSING_AND_PASSING,51,0,51
370679616,batfish/batfish,05/09/18 18:14,spirals-bears,7f781b86-edd9-4c2c-8d35-0759e20819d2_04-18-week4-PASSING_AND_PASSING,51,0,51
370679663,batfish/batfish,05/09/18 18:14,spirals-bears,7f781b86-edd9-4c2c-8d35-0759e20819d2_04-18-week4-PASSING_AND_PASSING,50,4,54
370431658,batfish/batfish,05/09/18 18:15,spirals-bears,7f781b86-edd9-4c2c-8d35-0759e20819d2_04-18-week4-PASSING_AND_PASSING,49,0,49
370366740,batfish/batfish,05/09/18 18:16,spirals-bears,7f781b86-edd9-4c2c-8d35-0759e20819d2_04-18-week4-PASSING_AND_PASSING,51,0,51
370803533,batfish/batfish,05/09/18 18:16,spirals-bears,7f781b86-edd9-4c2c-8d35-0759e20819d2_04-18-week4-PASSING_AND_PASSING,50,0,8,0,0,163,0,2,223
370780364,batfish/batfish,05/09/18 18:16,spirals-bears,7f781b86-edd9-4c2c-8d35-0759e20819d2_04-18-week4-PASSING_AND_PASSING,53,0,1,0,114,1,169
370774365,batfish/batfish,05/09/18 18:17,spirals-bears,7f781b86-edd9-4c2c-8d35-0759e20819d2_04-18-week4-PASSING_AND_PASSING,52,0,7,1,0,153,0,1,214
369794828,batfish/batfish,05/09/18 18:18,spirals-bears,7f781b86-edd9-4c2c-8d35-0759e20819d2_04-18-week4-PASSING_AND_PASSING,50,0,1,0,50,2,103
370351629,batfish/batfish,05/09/18 18:19,spirals-bears,7f781b86-edd9-4c2c-8d35-0759e20819d2_04-18-week4-PASSING_AND_PASSING,72,0,1,0,125,1,199
369415555,batfish/batfish,05/09/18 18:20,spirals-bears,7f781b86-edd9-4c2c-8d35-0759e20819d2_04-18-week4-PASSING_AND_PASSING,55,0,9,1,0,159,0,2,226
369810735,matsim-org/matsim,05/09/18 18:21,spirals-bears,7f781b86-edd9-4c2c-8d35-0759e20819d2_04-18-week4-PASSING_AND_PASSING,161,0,1,1,69,1,233
369085642,apache/incubator-servicecomb-java-chassis,05/09/18 18:22,spirals-bears,7f781b86-edd9-4c2c-8d35-0759e20819d2_04-18-week4-PASSING_AND_PASSING,9,4,13
369750365,matsim-org/matsim,05/09/18 18:22,spirals-bears,7f781b86-edd9-4c2c-8d35-0759e20819d2_04-18-week4-PASSING_AND_PASSING,163,0,1,2,72,2,240
370886133,apache/incubator-servicecomb-java-chassis,05/09/18 18:23,spirals-bears,7f781b86-edd9-4c2c-8d35-0759e20819d2_04-18-week4-PASSING_AND_PASSING,10,1,5,8,5,29
371900349,apache/incubator-servicecomb-java-chassis,05/09/18 18:23,spirals-bears,7f781b86-edd9-4c2c-8d35-0759e20819d2_04-18-week4-PASSING_AND_PASSING,9,0,9
371553471,apache/incubator-servicecomb-java-chassis,05/09/18 18:23,spirals-bears,7f781b86-edd9-4c2c-8d35-0759e20819d2_04-18-week4-PASSING_AND_PASSING,9,0,9
369783020,matsim-org/matsim,05/09/18 18:24,spirals-bears,7f781b86-edd9-4c2c-8d35-0759e20819d2_04-18-week4-PASSING_AND_PASSING,159,0,1,1,71,2,234
371889269,apache/incubator-servicecomb-java-chassis,05/09/18 18:24,spirals-bears,7f781b86-edd9-4c2c-8d35-0759e20819d2_04-18-week4-PASSING_AND_PASSING,9,1,5,0,41,1,57
371888646,apache/incubator-servicecomb-java-chassis,05/09/18 18:26,spirals-bears,7f781b86-edd9-4c2c-8d35-0759e20819d2_04-18-week4-PASSING_AND_PASSING,11,1,5,0,47,1,65
371362618,apache/incubator-servicecomb-java-chassis,05/09/18 18:26,spirals-bears,7f781b86-edd9-4c2c-8d35-0759e20819d2_04-18-week4-PASSING_AND_PASSING,9,0,9
371013051,apache/incubator-servicecomb-java-chassis,05/09/18 18:28,spirals-bears,7f781b86-edd9-4c2c-8d35-0759e20819d2_04-18-week4-PASSING_AND_PASSING,10,1,5,0,72,1,89
369971441,apache/incubator-servicecomb-java-chassis,05/09/18 18:28,spirals-bears,7f781b86-edd9-4c2c-8d35-0759e20819d2_04-18-week4-PASSING_AND_PASSING,8,4,12
369949525,apache/incubator-servicecomb-java-chassis,05/09/18 18:29,spirals-bears,7f781b86-edd9-4c2c-8d35-0759e20819d2_04-18-week4-PASSING_AND_PASSING,8,6,14
370007073,apache/incubator-servicecomb-java-chassis,05/09/18 18:30,spirals-bears,7f781b86-edd9-4c2c-8d35-0759e20819d2_04-18-week4-PASSING_AND_PASSING,9,1,5,0,30,1,46
371895345,apache/incubator-servicecomb-java-chassis,05/09/18 18:31,spirals-bears,7f781b86-edd9-4c2c-8d35-0759e20819d2_04-18-week4-PASSING_AND_PASSING,9,1,0,124,0,5,4,1,112,0,0,102,0,9,2,141,510
369915846,apache/incubator-servicecomb-java-chassis,05/09/18 18:33,spirals-bears,7f781b86-edd9-4c2c-8d35-0759e20819d2_04-18-week4-PASSING_AND_PASSING,9,1,5,0,85,0,100
370006943,apache/incubator-servicecomb-java-chassis,05/09/18 18:33,spirals-bears,7f781b86-edd9-4c2c-8d35-0759e20819d2_04-18-week4-PASSING_AND_PASSING,9,1,5,0,171,1,187
368036650,apache/incubator-servicecomb-java-chassis,05/09/18 18:33,spirals-bears,7f781b86-edd9-4c2c-8d35-0759e20819d2_04-18-week4-PASSING_AND_PASSING,10,4,14
365464426,apache/incubator-servicecomb-java-chassis,05/09/18 18:33,spirals-bears,7f781b86-edd9-4c2c-8d35-0759e20819d2_04-18-week4-PASSING_AND_PASSING,10,3,13
369692619,apache/incubator-servicecomb-java-chassis,05/09/18 18:34,spirals-bears,7f781b86-edd9-4c2c-8d35-0759e20819d2_04-18-week4-PASSING_AND_PASSING,11,1,5,0,31,0,48
369469079,apache/incubator-servicecomb-java-chassis,05/09/18 18:35,spirals-bears,7f781b86-edd9-4c2c-8d35-0759e20819d2_04-18-week4-PASSING_AND_PASSING,10,1,6,0,44,0,61
372231982,runelite/runelite,05/09/18 18:35,spirals-bears,7f781b86-edd9-4c2c-8d35-0759e20819d2_04-18-week4-PASSING_AND_PASSING,11,16,27
371335315,runelite/runelite,05/09/18 18:36,spirals-bears,7f781b86-edd9-4c2c-8d35-0759e20819d2_04-18-week4-PASSING_AND_PASSING,11,13,24
372856112,runelite/runelite,05/09/18 18:36,spirals-bears,7f781b86-edd9-4c2c-8d35-0759e20819d2_04-18-week4-PASSING_AND_PASSING,11,0,11
371801720,runelite/runelite,05/09/18 18:37,spirals-bears,7f781b86-edd9-4c2c-8d35-0759e20819d2_04-18-week4-PASSING_AND_PASSING,11,0,11
371738374,runelite/runelite,05/09/18 18:37,spirals-bears,7f781b86-edd9-4c2c-8d35-0759e20819d2_04-18-week4-PASSING_AND_PASSING,15,0,0,5,101,19,140
368629735,runelite/runelite,05/09/18 18:37,spirals-bears,7f781b86-edd9-4c2c-8d35-0759e20819d2_04-18-week4-PASSING_AND_PASSING,11,0,11
371750402,runelite/runelite,05/09/18 18:37,spirals-bears,7f781b86-edd9-4c2c-8d35-0759e20819d2_04-18-week4-PASSING_AND_PASSING,11,0,11
368365656,runelite/runelite,05/09/18 18:37,spirals-bears,7f781b86-edd9-4c2c-8d35-0759e20819d2_04-18-week4-PASSING_AND_PASSING,11,3,14
372231244,runelite/runelite,05/09/18 18:38,spirals-bears,7f781b86-edd9-4c2c-8d35-0759e20819d2_04-18-week4-PASSING_AND_PASSING,11,1,12
372478324,runelite/runelite,05/09/18 18:38,spirals-bears,7f781b86-edd9-4c2c-8d35-0759e20819d2_04-18-week4-PASSING_AND_PASSING,11,0,11
372228365,runelite/runelite,05/09/18 18:38,spirals-bears,7f781b86-edd9-4c2c-8d35-0759e20819d2_04-18-week4-PASSING_AND_PASSING,10,0,10
371353019,apache/incubator-servicecomb-java-chassis,05/09/18 18:39,spirals-bears,7f781b86-edd9-4c2c-8d35-0759e20819d2_04-18-week4-PASSING_AND_PASSING,10,3,1,0,7,28,0,5,4,1,400,0,0,0,160,0,10,2,2,208,841
372072104,runelite/runelite,05/09/18 18:39,spirals-bears,7f781b86-edd9-4c2c-8d35-0759e20819d2_04-18-week4-PASSING_AND_PASSING,11,15,26
372427675,runelite/runelite,05/09/18 18:39,spirals-bears,7f781b86-edd9-4c2c-8d35-0759e20819d2_04-18-week4-PASSING_AND_PASSING,13,0,13
372326196,runelite/runelite,05/09/18 18:39,spirals-bears,7f781b86-edd9-4c2c-8d35-0759e20819d2_04-18-week4-PASSING_AND_PASSING,12,0,12
372288635,runelite/runelite,05/09/18 18:40,spirals-bears,7f781b86-edd9-4c2c-8d35-0759e20819d2_04-18-week4-PASSING_AND_PASSING,12,0,12
371995908,runelite/runelite,05/09/18 18:40,spirals-bears,7f781b86-edd9-4c2c-8d35-0759e20819d2_04-18-week4-PASSING_AND_PASSING,12,0,0,6,104,15,137
372366856,runelite/runelite,05/09/18 18:40,spirals-bears,7f781b86-edd9-4c2c-8d35-0759e20819d2_04-18-week4-PASSING_AND_PASSING,11,2,13
372409351,runelite/runelite,05/09/18 18:40,spirals-bears,7f781b86-edd9-4c2c-8d35-0759e20819d2_04-18-week4-PASSING_AND_PASSING,13,17,30
372094581,runelite/runelite,05/09/18 18:40,spirals-bears,7f781b86-edd9-4c2c-8d35-0759e20819d2_04-18-week4-PASSING_AND_PASSING,12,0,12
372451834,runelite/runelite,05/09/18 18:40,spirals-bears,7f781b86-edd9-4c2c-8d35-0759e20819d2_04-18-week4-PASSING_AND_PASSING,11,0,11
371776371,runelite/runelite,05/09/18 18:40,spirals-bears,7f781b86-edd9-4c2c-8d35-0759e20819d2_04-18-week4-PASSING_AND_PASSING,11,0,11
370273679,runelite/runelite,05/09/18 18:41,spirals-bears,7f781b86-edd9-4c2c-8d35-0759e20819d2_04-18-week4-PASSING_AND_PASSING,15,0,15
370839274,runelite/runelite,05/09/18 18:41,spirals-bears,7f781b86-edd9-4c2c-8d35-0759e20819d2_04-18-week4-PASSING_AND_PASSING,12,0,12
370327170,runelite/runelite,05/09/18 18:41,spirals-bears,7f781b86-edd9-4c2c-8d35-0759e20819d2_04-18-week4-PASSING_AND_PASSING,12,0,12
367471011,runelite/runelite,05/09/18 18:41,spirals-bears,7f781b86-edd9-4c2c-8d35-0759e20819d2_04-18-week4-PASSING_AND_PASSING,11,15,26
371829382,runelite/runelite,05/09/18 18:41,spirals-bears,7f781b86-edd9-4c2c-8d35-0759e20819d2_04-18-week4-PASSING_AND_PASSING,12,0,12
369505894,runelite/runelite,05/09/18 18:41,spirals-bears,7f781b86-edd9-4c2c-8d35-0759e20819d2_04-18-week4-PASSING_AND_PASSING,11,13,24
371523387,runelite/runelite,05/09/18 18:42,spirals-bears,7f781b86-edd9-4c2c-8d35-0759e20819d2_04-18-week4-PASSING_AND_PASSING,12,0,12
371831153,runelite/runelite,05/09/18 18:42,spirals-bears,7f781b86-edd9-4c2c-8d35-0759e20819d2_04-18-week4-PASSING_AND_PASSING,11,0,0,4,20,35
371758272,runelite/runelite,05/09/18 18:42,spirals-bears,7f781b86-edd9-4c2c-8d35-0759e20819d2_04-18-week4-PASSING_AND_PASSING,13,0,13
371258133,runelite/runelite,05/09/18 18:42,spirals-bears,7f781b86-edd9-4c2c-8d35-0759e20819d2_04-18-week4-PASSING_AND_PASSING,11,0,11
371829820,runelite/runelite,05/09/18 18:43,spirals-bears,7f781b86-edd9-4c2c-8d35-0759e20819d2_04-18-week4-PASSING_AND_PASSING,11,0,11
371519703,runelite/runelite,05/09/18 18:43,spirals-bears,7f781b86-edd9-4c2c-8d35-0759e20819d2_04-18-week4-PASSING_AND_PASSING,13,15,28
371822952,runelite/runelite,05/09/18 18:43,spirals-bears,7f781b86-edd9-4c2c-8d35-0759e20819d2_04-18-week4-PASSING_AND_PASSING,10,0,10
371799241,runelite/runelite,05/09/18 18:43,spirals-bears,7f781b86-edd9-4c2c-8d35-0759e20819d2_04-18-week4-PASSING_AND_PASSING,11,13,24
371811575,runelite/runelite,05/09/18 18:44,spirals-bears,7f781b86-edd9-4c2c-8d35-0759e20819d2_04-18-week4-PASSING_AND_PASSING,12,0,12
371834171,runelite/runelite,05/09/18 18:44,spirals-bears,7f781b86-edd9-4c2c-8d35-0759e20819d2_04-18-week4-PASSING_AND_PASSING,12,0,0,5,103,15,135
371664040,runelite/runelite,05/09/18 18:44,spirals-bears,7f781b86-edd9-4c2c-8d35-0759e20819d2_04-18-week4-PASSING_AND_PASSING,11,0,11
369740761,runelite/runelite,05/09/18 18:44,spirals-bears,7f781b86-edd9-4c2c-8d35-0759e20819d2_04-18-week4-PASSING_AND_PASSING,12,0,12
368707904,runelite/runelite,05/09/18 18:44,spirals-bears,7f781b86-edd9-4c2c-8d35-0759e20819d2_04-18-week4-PASSING_AND_PASSING,11,0,11
370057622,runelite/runelite,05/09/18 18:45,spirals-bears,7f781b86-edd9-4c2c-8d35-0759e20819d2_04-18-week4-PASSING_AND_PASSING,12,0,12
370038588,runelite/runelite,05/09/18 18:45,spirals-bears,7f781b86-edd9-4c2c-8d35-0759e20819d2_04-18-week4-PASSING_AND_PASSING,13,17,30
369453975,runelite/runelite,05/09/18 18:45,spirals-bears,7f781b86-edd9-4c2c-8d35-0759e20819d2_04-18-week4-PASSING_AND_PASSING,10,14,24
371755225,runelite/runelite,05/09/18 18:45,spirals-bears,7f781b86-edd9-4c2c-8d35-0759e20819d2_04-18-week4-PASSING_AND_PASSING,11,0,0,6,103,17,137
368347166,runelite/runelite,05/09/18 18:46,spirals-bears,7f781b86-edd9-4c2c-8d35-0759e20819d2_04-18-week4-PASSING_AND_PASSING,12,0,12
369085594,runelite/runelite,05/09/18 18:46,spirals-bears,7f781b86-edd9-4c2c-8d35-0759e20819d2_04-18-week4-PASSING_AND_PASSING,11,0,11
366825550,runelite/runelite,05/09/18 18:46,spirals-bears,7f781b86-edd9-4c2c-8d35-0759e20819d2_04-18-week4-PASSING_AND_PASSING,11,0,11
369048597,matsim-org/matsim,05/09/18 18:46,spirals-bears,7f781b86-edd9-4c2c-8d35-0759e20819d2_04-18-week4-PASSING_AND_PASSING,269,0,0,1,1310,1,1581
370084262,runelite/runelite,05/09/18 18:46,spirals-bears,7f781b86-edd9-4c2c-8d35-0759e20819d2_04-18-week4-PASSING_AND_PASSING,12,0,12
370074891,runelite/runelite,05/09/18 18:46,spirals-bears,7f781b86-edd9-4c2c-8d35-0759e20819d2_04-18-week4-PASSING_AND_PASSING,12,0,2,4,15,33
370474514,runelite/runelite,05/09/18 18:46,spirals-bears,7f781b86-edd9-4c2c-8d35-0759e20819d2_04-18-week4-PASSING_AND_PASSING,14,0,14
370328459,runelite/runelite,05/09/18 18:46,spirals-bears,7f781b86-edd9-4c2c-8d35-0759e20819d2_04-18-week4-PASSING_AND_PASSING,12,0,12
369921702,runelite/runelite,05/09/18 18:47,spirals-bears,7f781b86-edd9-4c2c-8d35-0759e20819d2_04-18-week4-PASSING_AND_PASSING,11,3,14
366663873,runelite/runelite,05/09/18 18:47,spirals-bears,7f781b86-edd9-4c2c-8d35-0759e20819d2_04-18-week4-PASSING_AND_PASSING,13,1,14
369656358,runelite/runelite,05/09/18 18:47,spirals-bears,7f781b86-edd9-4c2c-8d35-0759e20819d2_04-18-week4-PASSING_AND_PASSING,13,0,13
369656560,runelite/runelite,05/09/18 18:47,spirals-bears,7f781b86-edd9-4c2c-8d35-0759e20819d2_04-18-week4-PASSING_AND_PASSING,11,0,11
369587476,runelite/runelite,05/09/18 18:47,spirals-bears,7f781b86-edd9-4c2c-8d35-0759e20819d2_04-18-week4-PASSING_AND_PASSING,12,0,12
369728843,runelite/runelite,05/09/18 18:47,spirals-bears,7f781b86-edd9-4c2c-8d35-0759e20819d2_04-18-week4-PASSING_AND_PASSING,13,0,13
370127638,runelite/runelite,05/09/18 18:47,spirals-bears,7f781b86-edd9-4c2c-8d35-0759e20819d2_04-18-week4-PASSING_AND_PASSING,11,0,11
369854050,runelite/runelite,05/09/18 18:47,spirals-bears,7f781b86-edd9-4c2c-8d35-0759e20819d2_04-18-week4-PASSING_AND_PASSING,11,0,11
370017662,runelite/runelite,05/09/18 18:47,spirals-bears,7f781b86-edd9-4c2c-8d35-0759e20819d2_04-18-week4-PASSING_AND_PASSING,13,0,13
370123689,runelite/runelite,05/09/18 18:47,spirals-bears,7f781b86-edd9-4c2c-8d35-0759e20819d2_04-18-week4-PASSING_AND_PASSING,13,0,13
369723459,runelite/runelite,05/09/18 18:48,spirals-bears,7f781b86-edd9-4c2c-8d35-0759e20819d2_04-18-week4-PASSING_AND_PASSING,12,0,1,5,16,34
369359317,runelite/runelite,05/09/18 18:48,spirals-bears,7f781b86-edd9-4c2c-8d35-0759e20819d2_04-18-week4-PASSING_AND_PASSING,17,0,17
368342505,runelite/runelite,05/09/18 18:48,spirals-bears,7f781b86-edd9-4c2c-8d35-0759e20819d2_04-18-week4-PASSING_AND_PASSING,12,0,12
356127628,runelite/runelite,05/09/18 18:48,spirals-bears,7f781b86-edd9-4c2c-8d35-0759e20819d2_04-18-week4-PASSING_AND_PASSING,12,0,0,4,17,33
367323635,runelite/runelite,05/09/18 18:48,spirals-bears,7f781b86-edd9-4c2c-8d35-0759e20819d2_04-18-week4-PASSING_AND_PASSING,13,14,27
368352572,runelite/runelite,05/09/18 18:48,spirals-bears,7f781b86-edd9-4c2c-8d35-0759e20819d2_04-18-week4-PASSING_AND_PASSING,13,0,13
366038603,runelite/runelite,05/09/18 18:49,spirals-bears,7f781b86-edd9-4c2c-8d35-0759e20819d2_04-18-week4-PASSING_AND_PASSING,13,1,14
372248910,CorfuDB/CorfuDB,05/09/18 18:53,spirals-bears,7f781b86-edd9-4c2c-8d35-0759e20819d2_04-18-week4-PASSING_AND_PASSING,279,0,279
372142639,CorfuDB/CorfuDB,05/09/18 18:53,spirals-bears,7f781b86-edd9-4c2c-8d35-0759e20819d2_04-18-week4-PASSING_AND_PASSING,287,4,291
371983329,Innovimax-SARL/mix-them,05/09/18 18:53,spirals-bears,7f781b86-edd9-4c2c-8d35-0759e20819d2_04-18-week4-PASSING_AND_PASSING,3,0,0,0,17,0,20
368917845,CorfuDB/CorfuDB,05/09/18 18:54,spirals-bears,7f781b86-edd9-4c2c-8d35-0759e20819d2_04-18-week4-PASSING_AND_PASSING,291,4,295
368850543,CorfuDB/CorfuDB,05/09/18 18:54,spirals-bears,7f781b86-edd9-4c2c-8d35-0759e20819d2_04-18-week4-PASSING_AND_PASSING,320,3,323
369597611,ChargeTimeEU/Java-OCA-OCPP,05/09/18 18:54,spirals-bears,7f781b86-edd9-4c2c-8d35-0759e20819d2_04-18-week4-PASSING_AND_PASSING,3,0,0,4,28,3,38
371380847,apache/calcite,05/09/18 18:54,spirals-bears,7f781b86-edd9-4c2c-8d35-0759e20819d2_04-18-week4-PASSING_AND_PASSING,26,4,30
370121853,apache/calcite,05/09/18 18:56,spirals-bears,7f781b86-edd9-4c2c-8d35-0759e20819d2_04-18-week4-PASSING_AND_PASSING,26,0,1,1,78,1,107
368968519,apache/calcite,05/09/18 18:56,spirals-bears,7f781b86-edd9-4c2c-8d35-0759e20819d2_04-18-week4-PASSING_AND_PASSING,34,0,0,0,78,1,113
369985465,apache/storm,05/09/18 18:57,spirals-bears,7f781b86-edd9-4c2c-8d35-0759e20819d2_04-18-week4-PASSING_AND_PASSING,58,0,2,7,7,74
371738564,apache/storm,05/09/18 18:58,spirals-bears,7f781b86-edd9-4c2c-8d35-0759e20819d2_04-18-week4-PASSING_AND_PASSING,53,16,69
370162771,apache/storm,05/09/18 18:58,spirals-bears,7f781b86-edd9-4c2c-8d35-0759e20819d2_04-18-week4-PASSING_AND_PASSING,42,3,45
368768605,apache/storm,05/09/18 19:08,spirals-bears,7f781b86-edd9-4c2c-8d35-0759e20819d2_04-18-week4-PASSING_AND_PASSING,42,0,3,8,521,9,583
371196483,apache/calcite,05/09/18 19:13,spirals-bears,7f781b86-edd9-4c2c-8d35-0759e20819d2_04-18-week4-PASSING_AND_PASSING,6,5,0,0,8,407,0,0,5,0,451,0,0,0,84,0,22,4,5,149,1146
370260137,apache/calcite,05/09/18 19:13,spirals-bears,7f781b86-edd9-4c2c-8d35-0759e20819d2_04-18-week4-PASSING_AND_PASSING,7,4,0,0,9,403,0,1,4,0,465,0,0,0,84,0,24,6,5,147,1159
373152413,apache/activemq-artemis,05/09/18 19:15,spirals-bears,7f781b86-edd9-4c2c-8d35-0759e20819d2_04-18-week4-PASSING_AND_PASSING,30,46,76
372056014,apache/activemq-artemis,05/09/18 19:20,spirals-bears,7f781b86-edd9-4c2c-8d35-0759e20819d2_04-18-week4-PASSING_AND_PASSING,29,0,1,1,356,1,388
371833674,apache/activemq-artemis,05/09/18 19:28,spirals-bears,7f781b86-edd9-4c2c-8d35-0759e20819d2_04-18-week4-PASSING_AND_PASSING,27,0,302,1,1,488,1,1,821
368984038,apache/storm,05/09/18 19:34,spirals-bears,7f781b86-edd9-4c2c-8d35-0759e20819d2_04-18-week4-PASSING_AND_PASSING,9,0,0,74,0,2,24,0,63,0,0,592,0,40,22,670,1496
371368939,apache/activemq-artemis,05/09/18 19:35,spirals-bears,7f781b86-edd9-4c2c-8d35-0759e20819d2_04-18-week4-PASSING_AND_PASSING,33,0,1,7,11,52
371832716,apache/activemq-artemis,05/09/18 19:35,spirals-bears,7f781b86-edd9-4c2c-8d35-0759e20819d2_04-18-week4-PASSING_AND_PASSING,40,0,348,1,1,485,1,1,877
370116693,apache/activemq-artemis,05/09/18 19:36,spirals-bears,7f781b86-edd9-4c2c-8d35-0759e20819d2_04-18-week4-PASSING_AND_PASSING,33,0,1,12,8,54
370403563,apache/activemq-artemis,05/09/18 19:36,spirals-bears,7f781b86-edd9-4c2c-8d35-0759e20819d2_04-18-week4-PASSING_AND_PASSING,29,6,35
370244335,apache/storm,05/09/18 19:42,spirals-bears,7f781b86-edd9-4c2c-8d35-0759e20819d2_04-18-week4-PASSING_AND_PASSING,11,0,0,592,0,2,40,0,619,2,0,618,1,49,22,707,2663
371590389,apache/activemq-artemis,05/09/18 19:42,spirals-bears,7f781b86-edd9-4c2c-8d35-0759e20819d2_04-18-week4-PASSING_AND_PASSING,26,0,315,2,1,470,0,2,816
369604883,apache/activemq-artemis,05/09/18 19:43,spirals-bears,7f781b86-edd9-4c2c-8d35-0759e20819d2_04-18-week4-PASSING_AND_PASSING,28,0,1,6,11,46
370089158,apache/activemq-artemis,05/09/18 19:43,spirals-bears,7f781b86-edd9-4c2c-8d35-0759e20819d2_04-18-week4-PASSING_AND_PASSING,28,0,1,5,11,45
371213603,apache/activemq-artemis,05/09/18 19:50,spirals-bears,7f781b86-edd9-4c2c-8d35-0759e20819d2_04-18-week4-PASSING_AND_PASSING,29,0,317,1,1,458,1,1,808
370397486,apache/activemq-artemis,05/09/18 19:50,spirals-bears,7f781b86-edd9-4c2c-8d35-0759e20819d2_04-18-week4-PASSING_AND_PASSING,30,0,327,1,1,464,0,2,825
371874321,linkedin/pinot,05/09/18 19:51,spirals-bears,7f781b86-edd9-4c2c-8d35-0759e20819d2_04-18-week4-PASSING_AND_PASSING,35,4,39
369164480,apache/activemq-artemis,05/09/18 19:51,spirals-bears,7f781b86-edd9-4c2c-8d35-0759e20819d2_04-18-week4-PASSING_AND_PASSING,27,0,1,1,414,1,444
372148826,linkedin/pinot,05/09/18 19:52,spirals-bears,7f781b86-edd9-4c2c-8d35-0759e20819d2_04-18-week4-PASSING_AND_PASSING,35,5,40
371334544,linkedin/pinot,05/09/18 19:53,spirals-bears,7f781b86-edd9-4c2c-8d35-0759e20819d2_04-18-week4-PASSING_AND_PASSING,36,5,41
371339701,linkedin/pinot,05/09/18 19:53,spirals-bears,7f781b86-edd9-4c2c-8d35-0759e20819d2_04-18-week4-PASSING_AND_PASSING,38,4,42
370266837,linkedin/pinot,05/09/18 19:55,spirals-bears,7f781b86-edd9-4c2c-8d35-0759e20819d2_04-18-week4-PASSING_AND_PASSING,48,4,52
371830239,linkedin/pinot,05/09/18 19:55,spirals-bears,7f781b86-edd9-4c2c-8d35-0759e20819d2_04-18-week4-PASSING_AND_PASSING,36,0,0,1,189,1,227
370860685,linkedin/pinot,05/09/18 19:55,spirals-bears,7f781b86-edd9-4c2c-8d35-0759e20819d2_04-18-week4-PASSING_AND_PASSING,36,5,41
371308310,linkedin/pinot,05/09/18 19:56,spirals-bears,7f781b86-edd9-4c2c-8d35-0759e20819d2_04-18-week4-PASSING_AND_PASSING,43,5,48
371303407,linkedin/pinot,05/09/18 19:56,spirals-bears,7f781b86-edd9-4c2c-8d35-0759e20819d2_04-18-week4-PASSING_AND_PASSING,37,3,40
372151018,linkedin/pinot,05/09/18 19:57,spirals-bears,7f781b86-edd9-4c2c-8d35-0759e20819d2_04-18-week4-PASSING_AND_PASSING,34,0,0,1,325,1,361
370352005,linkedin/pinot,05/09/18 19:57,spirals-bears,7f781b86-edd9-4c2c-8d35-0759e20819d2_04-18-week4-PASSING_AND_PASSING,38,3,41
370807260,linkedin/pinot,05/09/18 19:58,spirals-bears,7f781b86-edd9-4c2c-8d35-0759e20819d2_04-18-week4-PASSING_AND_PASSING,47,4,51
370361596,linkedin/pinot,05/09/18 19:58,spirals-bears,7f781b86-edd9-4c2c-8d35-0759e20819d2_04-18-week4-PASSING_AND_PASSING,49,3,52
367941159,linkedin/pinot,05/09/18 19:59,spirals-bears,7f781b86-edd9-4c2c-8d35-0759e20819d2_04-18-week4-PASSING_AND_PASSING,37,4,41
370318615,linkedin/pinot,05/09/18 19:59,spirals-bears,7f781b86-edd9-4c2c-8d35-0759e20819d2_04-18-week4-PASSING_AND_PASSING,34,4,38
370211919,linkedin/pinot,05/09/18 20:00,spirals-bears,7f781b86-edd9-4c2c-8d35-0759e20819d2_04-18-week4-PASSING_AND_PASSING,39,4,43
370844623,linkedin/pinot,05/09/18 20:01,spirals-bears,7f781b86-edd9-4c2c-8d35-0759e20819d2_04-18-week4-PASSING_AND_PASSING,40,0,0,1,226,3,270
372150070,Azure/azure-libraries-for-java,05/09/18 20:03,spirals-bears,7f781b86-edd9-4c2c-8d35-0759e20819d2_04-18-week4-PASSING_AND_PASSING,66,0,0,6,85,15,172
369299988,Azure/azure-libraries-for-java,05/09/18 20:03,spirals-bears,7f781b86-edd9-4c2c-8d35-0759e20819d2_04-18-week4-PASSING_AND_PASSING,66,0,1,6,53,12,138
370393731,apache/activemq-artemis,05/09/18 20:11,spirals-bears,7f781b86-edd9-4c2c-8d35-0759e20819d2_04-18-week4-PASSING_AND_PASSING,9,46,0,0,13,325,0,1,20,0,304,0,1,1,356,0,28,39,25,465,1633
372907342,raphw/byte-buddy,05/09/18 20:12,spirals-bears,7f781b86-edd9-4c2c-8d35-0759e20819d2_04-18-week4-PASSING_AND_PASSING,261,0,89,0,1,169,1,1,522
369242578,Azure/azure-libraries-for-java,05/09/18 20:13,spirals-bears,7f781b86-edd9-4c2c-8d35-0759e20819d2_04-18-week4-PASSING_AND_PASSING,12,0,0,93,0,1,19,0,93,1,0,126,0,82,21,105,553
372907039,raphw/byte-buddy,05/09/18 20:19,spirals-bears,7f781b86-edd9-4c2c-8d35-0759e20819d2_04-18-week4-PASSING_AND_PASSING,250,0,82,0,0,110,0,1,443
372623039,raphw/byte-buddy,05/09/18 20:20,spirals-bears,7f781b86-edd9-4c2c-8d35-0759e20819d2_04-18-week4-PASSING_AND_PASSING,258,0,82,2,1,110,1,0,454
372206324,raphw/byte-buddy,05/09/18 20:26,spirals-bears,7f781b86-edd9-4c2c-8d35-0759e20819d2_04-18-week4-PASSING_AND_PASSING,256,0,3,1,53,1,314
372439365,raphw/byte-buddy,05/09/18 20:26,spirals-bears,7f781b86-edd9-4c2c-8d35-0759e20819d2_04-18-week4-PASSING_AND_PASSING,9,12,0,0,21,57,0,0,10,0,78,0,0,0,54,0,395,13,11,112,772
372227494,raphw/byte-buddy,05/09/18 20:27,spirals-bears,7f781b86-edd9-4c2c-8d35-0759e20819d2_04-18-week4-PASSING_AND_PASSING,265,0,84,0,1,110,0,0,460
372204827,raphw/byte-buddy,05/09/18 20:34,spirals-bears,7f781b86-edd9-4c2c-8d35-0759e20819d2_04-18-week4-PASSING_AND_PASSING,11,0,0,16,0,0,12,0,15,0,0,51,0,246,11,113,475
372205431,raphw/byte-buddy,05/09/18 20:35,spirals-bears,7f781b86-edd9-4c2c-8d35-0759e20819d2_04-18-week4-PASSING_AND_PASSING,10,0,0,17,0,0,11,0,13,0,0,48,0,286,12,115,512
372163975,raphw/byte-buddy,05/09/18 20:35,spirals-bears,7f781b86-edd9-4c2c-8d35-0759e20819d2_04-18-week4-PASSING_AND_PASSING,11,0,0,15,0,0,10,0,14,1,0,49,0,242,11,118,471
371908435,raphw/byte-buddy,05/09/18 20:40,spirals-bears,7f781b86-edd9-4c2c-8d35-0759e20819d2_04-18-week4-PASSING_AND_PASSING,261,0,0,2,53,1,317
372075224,raphw/byte-buddy,05/09/18 20:45,spirals-bears,7f781b86-edd9-4c2c-8d35-0759e20819d2_04-18-week4-PASSING_AND_PASSING,12,0,0,63,0,0,11,0,61,0,1,56,0,248,11,120,583
370143030,graphhopper/graphhopper,05/09/18 20:45,spirals-bears,7f781b86-edd9-4c2c-8d35-0759e20819d2_04-18-week4-PASSING_AND_PASSING,36,0,76,0,0,127,0,0,239
369327326,graphhopper/graphhopper,05/09/18 20:45,spirals-bears,7f781b86-edd9-4c2c-8d35-0759e20819d2_04-18-week4-PASSING_AND_PASSING,18,4,22
369326481,graphhopper/graphhopper,05/09/18 20:45,spirals-bears,7f781b86-edd9-4c2c-8d35-0759e20819d2_04-18-week4-PASSING_AND_PASSING,22,0,22
372084438,raphw/byte-buddy,05/09/18 20:45,spirals-bears,7f781b86-edd9-4c2c-8d35-0759e20819d2_04-18-week4-PASSING_AND_PASSING,453,0,86,0,0,115,1,1,656
369866467,graphhopper/graphhopper,05/09/18 20:46,spirals-bears,7f781b86-edd9-4c2c-8d35-0759e20819d2_04-18-week4-PASSING_AND_PASSING,17,0,17
371112518,HubSpot/Singularity,05/09/18 20:49,spirals-bears,7f781b86-edd9-4c2c-8d35-0759e20819d2_04-18-week4-PASSING_AND_PASSING,17,0,1,0,162,0,180
371910336,HubSpot/Singularity,05/09/18 20:52,spirals-bears,7f781b86-edd9-4c2c-8d35-0759e20819d2_04-18-week4-PASSING_AND_PASSING,19,0,2,0,159,0,180
371330275,HubSpot/Singularity,05/09/18 20:56,spirals-bears,7f781b86-edd9-4c2c-8d35-0759e20819d2_04-18-week4-PASSING_AND_PASSING,19,0,1,0,183,0,203
368899245,HubSpot/Singularity,05/09/18 20:59,spirals-bears,7f781b86-edd9-4c2c-8d35-0759e20819d2_04-18-week4-PASSING_AND_PASSING,20,0,1,0,154,0,175
368899261,HubSpot/Singularity,05/09/18 21:03,spirals-bears,7f781b86-edd9-4c2c-8d35-0759e20819d2_04-18-week4-PASSING_AND_PASSING,18,0,2,5,158,3,186
373085973,HubSpot/Singularity,05/09/18 21:11,spirals-bears,7f781b86-edd9-4c2c-8d35-0759e20819d2_04-18-week4-PASSING_AND_PASSING,21,0,0,354,4,1,48,0,370,0,0,334,0,17,9,391,1549
373086002,HubSpot/Singularity,05/09/18 21:12,spirals-bears,7f781b86-edd9-4c2c-8d35-0759e20819d2_04-18-week4-PASSING_AND_PASSING,18,0,6,353,6,1,53,0,383,7,2,336,4,18,6,403,1596
370070253,lettuce-io/lettuce-core,05/09/18 21:13,spirals-bears,7f781b86-edd9-4c2c-8d35-0759e20819d2_04-18-week4-PASSING_AND_PASSING,9,0,27,1,0,51,0,0,88
369263071,lettuce-io/lettuce-core,05/09/18 21:14,spirals-bears,7f781b86-edd9-4c2c-8d35-0759e20819d2_04-18-week4-PASSING_AND_PASSING,10,0,28,1,0,52,0,0,91
371080395,HubSpot/Singularity,05/09/18 21:28,spirals-bears,7f781b86-edd9-4c2c-8d35-0759e20819d2_04-18-week4-PASSING_AND_PASSING,9,0,0,302,0,1,25,1,304,1,3,292,0,19,5,527,1489
372384648,magefree/mage,05/09/18 21:31,spirals-bears,7f781b86-edd9-4c2c-8d35-0759e20819d2_04-18-week4-PASSING_AND_PASSING,7,0,0,215,0,1,30,0,177,5,1,38,1,176,27,353,1031
370614341,magefree/mage,05/09/18 21:31,spirals-bears,7f781b86-edd9-4c2c-8d35-0759e20819d2_04-18-week4-PASSING_AND_PASSING,8,0,0,195,0,0,34,0,179,1,1,30,0,176,23,349,996
369710371,magefree/mage,05/09/18 21:46,spirals-bears,7f781b86-edd9-4c2c-8d35-0759e20819d2_04-18-week4-PASSING_AND_PASSING,12,0,0,184,0,1,30,0,185,2,1,36,1,169,23,344,988
369635704,magefree/mage,05/09/18 21:48,spirals-bears,7f781b86-edd9-4c2c-8d35-0759e20819d2_04-18-week4-PASSING_AND_PASSING,10,0,0,212,0,1,34,0,158,2,1,27,1,181,28,339,994
369653528,magefree/mage,05/09/18 21:49,spirals-bears,7f781b86-edd9-4c2c-8d35-0759e20819d2_04-18-week4-PASSING_AND_PASSING,11,0,0,217,1,0,33,0,183,2,1,28,1,176,25,351,1029
371512667,molgenis/molgenis,05/09/18 21:54,spirals-bears,7f781b86-edd9-4c2c-8d35-0759e20819d2_04-18-week4-PASSING_AND_PASSING,43,1,4,8,252,7,315
369615798,magefree/mage,05/09/18 22:04,spirals-bears,7f781b86-edd9-4c2c-8d35-0759e20819d2_04-18-week4-PASSING_AND_PASSING,14,0,0,185,1,1,35,0,225,2,1,22,0,169,24,360,1039
368936016,linkedin/pinot,05/09/18 22:08,spirals-bears,7f781b86-edd9-4c2c-8d35-0759e20819d2_04-18-week4-PASSING_AND_PASSING,15,72,0,5,21,3351,1,0,95,0,3314,0,7,3,193,5,35,91,32,435,7675
371040424,molgenis/molgenis,05/09/18 22:09,spirals-bears,7f781b86-edd9-4c2c-8d35-0759e20819d2_04-18-week4-PASSING_AND_PASSING,47,8,55
371476037,molgenis/molgenis,05/09/18 22:10,spirals-bears,7f781b86-edd9-4c2c-8d35-0759e20819d2_04-18-week4-PASSING_AND_PASSING,47,1,5,7,283,9,352
371023626,molgenis/molgenis,05/09/18 22:10,spirals-bears,7f781b86-edd9-4c2c-8d35-0759e20819d2_04-18-week4-PASSING_AND_PASSING,47,6,53
370998352,molgenis/molgenis,05/09/18 22:12,spirals-bears,7f781b86-edd9-4c2c-8d35-0759e20819d2_04-18-week4-PASSING_AND_PASSING,46,11,57
370984964,molgenis/molgenis,05/09/18 22:13,spirals-bears,7f781b86-edd9-4c2c-8d35-0759e20819d2_04-18-week4-PASSING_AND_PASSING,49,8,57
370629030,molgenis/molgenis,05/09/18 22:14,spirals-bears,7f781b86-edd9-4c2c-8d35-0759e20819d2_04-18-week4-PASSING_AND_PASSING,52,7,59
370284122,molgenis/molgenis,05/09/18 22:17,spirals-bears,7f781b86-edd9-4c2c-8d35-0759e20819d2_04-18-week4-PASSING_AND_PASSING,49,1,6,6,51,12,125
370470268,molgenis/molgenis,05/09/18 22:19,spirals-bears,7f781b86-edd9-4c2c-8d35-0759e20819d2_04-18-week4-PASSING_AND_PASSING,48,1,7,1,56,2,115
371001365,molgenis/molgenis,05/09/18 22:20,spirals-bears,7f781b86-edd9-4c2c-8d35-0759e20819d2_04-18-week4-PASSING_AND_PASSING,43,1,6,0,503,2,555
370635227,molgenis/molgenis,05/09/18 22:21,spirals-bears,7f781b86-edd9-4c2c-8d35-0759e20819d2_04-18-week4-PASSING_AND_PASSING,44,1,4,6,49,10,114
370489227,molgenis/molgenis,05/09/18 22:22,spirals-bears,7f781b86-edd9-4c2c-8d35-0759e20819d2_04-18-week4-PASSING_AND_PASSING,42,1,5,5,10,63
370337624,molgenis/molgenis,05/09/18 22:23,spirals-bears,7f781b86-edd9-4c2c-8d35-0759e20819d2_04-18-week4-PASSING_AND_PASSING,40,8,48
370025975,molgenis/molgenis,05/09/18 22:23,spirals-bears,7f781b86-edd9-4c2c-8d35-0759e20819d2_04-18-week4-PASSING_AND_PASSING,39,1,4,1,43,1,89
370006117,molgenis/molgenis,05/09/18 22:24,spirals-bears,7f781b86-edd9-4c2c-8d35-0759e20819d2_04-18-week4-PASSING_AND_PASSING,45,1,5,1,37,1,90
369966801,molgenis/molgenis,05/09/18 22:26,spirals-bears,7f781b86-edd9-4c2c-8d35-0759e20819d2_04-18-week4-PASSING_AND_PASSING,39,1,4,6,53,8,111
368599282,molgenis/molgenis,05/09/18 22:28,spirals-bears,7f781b86-edd9-4c2c-8d35-0759e20819d2_04-18-week4-PASSING_AND_PASSING,37,1,4,6,56,7,111
369063708,molgenis/molgenis,05/09/18 22:31,spirals-bears,7f781b86-edd9-4c2c-8d35-0759e20819d2_04-18-week4-PASSING_AND_PASSING,39,1,7,8,61,13,129
368559859,molgenis/molgenis,05/09/18 22:33,spirals-bears,7f781b86-edd9-4c2c-8d35-0759e20819d2_04-18-week4-PASSING_AND_PASSING,40,1,4,7,56,8,116
370316488,visallo/vertexium,05/09/18 22:33,spirals-bears,7f781b86-edd9-4c2c-8d35-0759e20819d2_04-18-week4-PASSING_AND_PASSING,7,2,9
371248534,languagetool-org/languagetool,05/09/18 23:06,spirals-bears,7f781b86-edd9-4c2c-8d35-0759e20819d2_04-18-week4-PASSING_AND_PASSING,15,71,0,0,47,226,1,1,72,0,852,0,1,0,83,0,282,121,71,111,1954
371024842,molgenis/molgenis,05/09/18 23:13,spirals-bears,7f781b86-edd9-4c2c-8d35-0759e20819d2_04-18-week4-PASSING_AND_PASSING,13,654,1,0,40,68,31,4,187,1,1224,1,4,2,526,2,40,562,387,943,4690
371487569,molgenis/molgenis,05/09/18 23:16,spirals-bears,7f781b86-edd9-4c2c-8d35-0759e20819d2_04-18-week4-PASSING_AND_PASSING,10,591,1,4,18,61,63,4,240,1,1326,0,18,2,600,13,41,768,438,992,5191
369514407,molgenis/molgenis,05/09/18 23:21,spirals-bears,7f781b86-edd9-4c2c-8d35-0759e20819d2_04-18-week4-PASSING_AND_PASSING,11,86,1,0,17,142,24,4,251,1,1257,0,3,2,479,3,37,146,257,730,3451
370626210,apache/incubator-dubbo,05/09/18 23:22,spirals-bears,7f781b86-edd9-4c2c-8d35-0759e20819d2_04-18-week4-PASSING_AND_PASSING,8,3,11
369010098,apache/incubator-dubbo,05/09/18 23:22,spirals-bears,7f781b86-edd9-4c2c-8d35-0759e20819d2_04-18-week4-PASSING_AND_PASSING,8,3,11
353182842,apache/incubator-dubbo,05/09/18 23:23,spirals-bears,7f781b86-edd9-4c2c-8d35-0759e20819d2_04-18-week4-PASSING_AND_PASSING,9,3,12
371189003,languagetool-org/languagetool,05/09/18 23:28,spirals-bears,7f781b86-edd9-4c2c-8d35-0759e20819d2_04-18-week4-PASSING_AND_PASSING,294,0,861,1,2,149,1,3,1311
363791266,apache/incubator-dubbo,05/09/18 23:29,spirals-bears,7f781b86-edd9-4c2c-8d35-0759e20819d2_04-18-week4-PASSING_AND_PASSING,8,3,11
369925190,apache/incubator-dubbo,05/09/18 23:32,spirals-bears,7f781b86-edd9-4c2c-8d35-0759e20819d2_04-18-week4-PASSING_AND_PASSING,12,0,2,0,155,3,172
370239119,languagetool-org/languagetool,05/09/18 23:42,spirals-bears,7f781b86-edd9-4c2c-8d35-0759e20819d2_04-18-week4-PASSING_AND_PASSING,9,36,0,0,27,208,0,1,31,0,831,0,0,0,61,0,294,37,33,122,1690
369772224,languagetool-org/languagetool,05/09/18 23:45,spirals-bears,7f781b86-edd9-4c2c-8d35-0759e20819d2_04-18-week4-PASSING_AND_PASSING,11,38,0,0,27,210,0,3,32,0,833,0,0,0,68,0,287,40,39,103,1691
369322017,ga4gh/dockstore,05/09/18 23:46,spirals-bears,7f781b86-edd9-4c2c-8d35-0759e20819d2_04-18-week4-PASSING_AND_PASSING,10,2,12
370383941,apache/incubator-dubbo,05/09/18 23:46,spirals-bears,7f781b86-edd9-4c2c-8d35-0759e20819d2_04-18-week4-PASSING_AND_PASSING,10,5,0,0,6,137,0,2,4,0,390,0,0,0,76,0,9,6,4,741,1390
369228516,ga4gh/dockstore,05/09/18 23:47,spirals-bears,7f781b86-edd9-4c2c-8d35-0759e20819d2_04-18-week4-PASSING_AND_PASSING,10,2,12
369208624,ga4gh/dockstore,05/09/18 23:47,spirals-bears,7f781b86-edd9-4c2c-8d35-0759e20819d2_04-18-week4-PASSING_AND_PASSING,8,0,8
369745736,apache/incubator-dubbo,05/09/18 23:49,spirals-bears,7f781b86-edd9-4c2c-8d35-0759e20819d2_04-18-week4-PASSING_AND_PASSING,8,0,285,1,0,706,0,1,1001
371125222,ga4gh/dockstore,05/09/18 23:54,spirals-bears,7f781b86-edd9-4c2c-8d35-0759e20819d2_04-18-week4-PASSING_AND_PASSING,9,0,0,0,669,0,678
369280268,ga4gh/dockstore,05/09/18 23:56,spirals-bears,7f781b86-edd9-4c2c-8d35-0759e20819d2_04-18-week4-PASSING_AND_PASSING,10,0,0,0,611,0,621
371570048,apache/jackrabbit-oak,06/09/18 00:00,spirals-bears,7f781b86-edd9-4c2c-8d35-0759e20819d2_04-18-week4-PASSING_AND_PASSING,39,0,2,0,348,1,390
371570151,apache/jackrabbit-oak,06/09/18 00:31,spirals-bears,7f781b86-edd9-4c2c-8d35-0759e20819d2_04-18-week4-PASSING_AND_PASSING,8,0,0,514,0,1,6,0,1516,0,1,174,0,34,9,264,2527
371570000,apache/jackrabbit-oak,06/09/18 00:35,spirals-bears,7f781b86-edd9-4c2c-8d35-0759e20819d2_04-18-week4-PASSING_AND_PASSING,10,0,0,452,0,1,7,0,1301,1,1,192,0,36,11,275,2287
371570024,apache/jackrabbit-oak,06/09/18 00:46,spirals-bears,7f781b86-edd9-4c2c-8d35-0759e20819d2_04-18-week4-PASSING_AND_PASSING,11,0,0,403,0,2,8,0,1739,1,1,195,0,34,12,290,2696
372016535,apache/jackrabbit-oak,06/09/18 01:02,spirals-bears,7f781b86-edd9-4c2c-8d35-0759e20819d2_04-18-week4-PASSING_AND_PASSING,13,0,6,1770,0,2,21,0,1747,1,1,396,0,36,20,478,4491
371073111,apache/jackrabbit-oak,06/09/18 01:04,spirals-bears,7f781b86-edd9-4c2c-8d35-0759e20819d2_04-18-week4-PASSING_AND_PASSING,15,0,0,450,2,11,0,0,1,86,0,36,15,482,1098
370077936,apache/jackrabbit-oak,06/09/18 01:12,spirals-bears,7f781b86-edd9-4c2c-8d35-0759e20819d2_04-18-week4-PASSING_AND_PASSING,36,0,2,1,427,1,467
369196648,apache/jackrabbit-oak,06/09/18 01:15,spirals-bears,7f781b86-edd9-4c2c-8d35-0759e20819d2_04-18-week4-PASSING_AND_PASSING,36,0,2,0,113,1,152
365961179,aliyun/fc-java-sdk,06/09/18 01:16,spirals-bears,7f781b86-edd9-4c2c-8d35-0759e20819d2_04-18-week4-PASSING_AND_PASSING,3,0,0,0,20,0,23
371378621,aliyun/fc-java-sdk,06/09/18 01:16,spirals-bears,7f781b86-edd9-4c2c-8d35-0759e20819d2_04-18-week4-PASSING_AND_PASSING,2,0,0,3,19,2,26
371378612,aliyun/fc-java-sdk,06/09/18 01:17,spirals-bears,7f781b86-edd9-4c2c-8d35-0759e20819d2_04-18-week4-PASSING_AND_PASSING,2,0,0,0,19,0,21
371131241,apache/jackrabbit-oak,06/09/18 01:23,spirals-bears,7f781b86-edd9-4c2c-8d35-0759e20819d2_04-18-week4-PASSING_AND_PASSING,7,0,0,1176,0,1,7,0,1391,0,1,186,0,36,13,276,3094
372661377,openzipkin/zipkin,06/09/18 01:27,spirals-bears,7f781b86-edd9-4c2c-8d35-0759e20819d2_04-18-week4-PASSING_AND_PASSING,23,0,246,2,0,298,0,0,569
372653146,openzipkin/zipkin,06/09/18 01:33,spirals-bears,7f781b86-edd9-4c2c-8d35-0759e20819d2_04-18-week4-PASSING_AND_PASSING,24,0,252,2,0,291,0,0,569
371909362,openzipkin/zipkin,06/09/18 01:34,spirals-bears,7f781b86-edd9-4c2c-8d35-0759e20819d2_04-18-week4-PASSING_AND_PASSING,25,0,25
371905252,openzipkin/zipkin,06/09/18 01:34,spirals-bears,7f781b86-edd9-4c2c-8d35-0759e20819d2_04-18-week4-PASSING_AND_PASSING,23,2,25
371905059,openzipkin/zipkin,06/09/18 01:35,spirals-bears,7f781b86-edd9-4c2c-8d35-0759e20819d2_04-18-week4-PASSING_AND_PASSING,24,0,24
372078566,openzipkin/zipkin,06/09/18 01:36,spirals-bears,7f781b86-edd9-4c2c-8d35-0759e20819d2_04-18-week4-PASSING_AND_PASSING,23,0,241,2,0,294,0,0,560
371605104,openzipkin/zipkin,06/09/18 01:36,spirals-bears,7f781b86-edd9-4c2c-8d35-0759e20819d2_04-18-week4-PASSING_AND_PASSING,25,0,2,0,42,0,69
371434348,openzipkin/zipkin,06/09/18 01:37,spirals-bears,7f781b86-edd9-4c2c-8d35-0759e20819d2_04-18-week4-PASSING_AND_PASSING,24,0,24
371434376,openzipkin/zipkin,06/09/18 01:37,spirals-bears,7f781b86-edd9-4c2c-8d35-0759e20819d2_04-18-week4-PASSING_AND_PASSING,25,2,27
371425684,openzipkin/zipkin,06/09/18 01:37,spirals-bears,7f781b86-edd9-4c2c-8d35-0759e20819d2_04-18-week4-PASSING_AND_PASSING,23,2,25
371425021,openzipkin/zipkin,06/09/18 01:38,spirals-bears,7f781b86-edd9-4c2c-8d35-0759e20819d2_04-18-week4-PASSING_AND_PASSING,26,2,28
371424942,openzipkin/zipkin,06/09/18 01:38,spirals-bears,7f781b86-edd9-4c2c-8d35-0759e20819d2_04-18-week4-PASSING_AND_PASSING,23,0,23
371083730,openzipkin/zipkin,06/09/18 01:38,spirals-bears,7f781b86-edd9-4c2c-8d35-0759e20819d2_04-18-week4-PASSING_AND_PASSING,24,0,24
371083759,openzipkin/zipkin,06/09/18 01:39,spirals-bears,7f781b86-edd9-4c2c-8d35-0759e20819d2_04-18-week4-PASSING_AND_PASSING,24,3,27
371066071,openzipkin/zipkin,06/09/18 01:39,spirals-bears,7f781b86-edd9-4c2c-8d35-0759e20819d2_04-18-week4-PASSING_AND_PASSING,24,2,26
371071057,openzipkin/zipkin,06/09/18 01:39,spirals-bears,7f781b86-edd9-4c2c-8d35-0759e20819d2_04-18-week4-PASSING_AND_PASSING,24,0,24
371074331,openzipkin/zipkin,06/09/18 01:39,spirals-bears,7f781b86-edd9-4c2c-8d35-0759e20819d2_04-18-week4-PASSING_AND_PASSING,26,2,28
371071079,openzipkin/zipkin,06/09/18 01:40,spirals-bears,7f781b86-edd9-4c2c-8d35-0759e20819d2_04-18-week4-PASSING_AND_PASSING,25,2,27
370089334,openzipkin/zipkin,06/09/18 01:40,spirals-bears,7f781b86-edd9-4c2c-8d35-0759e20819d2_04-18-week4-PASSING_AND_PASSING,23,0,23
370089351,openzipkin/zipkin,06/09/18 01:41,spirals-bears,7f781b86-edd9-4c2c-8d35-0759e20819d2_04-18-week4-PASSING_AND_PASSING,25,2,27
370870392,openzipkin/zipkin,06/09/18 01:42,spirals-bears,7f781b86-edd9-4c2c-8d35-0759e20819d2_04-18-week4-PASSING_AND_PASSING,24,2,26
370080885,openzipkin/zipkin,06/09/18 01:42,spirals-bears,7f781b86-edd9-4c2c-8d35-0759e20819d2_04-18-week4-PASSING_AND_PASSING,23,2,25
371543181,apache/jackrabbit-oak,06/09/18 01:46,spirals-bears,7f781b86-edd9-4c2c-8d35-0759e20819d2_04-18-week4-PASSING_AND_PASSING,13,0,0,1651,0,2,12,0,1675,1,1,396,0,35,19,472,4277
369988942,openzipkin/zipkin,06/09/18 01:50,spirals-bears,7f781b86-edd9-4c2c-8d35-0759e20819d2_04-18-week4-PASSING_AND_PASSING,28,0,2,4,166,4,204
368564577,openzipkin/zipkin,06/09/18 01:51,spirals-bears,7f781b86-edd9-4c2c-8d35-0759e20819d2_04-18-week4-PASSING_AND_PASSING,24,2,26
370502194,openzipkin/zipkin,06/09/18 01:51,spirals-bears,7f781b86-edd9-4c2c-8d35-0759e20819d2_04-18-week4-PASSING_AND_PASSING,23,0,205,1,4,277,0,4,514
368564554,openzipkin/zipkin,06/09/18 01:51,spirals-bears,7f781b86-edd9-4c2c-8d35-0759e20819d2_04-18-week4-PASSING_AND_PASSING,23,0,23
369983432,openzipkin/zipkin,06/09/18 01:52,spirals-bears,7f781b86-edd9-4c2c-8d35-0759e20819d2_04-18-week4-PASSING_AND_PASSING,24,0,24
369983452,openzipkin/zipkin,06/09/18 01:52,spirals-bears,7f781b86-edd9-4c2c-8d35-0759e20819d2_04-18-week4-PASSING_AND_PASSING,28,2,30
243155503,openzipkin/zipkin,06/09/18 01:52,spirals-bears,7f781b86-edd9-4c2c-8d35-0759e20819d2_04-18-week4-PASSING_AND_PASSING,24,0,24
368563081,openzipkin/zipkin,06/09/18 01:52,spirals-bears,7f781b86-edd9-4c2c-8d35-0759e20819d2_04-18-week4-PASSING_AND_PASSING,23,0,23
371612053,resteasy/Resteasy,06/09/18 01:53,spirals-bears,7f781b86-edd9-4c2c-8d35-0759e20819d2_04-18-week4-PASSING_AND_PASSING,18,2,1,21
368563102,openzipkin/zipkin,06/09/18 01:53,spirals-bears,7f781b86-edd9-4c2c-8d35-0759e20819d2_04-18-week4-PASSING_AND_PASSING,25,2,27
371531567,resteasy/Resteasy,06/09/18 01:53,spirals-bears,7f781b86-edd9-4c2c-8d35-0759e20819d2_04-18-week4-PASSING_AND_PASSING,17,2,1,20
370328037,resteasy/Resteasy,06/09/18 01:53,spirals-bears,7f781b86-edd9-4c2c-8d35-0759e20819d2_04-18-week4-PASSING_AND_PASSING,18,2,2,22
370462082,resteasy/Resteasy,06/09/18 01:54,spirals-bears,7f781b86-edd9-4c2c-8d35-0759e20819d2_04-18-week4-PASSING_AND_PASSING,18,2,1,21
370857408,openzipkin/zipkin,06/09/18 01:54,spirals-bears,7f781b86-edd9-4c2c-8d35-0759e20819d2_04-18-week4-PASSING_AND_PASSING,10,0,0,190,0,1,3,0,186,0,0,152,0,23,7,290,862
370666392,resteasy/Resteasy,06/09/18 01:54,spirals-bears,7f781b86-edd9-4c2c-8d35-0759e20819d2_04-18-week4-PASSING_AND_PASSING,18,2,8,28
368994314,resteasy/Resteasy,06/09/18 01:54,spirals-bears,7f781b86-edd9-4c2c-8d35-0759e20819d2_04-18-week4-PASSING_AND_PASSING,18,5,23
357485448,resteasy/Resteasy,06/09/18 01:55,spirals-bears,7f781b86-edd9-4c2c-8d35-0759e20819d2_04-18-week4-PASSING_AND_PASSING,18,2,7,27
370493571,resteasy/Resteasy,06/09/18 01:55,spirals-bears,7f781b86-edd9-4c2c-8d35-0759e20819d2_04-18-week4-PASSING_AND_PASSING,19,6,25
370060478,resteasy/Resteasy,06/09/18 01:55,spirals-bears,7f781b86-edd9-4c2c-8d35-0759e20819d2_04-18-week4-PASSING_AND_PASSING,20,5,25
367054511,resteasy/Resteasy,06/09/18 01:55,spirals-bears,7f781b86-edd9-4c2c-8d35-0759e20819d2_04-18-week4-PASSING_AND_PASSING,18,2,1,21
367385487,resteasy/Resteasy,06/09/18 01:55,spirals-bears,7f781b86-edd9-4c2c-8d35-0759e20819d2_04-18-week4-PASSING_AND_PASSING,19,2,1,22
360426801,pgjdbc/pgjdbc,06/09/18 01:55,spirals-bears,7f781b86-edd9-4c2c-8d35-0759e20819d2_04-18-week4-PASSING_AND_PASSING,10,3,13
372980812,geoserver/geoserver,06/09/18 01:56,spirals-bears,7f781b86-edd9-4c2c-8d35-0759e20819d2_04-18-week4-PASSING_AND_PASSING,63,8,71
370162099,apache/jackrabbit-oak,06/09/18 02:18,spirals-bears,7f781b86-edd9-4c2c-8d35-0759e20819d2_04-18-week4-PASSING_AND_PASSING,9,0,0,1781,1,2,22,0,1797,1,1,373,0,39,19,465,4510
372682540,geoserver/geoserver,06/09/18 02:18,spirals-bears,7f781b86-edd9-4c2c-8d35-0759e20819d2_04-18-week4-PASSING_AND_PASSING,10,0,0,21,0,1,32,0,490,1,0,41,1,57,27,664,1345
372147740,geoserver/geoserver,06/09/18 02:20,spirals-bears,7f781b86-edd9-4c2c-8d35-0759e20819d2_04-18-week4-PASSING_AND_PASSING,10,0,0,122,0,2,34,0,482,1,0,40,0,56,36,579,1362
372206916,geoserver/geoserver,06/09/18 02:20,spirals-bears,7f781b86-edd9-4c2c-8d35-0759e20819d2_04-18-week4-PASSING_AND_PASSING,13,0,0,204,0,1,30,0,454,1,0,36,0,60,32,631,1462
372143674,geoserver/geoserver,06/09/18 02:22,spirals-bears,7f781b86-edd9-4c2c-8d35-0759e20819d2_04-18-week4-PASSING_AND_PASSING,55,0,3,4,141,7,210
371544451,aicis/fresco,06/09/18 02:23,spirals-bears,7f781b86-edd9-4c2c-8d35-0759e20819d2_04-18-week4-PASSING_AND_PASSING,10,0,0,0,56,0,66
371525809,aicis/fresco,06/09/18 02:44,spirals-bears,7f781b86-edd9-4c2c-8d35-0759e20819d2_04-18-week4-PASSING_AND_PASSING,9,0,1158,0,0,98,0,0,1265
371525108,aicis/fresco,06/09/18 02:45,spirals-bears,7f781b86-edd9-4c2c-8d35-0759e20819d2_04-18-week4-PASSING_AND_PASSING,10,0,0,0,25,0,35
371490759,aicis/fresco,06/09/18 02:46,spirals-bears,7f781b86-edd9-4c2c-8d35-0759e20819d2_04-18-week4-PASSING_AND_PASSING,8,0,0,5,23,3,39
371452223,geoserver/geoserver,06/09/18 02:47,spirals-bears,7f781b86-edd9-4c2c-8d35-0759e20819d2_04-18-week4-PASSING_AND_PASSING,9,0,0,493,0,0,31,0,489,1,0,35,0,58,30,564,1710
371490752,aicis/fresco,06/09/18 02:48,spirals-bears,7f781b86-edd9-4c2c-8d35-0759e20819d2_04-18-week4-PASSING_AND_PASSING,8,0,0,0,24,0,32
371501685,aicis/fresco,06/09/18 02:49,spirals-bears,7f781b86-edd9-4c2c-8d35-0759e20819d2_04-18-week4-PASSING_AND_PASSING,9,0,0,0,25,0,34
371219260,geoserver/geoserver,06/09/18 02:49,spirals-bears,7f781b86-edd9-4c2c-8d35-0759e20819d2_04-18-week4-PASSING_AND_PASSING,12,1,0,488,0,2,33,0,482,1,0,40,0,56,34,566,1715
370672304,geoserver/geoserver,06/09/18 02:49,spirals-bears,7f781b86-edd9-4c2c-8d35-0759e20819d2_04-18-week4-PASSING_AND_PASSING,11,0,0,499,0,1,38,0,477,1,0,38,0,55,33,568,1721
371471914,aicis/fresco,06/09/18 02:50,spirals-bears,7f781b86-edd9-4c2c-8d35-0759e20819d2_04-18-week4-PASSING_AND_PASSING,10,0,0,0,29,0,39
371471934,aicis/fresco,06/09/18 02:51,spirals-bears,7f781b86-edd9-4c2c-8d35-0759e20819d2_04-18-week4-PASSING_AND_PASSING,9,0,0,4,27,2,42
371510528,aicis/fresco,06/09/18 03:09,spirals-bears,7f781b86-edd9-4c2c-8d35-0759e20819d2_04-18-week4-PASSING_AND_PASSING,9,0,1277,0,0,93,0,0,1379
371496638,aicis/fresco,06/09/18 03:12,spirals-bears,7f781b86-edd9-4c2c-8d35-0759e20819d2_04-18-week4-PASSING_AND_PASSING,8,0,1295,0,0,100,0,0,1403
371475085,aicis/fresco,06/09/18 03:13,spirals-bears,7f781b86-edd9-4c2c-8d35-0759e20819d2_04-18-week4-PASSING_AND_PASSING,10,0,1285,0,0,97,0,0,1392
371460895,aicis/fresco,06/09/18 03:13,spirals-bears,7f781b86-edd9-4c2c-8d35-0759e20819d2_04-18-week4-PASSING_AND_PASSING,9,0,0,0,28,0,37
371490621,aicis/fresco,06/09/18 03:14,spirals-bears,7f781b86-edd9-4c2c-8d35-0759e20819d2_04-18-week4-PASSING_AND_PASSING,9,0,1293,0,4,94,0,2,1402
371470818,aicis/fresco,06/09/18 03:33,spirals-bears,7f781b86-edd9-4c2c-8d35-0759e20819d2_04-18-week4-PASSING_AND_PASSING,9,0,1290,0,0,95,0,0,1394
370634151,aicis/fresco,06/09/18 03:36,spirals-bears,7f781b86-edd9-4c2c-8d35-0759e20819d2_04-18-week4-PASSING_AND_PASSING,8,0,1295,0,0,99,0,0,1402
370625687,aicis/fresco,06/09/18 03:37,spirals-bears,7f781b86-edd9-4c2c-8d35-0759e20819d2_04-18-week4-PASSING_AND_PASSING,8,0,1253,0,0,96,0,0,1357
370510835,aicis/fresco,06/09/18 03:38,spirals-bears,7f781b86-edd9-4c2c-8d35-0759e20819d2_04-18-week4-PASSING_AND_PASSING,9,0,0,0,54,0,63
370628089,aicis/fresco,06/09/18 03:56,spirals-bears,7f781b86-edd9-4c2c-8d35-0759e20819d2_04-18-week4-PASSING_AND_PASSING,10,5,0,0,7,1134,0,0,4,0,1255,0,0,0,35,0,8,6,5,97,2566
370150700,aicis/fresco,06/09/18 04:01,spirals-bears,7f781b86-edd9-4c2c-8d35-0759e20819d2_04-18-week4-PASSING_AND_PASSING,9,0,1300,0,0,95,0,0,1404
371427144,SpoonLabs/nopol,06/09/18 04:02,spirals-bears,7f781b86-edd9-4c2c-8d35-0759e20819d2_04-18-week4-PASSING_AND_PASSING,42,0,0,42
372929519,swagger-api/swagger-codegen,06/09/18 04:03,spirals-bears,7f781b86-edd9-4c2c-8d35-0759e20819d2_04-18-week4-PASSING_AND_PASSING,35,4,39
373003639,swagger-api/swagger-codegen,06/09/18 04:04,spirals-bears,7f781b86-edd9-4c2c-8d35-0759e20819d2_04-18-week4-PASSING_AND_PASSING,34,5,39
370467437,aicis/fresco,06/09/18 04:08,spirals-bears,7f781b86-edd9-4c2c-8d35-0759e20819d2_04-18-week4-PASSING_AND_PASSING,9,6,0,0,7,377,0,0,4,0,1289,0,0,0,37,0,8,5,5,93,1840
372841498,swagger-api/swagger-codegen,06/09/18 04:10,spirals-bears,7f781b86-edd9-4c2c-8d35-0759e20819d2_04-18-week4-PASSING_AND_PASSING,34,0,56,0,7,251,0,7,355
371916614,swagger-api/swagger-codegen,06/09/18 04:10,spirals-bears,7f781b86-edd9-4c2c-8d35-0759e20819d2_04-18-week4-PASSING_AND_PASSING,32,0,0,10,74,9,125
347647350,swagger-api/swagger-codegen,06/09/18 04:12,spirals-bears,7f781b86-edd9-4c2c-8d35-0759e20819d2_04-18-week4-PASSING_AND_PASSING,34,0,1,8,80,7,130
369676062,swagger-api/swagger-codegen,06/09/18 04:13,spirals-bears,7f781b86-edd9-4c2c-8d35-0759e20819d2_04-18-week4-PASSING_AND_PASSING,33,0,0,6,6,45
369468274,swagger-api/swagger-codegen,06/09/18 04:14,spirals-bears,7f781b86-edd9-4c2c-8d35-0759e20819d2_04-18-week4-PASSING_AND_PASSING,34,4,38
372389346,junit-team/junit5-samples,06/09/18 04:15,spirals-bears,7f781b86-edd9-4c2c-8d35-0759e20819d2_04-18-week4-PASSING_AND_PASSING,2,0,10,0,0,15,0,0,27
372112732,junit-team/junit5-samples,06/09/18 04:15,spirals-bears,7f781b86-edd9-4c2c-8d35-0759e20819d2_04-18-week4-PASSING_AND_PASSING,2,2,4
369667209,junit-team/junit5-samples,06/09/18 04:15,spirals-bears,7f781b86-edd9-4c2c-8d35-0759e20819d2_04-18-week4-PASSING_AND_PASSING,2,1,3
369667183,junit-team/junit5-samples,06/09/18 04:15,spirals-bears,7f781b86-edd9-4c2c-8d35-0759e20819d2_04-18-week4-PASSING_AND_PASSING,2,0,2
369593872,junit-team/junit5-samples,06/09/18 04:16,spirals-bears,7f781b86-edd9-4c2c-8d35-0759e20819d2_04-18-week4-PASSING_AND_PASSING,3,3,6
369593514,junit-team/junit5-samples,06/09/18 04:16,spirals-bears,7f781b86-edd9-4c2c-8d35-0759e20819d2_04-18-week4-PASSING_AND_PASSING,2,0,2
369680502,swagger-api/swagger-codegen,06/09/18 04:16,spirals-bears,7f781b86-edd9-4c2c-8d35-0759e20819d2_04-18-week4-PASSING_AND_PASSING,33,0,65,0,8,225,0,6,337
372086703,spring-cloud/spring-cloud-gcp,06/09/18 04:16,spirals-bears,7f781b86-edd9-4c2c-8d35-0759e20819d2_04-18-week4-PASSING_AND_PASSING,4,2,6
370568847,aicis/fresco,06/09/18 04:16,spirals-bears,7f781b86-edd9-4c2c-8d35-0759e20819d2_04-18-week4-PASSING_AND_PASSING,11,6,0,0,7,1111,0,0,5,0,1287,0,0,0,44,0,8,5,5,97,2586
371099367,spring-cloud/spring-cloud-gcp,06/09/18 04:16,spirals-bears,7f781b86-edd9-4c2c-8d35-0759e20819d2_04-18-week4-PASSING_AND_PASSING,4,2,6
371648781,spring-cloud/spring-cloud-gcp,06/09/18 04:17,spirals-bears,7f781b86-edd9-4c2c-8d35-0759e20819d2_04-18-week4-PASSING_AND_PASSING,5,2,7
370126750,aicis/fresco,06/09/18 04:20,spirals-bears,7f781b86-edd9-4c2c-8d35-0759e20819d2_04-18-week4-PASSING_AND_PASSING,9,0,1304,0,0,98,0,0,1411
371684708,spring-cloud/spring-cloud-gcp,06/09/18 04:21,spirals-bears,7f781b86-edd9-4c2c-8d35-0759e20819d2_04-18-week4-PASSING_AND_PASSING,5,6,10,0,247,0,268
371604417,spring-cloud/spring-cloud-gcp,06/09/18 04:22,spirals-bears,7f781b86-edd9-4c2c-8d35-0759e20819d2_04-18-week4-PASSING_AND_PASSING,4,3,7
371645178,spring-cloud/spring-cloud-gcp,06/09/18 04:22,spirals-bears,7f781b86-edd9-4c2c-8d35-0759e20819d2_04-18-week4-PASSING_AND_PASSING,4,2,6
370684284,spring-cloud/spring-cloud-gcp,06/09/18 04:22,spirals-bears,7f781b86-edd9-4c2c-8d35-0759e20819d2_04-18-week4-PASSING_AND_PASSING,4,2,6
371154067,spring-cloud/spring-cloud-gcp,06/09/18 04:22,spirals-bears,7f781b86-edd9-4c2c-8d35-0759e20819d2_04-18-week4-PASSING_AND_PASSING,5,2,7
368244716,spring-cloud/spring-cloud-gcp,06/09/18 04:23,spirals-bears,7f781b86-edd9-4c2c-8d35-0759e20819d2_04-18-week4-PASSING_AND_PASSING,5,2,7
370712443,spring-cloud/spring-cloud-gcp,06/09/18 04:23,spirals-bears,7f781b86-edd9-4c2c-8d35-0759e20819d2_04-18-week4-PASSING_AND_PASSING,4,3,7
371758649,spring-cloud/spring-cloud-gcp,06/09/18 04:24,spirals-bears,7f781b86-edd9-4c2c-8d35-0759e20819d2_04-18-week4-PASSING_AND_PASSING,4,96,123,0,249,0,472
369347790,spring-cloud/spring-cloud-gcp,06/09/18 04:24,spirals-bears,7f781b86-edd9-4c2c-8d35-0759e20819d2_04-18-week4-PASSING_AND_PASSING,5,2,7
371642457,spring-cloud/spring-cloud-gcp,06/09/18 04:25,spirals-bears,7f781b86-edd9-4c2c-8d35-0759e20819d2_04-18-week4-PASSING_AND_PASSING,4,6,10,0,249,0,269
371685276,spring-cloud/spring-cloud-gcp,06/09/18 04:25,spirals-bears,7f781b86-edd9-4c2c-8d35-0759e20819d2_04-18-week4-PASSING_AND_PASSING,4,96,104,0,295,0,499
370281637,spring-cloud/spring-cloud-gcp,06/09/18 04:25,spirals-bears,7f781b86-edd9-4c2c-8d35-0759e20819d2_04-18-week4-PASSING_AND_PASSING,5,2,7
369284121,spring-cloud/spring-cloud-gcp,06/09/18 04:25,spirals-bears,7f781b86-edd9-4c2c-8d35-0759e20819d2_04-18-week4-PASSING_AND_PASSING,4,2,6
369299252,spring-cloud/spring-cloud-gcp,06/09/18 04:25,spirals-bears,7f781b86-edd9-4c2c-8d35-0759e20819d2_04-18-week4-PASSING_AND_PASSING,4,2,6
371275126,datastax/java-driver,06/09/18 04:26,spirals-bears,7f781b86-edd9-4c2c-8d35-0759e20819d2_04-18-week4-PASSING_AND_PASSING,18,2,20
371275100,datastax/java-driver,06/09/18 04:26,spirals-bears,7f781b86-edd9-4c2c-8d35-0759e20819d2_04-18-week4-PASSING_AND_PASSING,16,0,16
370787964,datastax/java-driver,06/09/18 04:26,spirals-bears,7f781b86-edd9-4c2c-8d35-0759e20819d2_04-18-week4-PASSING_AND_PASSING,18,2,20
370787952,datastax/java-driver,06/09/18 04:27,spirals-bears,7f781b86-edd9-4c2c-8d35-0759e20819d2_04-18-week4-PASSING_AND_PASSING,18,0,18
370828439,datastax/java-driver,06/09/18 04:29,spirals-bears,7f781b86-edd9-4c2c-8d35-0759e20819d2_04-18-week4-PASSING_AND_PASSING,17,0,0,0,73,1,91
367436862,datastax/java-driver,06/09/18 04:29,spirals-bears,7f781b86-edd9-4c2c-8d35-0759e20819d2_04-18-week4-PASSING_AND_PASSING,18,0,18
370785542,datastax/java-driver,06/09/18 04:31,spirals-bears,7f781b86-edd9-4c2c-8d35-0759e20819d2_04-18-week4-PASSING_AND_PASSING,17,0,0,0,60,1,78
369916320,spring-cloud/spring-cloud-gcp,06/09/18 04:31,spirals-bears,7f781b86-edd9-4c2c-8d35-0759e20819d2_04-18-week4-PASSING_AND_PASSING,5,28,57,0,245,0,335
370595659,datastax/java-driver,06/09/18 04:31,spirals-bears,7f781b86-edd9-4c2c-8d35-0759e20819d2_04-18-week4-PASSING_AND_PASSING,18,2,20
367437203,datastax/java-driver,06/09/18 04:31,spirals-bears,7f781b86-edd9-4c2c-8d35-0759e20819d2_04-18-week4-PASSING_AND_PASSING,17,2,19
370784296,datastax/java-driver,06/09/18 04:32,spirals-bears,7f781b86-edd9-4c2c-8d35-0759e20819d2_04-18-week4-PASSING_AND_PASSING,16,0,16
367859425,datastax/java-driver,06/09/18 04:32,spirals-bears,7f781b86-edd9-4c2c-8d35-0759e20819d2_04-18-week4-PASSING_AND_PASSING,18,0,18
370764701,datastax/java-driver,06/09/18 04:33,spirals-bears,7f781b86-edd9-4c2c-8d35-0759e20819d2_04-18-week4-PASSING_AND_PASSING,17,0,1,0,99,0,117
369426875,datastax/java-driver,06/09/18 04:34,spirals-bears,7f781b86-edd9-4c2c-8d35-0759e20819d2_04-18-week4-PASSING_AND_PASSING,15,0,0,0,70,0,85
370763508,datastax/java-driver,06/09/18 04:34,spirals-bears,7f781b86-edd9-4c2c-8d35-0759e20819d2_04-18-week4-PASSING_AND_PASSING,22,0,22
370594943,datastax/java-driver,06/09/18 04:34,spirals-bears,7f781b86-edd9-4c2c-8d35-0759e20819d2_04-18-week4-PASSING_AND_PASSING,16,0,16
370356033,datastax/java-driver,06/09/18 04:34,spirals-bears,7f781b86-edd9-4c2c-8d35-0759e20819d2_04-18-week4-PASSING_AND_PASSING,17,0,17
370285058,spring-cloud/spring-cloud-gcp,06/09/18 04:35,spirals-bears,7f781b86-edd9-4c2c-8d35-0759e20819d2_04-18-week4-PASSING_AND_PASSING,4,17,67,41,0,468,0,0,597
373114319,heptastique/onlygo,06/09/18 04:35,spirals-bears,7f781b86-edd9-4c2c-8d35-0759e20819d2_04-18-week4-PASSING_AND_PASSING,4,0,2,0,24,0,30
373063207,heptastique/onlygo,06/09/18 04:35,spirals-bears,7f781b86-edd9-4c2c-8d35-0759e20819d2_04-18-week4-PASSING_AND_PASSING,3,0,2,4,33,2,44
370354688,spring-cloud/spring-cloud-gcp,06/09/18 04:35,spirals-bears,7f781b86-edd9-4c2c-8d35-0759e20819d2_04-18-week4-PASSING_AND_PASSING,28,5,13,0,5,32,0,10,1,1,64,0,0,0,82,0,4,5,1,470,721
373063092,heptastique/onlygo,06/09/18 04:36,spirals-bears,7f781b86-edd9-4c2c-8d35-0759e20819d2_04-18-week4-PASSING_AND_PASSING,6,0,2,0,25,0,33
373054316,heptastique/onlygo,06/09/18 04:42,spirals-bears,7f781b86-edd9-4c2c-8d35-0759e20819d2_04-18-week4-PASSING_AND_PASSING,11,0,0,158,0,2,0,0,155,0,0,13,0,6,0,32,377
373055077,heptastique/onlygo,06/09/18 04:42,spirals-bears,7f781b86-edd9-4c2c-8d35-0759e20819d2_04-18-week4-PASSING_AND_PASSING,11,0,0,155,0,2,0,0,152,0,0,13,0,4,0,32,369
373056718,heptastique/onlygo,06/09/18 04:42,spirals-bears,7f781b86-edd9-4c2c-8d35-0759e20819d2_04-18-week4-PASSING_AND_PASSING,11,0,2,162,0,2,0,0,158,4,0,14,1,3,0,30,387
373015530,heptastique/onlygo,06/09/18 04:42,spirals-bears,7f781b86-edd9-4c2c-8d35-0759e20819d2_04-18-week4-PASSING_AND_PASSING,12,0,0,157,0,2,0,0,156,0,0,13,0,3,0,30,373
373034269,heptastique/onlygo,06/09/18 04:48,spirals-bears,7f781b86-edd9-4c2c-8d35-0759e20819d2_04-18-week4-PASSING_AND_PASSING,11,0,0,155,0,2,0,0,151,0,0,12,0,4,0,30,365
373035106,heptastique/onlygo,06/09/18 04:48,spirals-bears,7f781b86-edd9-4c2c-8d35-0759e20819d2_04-18-week4-PASSING_AND_PASSING,12,0,2,155,0,2,0,0,153,5,0,13,2,5,0,30,379
373039058,heptastique/onlygo,06/09/18 04:48,spirals-bears,7f781b86-edd9-4c2c-8d35-0759e20819d2_04-18-week4-PASSING_AND_PASSING,12,0,0,153,0,2,0,0,152,0,0,13,0,4,0,30,366
373014032,heptastique/onlygo,06/09/18 04:49,spirals-bears,7f781b86-edd9-4c2c-8d35-0759e20819d2_04-18-week4-PASSING_AND_PASSING,11,0,2,153,0,2,0,0,152,4,0,12,1,4,0,29,370
372916577,heptastique/onlygo,06/09/18 04:54,spirals-bears,7f781b86-edd9-4c2c-8d35-0759e20819d2_04-18-week4-PASSING_AND_PASSING,11,0,0,152,0,2,0,0,149,0,0,11,0,4,1,29,359
372916807,heptastique/onlygo,06/09/18 04:55,spirals-bears,7f781b86-edd9-4c2c-8d35-0759e20819d2_04-18-week4-PASSING_AND_PASSING,10,0,1,153,0,2,0,0,152,4,0,14,2,4,0,29,371
372912933,heptastique/onlygo,06/09/18 04:55,spirals-bears,7f781b86-edd9-4c2c-8d35-0759e20819d2_04-18-week4-PASSING_AND_PASSING,12,0,2,154,0,2,0,0,153,4,0,13,1,5,0,29,375
372912923,heptastique/onlygo,06/09/18 04:55,spirals-bears,7f781b86-edd9-4c2c-8d35-0759e20819d2_04-18-week4-PASSING_AND_PASSING,11,0,0,152,0,2,0,0,153,0,0,13,0,4,1,28,364
372928253,heptastique/onlygo,06/09/18 05:00,spirals-bears,7f781b86-edd9-4c2c-8d35-0759e20819d2_04-18-week4-PASSING_AND_PASSING,10,0,0,153,0,2,0,0,150,0,0,11,0,4,0,28,358
372921159,heptastique/onlygo,06/09/18 05:01,spirals-bears,7f781b86-edd9-4c2c-8d35-0759e20819d2_04-18-week4-PASSING_AND_PASSING,11,0,0,142,0,2,0,0,144,0,0,12,0,4,1,28,344
372900181,heptastique/onlygo,06/09/18 05:01,spirals-bears,7f781b86-edd9-4c2c-8d35-0759e20819d2_04-18-week4-PASSING_AND_PASSING,12,0,0,144,0,2,0,0,144,0,0,14,0,4,0,27,347
372926316,heptastique/onlygo,06/09/18 05:01,spirals-bears,7f781b86-edd9-4c2c-8d35-0759e20819d2_04-18-week4-PASSING_AND_PASSING,12,0,0,150,0,3,0,0,151,0,0,15,0,4,0,29,364
372907027,heptastique/onlygo,06/09/18 05:06,spirals-bears,7f781b86-edd9-4c2c-8d35-0759e20819d2_04-18-week4-PASSING_AND_PASSING,11,0,2,141,0,2,0,0,138,4,0,12,2,4,0,31,347
372908610,heptastique/onlygo,06/09/18 05:07,spirals-bears,7f781b86-edd9-4c2c-8d35-0759e20819d2_04-18-week4-PASSING_AND_PASSING,11,0,0,139,0,2,0,0,136,0,0,12,0,6,0,28,334
372903705,heptastique/onlygo,06/09/18 05:07,spirals-bears,7f781b86-edd9-4c2c-8d35-0759e20819d2_04-18-week4-PASSING_AND_PASSING,11,0,0,143,0,2,0,0,141,0,0,12,0,4,0,30,343
372904368,heptastique/onlygo,06/09/18 05:07,spirals-bears,7f781b86-edd9-4c2c-8d35-0759e20819d2_04-18-week4-PASSING_AND_PASSING,12,0,2,143,0,2,0,0,141,5,0,13,2,4,0,29,353
372900784,heptastique/onlygo,06/09/18 05:13,spirals-bears,7f781b86-edd9-4c2c-8d35-0759e20819d2_04-18-week4-PASSING_AND_PASSING,10,0,2,139,0,2,0,0,137,4,0,12,2,4,0,32,344
372778371,heptastique/onlygo,06/09/18 05:13,spirals-bears,7f781b86-edd9-4c2c-8d35-0759e20819d2_04-18-week4-PASSING_AND_PASSING,11,0,2,140,0,2,0,0,142,4,0,13,2,5,0,32,353
372795688,heptastique/onlygo,06/09/18 05:13,spirals-bears,7f781b86-edd9-4c2c-8d35-0759e20819d2_04-18-week4-PASSING_AND_PASSING,11,0,0,140,0,2,0,0,139,0,0,11,0,4,0,30,337
372796890,heptastique/onlygo,06/09/18 05:13,spirals-bears,7f781b86-edd9-4c2c-8d35-0759e20819d2_04-18-week4-PASSING_AND_PASSING,11,0,1,141,0,2,0,0,140,4,0,11,1,5,0,31,347
372094346,heptastique/onlygo,06/09/18 05:13,spirals-bears,7f781b86-edd9-4c2c-8d35-0759e20819d2_04-18-week4-PASSING_AND_PASSING,4,0,4
372894381,heptastique/onlygo,06/09/18 05:19,spirals-bears,7f781b86-edd9-4c2c-8d35-0759e20819d2_04-18-week4-PASSING_AND_PASSING,11,0,2,140,0,2,0,0,138,4,0,12,2,4,0,31,346
372791510,heptastique/onlygo,06/09/18 05:19,spirals-bears,7f781b86-edd9-4c2c-8d35-0759e20819d2_04-18-week4-PASSING_AND_PASSING,11,0,0,125,0,2,0,0,125,0,0,13,0,4,0,29,309
372791523,heptastique/onlygo,06/09/18 05:19,spirals-bears,7f781b86-edd9-4c2c-8d35-0759e20819d2_04-18-week4-PASSING_AND_PASSING,11,0,2,128,0,2,0,0,128,4,0,13,2,4,0,29,323
372894370,heptastique/onlygo,06/09/18 05:19,spirals-bears,7f781b86-edd9-4c2c-8d35-0759e20819d2_04-18-week4-PASSING_AND_PASSING,10,0,0,139,0,3,0,0,141,0,0,12,0,5,0,29,339
372718462,heptastique/onlygo,06/09/18 05:19,spirals-bears,7f781b86-edd9-4c2c-8d35-0759e20819d2_04-18-week4-PASSING_AND_PASSING,5,0,2,0,23,0,30
372095938,heptastique/onlygo,06/09/18 05:20,spirals-bears,7f781b86-edd9-4c2c-8d35-0759e20819d2_04-18-week4-PASSING_AND_PASSING,4,0,2,0,25,0,31
372096400,heptastique/onlygo,06/09/18 05:20,spirals-bears,7f781b86-edd9-4c2c-8d35-0759e20819d2_04-18-week4-PASSING_AND_PASSING,5,0,3,0,25,0,33
371936178,heptastique/onlygo,06/09/18 05:20,spirals-bears,7f781b86-edd9-4c2c-8d35-0759e20819d2_04-18-week4-PASSING_AND_PASSING,3,0,2,0,23,0,28
372015967,heptastique/onlygo,06/09/18 05:20,spirals-bears,7f781b86-edd9-4c2c-8d35-0759e20819d2_04-18-week4-PASSING_AND_PASSING,4,0,2,0,22,0,28
371938744,heptastique/onlygo,06/09/18 05:20,spirals-bears,7f781b86-edd9-4c2c-8d35-0759e20819d2_04-18-week4-PASSING_AND_PASSING,4,0,2,0,22,0,28
371573491,heptastique/onlygo,06/09/18 05:21,spirals-bears,7f781b86-edd9-4c2c-8d35-0759e20819d2_04-18-week4-PASSING_AND_PASSING,5,0,2,0,23,0,30
371892707,heptastique/onlygo,06/09/18 05:22,spirals-bears,7f781b86-edd9-4c2c-8d35-0759e20819d2_04-18-week4-PASSING_AND_PASSING,4,0,2,0,22,0,28
372790759,heptastique/onlygo,06/09/18 05:24,spirals-bears,7f781b86-edd9-4c2c-8d35-0759e20819d2_04-18-week4-PASSING_AND_PASSING,10,0,0,126,0,2,0,0,121,0,0,12,0,4,0,32,307
371933199,heptastique/onlygo,06/09/18 05:26,spirals-bears,7f781b86-edd9-4c2c-8d35-0759e20819d2_04-18-week4-PASSING_AND_PASSING,10,0,0,122,0,2,0,0,118,0,0,12,0,5,0,29,298
371936487,heptastique/onlygo,06/09/18 05:26,spirals-bears,7f781b86-edd9-4c2c-8d35-0759e20819d2_04-18-week4-PASSING_AND_PASSING,10,0,2,124,0,3,0,0,124,4,0,12,2,3,1,29,314
371774166,heptastique/onlygo,06/09/18 05:26,spirals-bears,7f781b86-edd9-4c2c-8d35-0759e20819d2_04-18-week4-PASSING_AND_PASSING,4,0,2,0,23,0,29
371769174,heptastique/onlygo,06/09/18 05:26,spirals-bears,7f781b86-edd9-4c2c-8d35-0759e20819d2_04-18-week4-PASSING_AND_PASSING,4,0,2,3,23,2,34
371769159,heptastique/onlygo,06/09/18 05:27,spirals-bears,7f781b86-edd9-4c2c-8d35-0759e20819d2_04-18-week4-PASSING_AND_PASSING,4,0,3,0,23,0,30
371889747,heptastique/onlygo,06/09/18 05:27,spirals-bears,7f781b86-edd9-4c2c-8d35-0759e20819d2_04-18-week4-PASSING_AND_PASSING,10,0,2,118,0,2,0,0,121,4,0,11,2,3,0,28,301
371764887,heptastique/onlygo,06/09/18 05:27,spirals-bears,7f781b86-edd9-4c2c-8d35-0759e20819d2_04-18-week4-PASSING_AND_PASSING,5,0,2,0,24,0,31
371765287,heptastique/onlygo,06/09/18 05:28,spirals-bears,7f781b86-edd9-4c2c-8d35-0759e20819d2_04-18-week4-PASSING_AND_PASSING,4,0,2,3,23,3,35
371724476,heptastique/onlygo,06/09/18 05:28,spirals-bears,7f781b86-edd9-4c2c-8d35-0759e20819d2_04-18-week4-PASSING_AND_PASSING,4,0,2,0,22,0,28
371721627,heptastique/onlygo,06/09/18 05:28,spirals-bears,7f781b86-edd9-4c2c-8d35-0759e20819d2_04-18-week4-PASSING_AND_PASSING,4,0,2,0,24,0,30
371628584,heptastique/onlygo,06/09/18 05:28,spirals-bears,7f781b86-edd9-4c2c-8d35-0759e20819d2_04-18-week4-PASSING_AND_PASSING,4,0,2,0,24,0,30
371629127,heptastique/onlygo,06/09/18 05:29,spirals-bears,7f781b86-edd9-4c2c-8d35-0759e20819d2_04-18-week4-PASSING_AND_PASSING,4,0,2,0,24,0,30
371721686,heptastique/onlygo,06/09/18 05:29,spirals-bears,7f781b86-edd9-4c2c-8d35-0759e20819d2_04-18-week4-PASSING_AND_PASSING,4,0,2,3,24,2,35
371708394,heptastique/onlygo,06/09/18 05:29,spirals-bears,7f781b86-edd9-4c2c-8d35-0759e20819d2_04-18-week4-PASSING_AND_PASSING,4,0,2,0,22,0,28
371889534,heptastique/onlygo,06/09/18 05:29,spirals-bears,7f781b86-edd9-4c2c-8d35-0759e20819d2_04-18-week4-PASSING_AND_PASSING,11,0,0,121,0,2,0,0,121,0,0,13,0,4,1,27,300
371708423,heptastique/onlygo,06/09/18 05:29,spirals-bears,7f781b86-edd9-4c2c-8d35-0759e20819d2_04-18-week4-PASSING_AND_PASSING,4,0,2,3,25,2,36
371707413,heptastique/onlygo,06/09/18 05:30,spirals-bears,7f781b86-edd9-4c2c-8d35-0759e20819d2_04-18-week4-PASSING_AND_PASSING,4,0,2,0,0,6
371707448,heptastique/onlygo,06/09/18 05:30,spirals-bears,7f781b86-edd9-4c2c-8d35-0759e20819d2_04-18-week4-PASSING_AND_PASSING,4,0,3,4,2,13
371583512,heptastique/onlygo,06/09/18 05:30,spirals-bears,7f781b86-edd9-4c2c-8d35-0759e20819d2_04-18-week4-PASSING_AND_PASSING,5,0,2,0,21,0,28
371598522,heptastique/onlygo,06/09/18 05:30,spirals-bears,7f781b86-edd9-4c2c-8d35-0759e20819d2_04-18-week4-PASSING_AND_PASSING,4,0,2,0,24,0,30
371576246,heptastique/onlygo,06/09/18 05:31,spirals-bears,7f781b86-edd9-4c2c-8d35-0759e20819d2_04-18-week4-PASSING_AND_PASSING,4,0,2,4,23,2,35
371600003,heptastique/onlygo,06/09/18 05:32,spirals-bears,7f781b86-edd9-4c2c-8d35-0759e20819d2_04-18-week4-PASSING_AND_PASSING,4,0,2,0,22,0,28
371713500,heptastique/onlygo,06/09/18 05:33,spirals-bears,7f781b86-edd9-4c2c-8d35-0759e20819d2_04-18-week4-PASSING_AND_PASSING,11,0,0,117,0,2,0,0,112,0,0,11,0,5,0,29,287
371583648,heptastique/onlygo,06/09/18 05:34,spirals-bears,7f781b86-edd9-4c2c-8d35-0759e20819d2_04-18-week4-PASSING_AND_PASSING,6,0,2,0,21,0,29
371610612,heptastique/onlygo,06/09/18 05:35,spirals-bears,7f781b86-edd9-4c2c-8d35-0759e20819d2_04-18-week4-PASSING_AND_PASSING,11,0,0,113,0,2,0,0,111,0,0,11,0,4,0,30,282
371581474,heptastique/onlygo,06/09/18 05:35,spirals-bears,7f781b86-edd9-4c2c-8d35-0759e20819d2_04-18-week4-PASSING_AND_PASSING,4,0,2,0,22,0,28
371610625,heptastique/onlygo,06/09/18 05:35,spirals-bears,7f781b86-edd9-4c2c-8d35-0759e20819d2_04-18-week4-PASSING_AND_PASSING,10,0,2,113,0,2,0,0,113,4,0,10,1,4,0,27,286
371563596,heptastique/onlygo,06/09/18 05:36,spirals-bears,7f781b86-edd9-4c2c-8d35-0759e20819d2_04-18-week4-PASSING_AND_PASSING,11,0,0,109,0,2,1,0,105,0,0,12,0,3,0,28,271
371562394,heptastique/onlygo,06/09/18 05:39,spirals-bears,7f781b86-edd9-4c2c-8d35-0759e20819d2_04-18-week4-PASSING_AND_PASSING,10,0,0,103,0,2,0,0,104,0,0,12,0,4,0,27,262
371573611,heptastique/onlygo,06/09/18 05:39,spirals-bears,7f781b86-edd9-4c2c-8d35-0759e20819d2_04-18-week4-PASSING_AND_PASSING,10,0,1,104,0,2,0,0,106,4,0,11,2,4,0,28,272
371562413,heptastique/onlygo,06/09/18 05:40,spirals-bears,7f781b86-edd9-4c2c-8d35-0759e20819d2_04-18-week4-PASSING_AND_PASSING,11,0,1,102,0,2,0,0,104,4,0,13,2,4,0,28,271
371476463,heptastique/onlygo,06/09/18 05:40,spirals-bears,7f781b86-edd9-4c2c-8d35-0759e20819d2_04-18-week4-PASSING_AND_PASSING,5,0,2,0,22,0,29
371477360,heptastique/onlygo,06/09/18 05:41,spirals-bears,7f781b86-edd9-4c2c-8d35-0759e20819d2_04-18-week4-PASSING_AND_PASSING,11,0,0,99,0,2,0,0,102,0,0,12,0,4,0,27,257
371561293,heptastique/onlygo,06/09/18 05:44,spirals-bears,7f781b86-edd9-4c2c-8d35-0759e20819d2_04-18-week4-PASSING_AND_PASSING,10,0,0,100,0,2,0,0,97,0,0,12,0,5,0,29,255
371501815,heptastique/onlygo,06/09/18 05:45,spirals-bears,7f781b86-edd9-4c2c-8d35-0759e20819d2_04-18-week4-PASSING_AND_PASSING,10,0,0,105,0,2,0,0,104,0,0,11,0,4,0,27,263
371501830,heptastique/onlygo,06/09/18 05:45,spirals-bears,7f781b86-edd9-4c2c-8d35-0759e20819d2_04-18-week4-PASSING_AND_PASSING,11,0,2,105,0,2,0,0,103,4,0,13,2,5,0,27,274
371457864,heptastique/onlygo,06/09/18 05:45,spirals-bears,7f781b86-edd9-4c2c-8d35-0759e20819d2_04-18-week4-PASSING_AND_PASSING,4,0,2,0,0,6
371541677,heptastique/onlygo,06/09/18 05:45,spirals-bears,7f781b86-edd9-4c2c-8d35-0759e20819d2_04-18-week4-PASSING_AND_PASSING,11,0,0,98,0,2,0,0,102,0,0,11,0,4,0,27,255
371453578,heptastique/onlygo,06/09/18 05:45,spirals-bears,7f781b86-edd9-4c2c-8d35-0759e20819d2_04-18-week4-PASSING_AND_PASSING,3,0,3
371446275,heptastique/onlygo,06/09/18 05:48,spirals-bears,7f781b86-edd9-4c2c-8d35-0759e20819d2_04-18-week4-PASSING_AND_PASSING,11,0,0,103,0,2,0,0,99,0,0,10,0,4,0,29,258
371214119,heptastique/onlygo,06/09/18 05:49,spirals-bears,7f781b86-edd9-4c2c-8d35-0759e20819d2_04-18-week4-PASSING_AND_PASSING,11,0,0,102,0,2,0,0,100,0,0,11,0,4,0,29,259
371437528,heptastique/onlygo,06/09/18 05:50,spirals-bears,7f781b86-edd9-4c2c-8d35-0759e20819d2_04-18-week4-PASSING_AND_PASSING,11,0,0,100,0,2,0,0,101,0,0,12,0,4,0,29,259
371437547,heptastique/onlygo,06/09/18 05:50,spirals-bears,7f781b86-edd9-4c2c-8d35-0759e20819d2_04-18-week4-PASSING_AND_PASSING,12,0,2,103,0,2,0,0,102,4,0,11,2,5,0,28,271
371284001,heptastique/onlygo,06/09/18 05:53,spirals-bears,7f781b86-edd9-4c2c-8d35-0759e20819d2_04-18-week4-PASSING_AND_PASSING,10,0,2,99,0,2,0,0,95,4,0,13,1,5,0,28,259
371130009,heptastique/onlygo,06/09/18 05:53,spirals-bears,7f781b86-edd9-4c2c-8d35-0759e20819d2_04-18-week4-PASSING_AND_PASSING,11,0,0,64,0,2,0,0,65,0,0,11,0,3,0,29,185
371283984,heptastique/onlygo,06/09/18 05:54,spirals-bears,7f781b86-edd9-4c2c-8d35-0759e20819d2_04-18-week4-PASSING_AND_PASSING,11,0,0,98,0,2,0,0,96,0,0,12,0,4,0,29,252
371280884,heptastique/onlygo,06/09/18 05:55,spirals-bears,7f781b86-edd9-4c2c-8d35-0759e20819d2_04-18-week4-PASSING_AND_PASSING,10,0,2,94,0,2,0,0,93,4,0,11,2,4,0,26,248
371277180,heptastique/onlygo,06/09/18 05:57,spirals-bears,7f781b86-edd9-4c2c-8d35-0759e20819d2_04-18-week4-PASSING_AND_PASSING,11,0,0,97,0,2,0,0,94,0,0,10,0,5,0,28,247
371261243,heptastique/onlygo,06/09/18 05:57,spirals-bears,7f781b86-edd9-4c2c-8d35-0759e20819d2_04-18-week4-PASSING_AND_PASSING,11,0,0,95,0,2,0,0,93,0,0,10,0,4,0,27,242
371261608,heptastique/onlygo,06/09/18 05:58,spirals-bears,7f781b86-edd9-4c2c-8d35-0759e20819d2_04-18-week4-PASSING_AND_PASSING,10,0,2,91,0,2,0,0,91,4,0,11,2,3,0,26,242
371243277,heptastique/onlygo,06/09/18 05:59,spirals-bears,7f781b86-edd9-4c2c-8d35-0759e20819d2_04-18-week4-PASSING_AND_PASSING,10,0,0,92,0,2,0,0,93,0,0,11,0,4,0,26,238
371203623,heptastique/onlygo,06/09/18 06:01,spirals-bears,7f781b86-edd9-4c2c-8d35-0759e20819d2_04-18-week4-PASSING_AND_PASSING,11,0,0,66,0,2,0,0,65,0,0,12,0,4,0,28,188
371121535,heptastique/onlygo,06/09/18 06:01,spirals-bears,7f781b86-edd9-4c2c-8d35-0759e20819d2_04-18-week4-PASSING_AND_PASSING,11,0,0,62,0,2,0,0,63,0,0,14,0,5,0,28,185
371114121,heptastique/onlygo,06/09/18 06:01,spirals-bears,7f781b86-edd9-4c2c-8d35-0759e20819d2_04-18-week4-PASSING_AND_PASSING,12,0,0,55,0,2,0,0,53,0,0,12,0,4,0,28,166
371113046,heptastique/onlygo,06/09/18 06:01,spirals-bears,7f781b86-edd9-4c2c-8d35-0759e20819d2_04-18-week4-PASSING_AND_PASSING,5,0,3,0,22,1,31
371113090,heptastique/onlygo,06/09/18 06:02,spirals-bears,7f781b86-edd9-4c2c-8d35-0759e20819d2_04-18-week4-PASSING_AND_PASSING,4,0,3,3,22,2,34
371114140,heptastique/onlygo,06/09/18 06:02,spirals-bears,7f781b86-edd9-4c2c-8d35-0759e20819d2_04-18-week4-PASSING_AND_PASSING,11,0,2,57,0,2,0,0,54,5,0,12,2,5,0,28,178
371103180,heptastique/onlygo,06/09/18 06:02,spirals-bears,7f781b86-edd9-4c2c-8d35-0759e20819d2_04-18-week4-PASSING_AND_PASSING,4,0,2,3,22,2,33
371098104,heptastique/onlygo,06/09/18 06:03,spirals-bears,7f781b86-edd9-4c2c-8d35-0759e20819d2_04-18-week4-PASSING_AND_PASSING,4,0,2,0,23,0,29
371082756,heptastique/onlygo,06/09/18 06:03,spirals-bears,7f781b86-edd9-4c2c-8d35-0759e20819d2_04-18-week4-PASSING_AND_PASSING,4,0,2,0,24,0,30
371074632,heptastique/onlygo,06/09/18 06:03,spirals-bears,7f781b86-edd9-4c2c-8d35-0759e20819d2_04-18-week4-PASSING_AND_PASSING,6,0,2,0,22,0,30
371089132,heptastique/onlygo,06/09/18 06:04,spirals-bears,7f781b86-edd9-4c2c-8d35-0759e20819d2_04-18-week4-PASSING_AND_PASSING,12,0,0,56,0,3,0,0,52,1,0,12,0,5,0,28,169
371101837,heptastique/onlygo,06/09/18 06:05,spirals-bears,7f781b86-edd9-4c2c-8d35-0759e20819d2_04-18-week4-PASSING_AND_PASSING,11,0,0,53,0,2,0,0,50,0,0,10,0,4,0,29,159
370952705,heptastique/onlygo,06/09/18 06:05,spirals-bears,7f781b86-edd9-4c2c-8d35-0759e20819d2_04-18-week4-PASSING_AND_PASSING,11,0,0,37,0,2,0,0,38,0,0,12,0,4,0,27,131
371074211,heptastique/onlygo,06/09/18 06:06,spirals-bears,7f781b86-edd9-4c2c-8d35-0759e20819d2_04-18-week4-PASSING_AND_PASSING,11,0,2,43,0,2,0,0,44,4,0,12,2,3,0,27,150
371074207,heptastique/onlygo,06/09/18 06:06,spirals-bears,7f781b86-edd9-4c2c-8d35-0759e20819d2_04-18-week4-PASSING_AND_PASSING,11,0,0,44,0,2,0,0,44,0,0,12,0,4,0,26,143
371069143,heptastique/onlygo,06/09/18 06:07,spirals-bears,7f781b86-edd9-4c2c-8d35-0759e20819d2_04-18-week4-PASSING_AND_PASSING,10,0,0,40,0,2,0,0,40,0,0,12,0,4,0,27,135
371073734,heptastique/onlygo,06/09/18 06:08,spirals-bears,7f781b86-edd9-4c2c-8d35-0759e20819d2_04-18-week4-PASSING_AND_PASSING,11,0,1,43,0,2,0,0,43,4,0,13,1,5,0,29,152
371073710,heptastique/onlygo,06/09/18 06:09,spirals-bears,7f781b86-edd9-4c2c-8d35-0759e20819d2_04-18-week4-PASSING_AND_PASSING,10,0,0,43,0,2,0,0,41,0,0,12,0,4,0,28,140
371072418,heptastique/onlygo,06/09/18 06:09,spirals-bears,7f781b86-edd9-4c2c-8d35-0759e20819d2_04-18-week4-PASSING_AND_PASSING,10,0,2,41,0,2,0,0,39,4,0,12,2,5,0,30,147
371071989,heptastique/onlygo,06/09/18 06:10,spirals-bears,7f781b86-edd9-4c2c-8d35-0759e20819d2_04-18-week4-PASSING_AND_PASSING,11,0,0,39,0,2,0,0,40,0,0,13,0,4,0,28,137
370908201,heptastique/onlygo,06/09/18 06:10,spirals-bears,7f781b86-edd9-4c2c-8d35-0759e20819d2_04-18-week4-PASSING_AND_PASSING,3,0,2,0,21,0,26
370908235,heptastique/onlygo,06/09/18 06:10,spirals-bears,7f781b86-edd9-4c2c-8d35-0759e20819d2_04-18-week4-PASSING_AND_PASSING,5,0,2,4,21,2,34
370788698,heptastique/onlygo,06/09/18 06:10,spirals-bears,7f781b86-edd9-4c2c-8d35-0759e20819d2_04-18-week4-PASSING_AND_PASSING,4,0,2,0,21,0,27
371064185,heptastique/onlygo,06/09/18 06:11,spirals-bears,7f781b86-edd9-4c2c-8d35-0759e20819d2_04-18-week4-PASSING_AND_PASSING,11,0,0,42,0,2,0,0,38,0,0,11,0,4,0,28,136
371014900,heptastique/onlygo,06/09/18 06:11,spirals-bears,7f781b86-edd9-4c2c-8d35-0759e20819d2_04-18-week4-PASSING_AND_PASSING,10,0,0,35,0,2,0,0,37,0,0,12,0,4,0,28,128
368500690,alipay/sofa-rpc-boot-projects,06/09/18 06:12,spirals-bears,7f781b86-edd9-4c2c-8d35-0759e20819d2_04-18-week4-PASSING_AND_PASSING,2,0,1,0,30,0,33
370222579,heptastique/onlygo,06/09/18 06:12,spirals-bears,7f781b86-edd9-4c2c-8d35-0759e20819d2_04-18-week4-PASSING_AND_PASSING,12,0,0,25,0,2,0,0,22,0,0,10,0,4,0,25,100
370287144,heptastique/onlygo,06/09/18 06:12,spirals-bears,7f781b86-edd9-4c2c-8d35-0759e20819d2_04-18-week4-PASSING_AND_PASSING,12,0,0,26,0,3,0,0,22,0,0,9,0,4,0,25,101
369820781,SzFMV2018-Tavasz/AutomatedCar,06/09/18 06:13,spirals-bears,7f781b86-edd9-4c2c-8d35-0759e20819d2_04-18-week4-PASSING_AND_PASSING,9,0,0,0,18,0,27
370648084,SzFMV2018-Tavasz/AutomatedCar,06/09/18 06:13,spirals-bears,7f781b86-edd9-4c2c-8d35-0759e20819d2_04-18-week4-PASSING_AND_PASSING,10,0,0,0,20,0,30
372902325,SzFMV2018-Tavasz/AutomatedCar,06/09/18 06:13,spirals-bears,7f781b86-edd9-4c2c-8d35-0759e20819d2_04-18-week4-PASSING_AND_PASSING,10,0,0,0,20,0,30
372382076,SzFMV2018-Tavasz/AutomatedCar,06/09/18 06:13,spirals-bears,7f781b86-edd9-4c2c-8d35-0759e20819d2_04-18-week4-PASSING_AND_PASSING,8,0,1,0,20,0,29
372381362,SzFMV2018-Tavasz/AutomatedCar,06/09/18 06:13,spirals-bears,7f781b86-edd9-4c2c-8d35-0759e20819d2_04-18-week4-PASSING_AND_PASSING,9,0,0,0,21,0,30
372624292,SzFMV2018-Tavasz/AutomatedCar,06/09/18 06:14,spirals-bears,7f781b86-edd9-4c2c-8d35-0759e20819d2_04-18-week4-PASSING_AND_PASSING,9,0,0,0,19,0,28
370003666,SzFMV2018-Tavasz/AutomatedCar,06/09/18 06:14,spirals-bears,7f781b86-edd9-4c2c-8d35-0759e20819d2_04-18-week4-PASSING_AND_PASSING,9,0,0,0,19,0,28
372357255,SzFMV2018-Tavasz/AutomatedCar,06/09/18 06:14,spirals-bears,7f781b86-edd9-4c2c-8d35-0759e20819d2_04-18-week4-PASSING_AND_PASSING,9,0,0,0,21,0,30
370020787,SzFMV2018-Tavasz/AutomatedCar,06/09/18 06:14,spirals-bears,7f781b86-edd9-4c2c-8d35-0759e20819d2_04-18-week4-PASSING_AND_PASSING,10,0,0,0,21,0,31
370020822,SzFMV2018-Tavasz/AutomatedCar,06/09/18 06:15,spirals-bears,7f781b86-edd9-4c2c-8d35-0759e20819d2_04-18-week4-PASSING_AND_PASSING,9,0,0,4,18,3,34
372343336,SzFMV2018-Tavasz/AutomatedCar,06/09/18 06:15,spirals-bears,7f781b86-edd9-4c2c-8d35-0759e20819d2_04-18-week4-PASSING_AND_PASSING,9,0,0,0,21,0,30
369959860,SzFMV2018-Tavasz/AutomatedCar,06/09/18 06:15,spirals-bears,7f781b86-edd9-4c2c-8d35-0759e20819d2_04-18-week4-PASSING_AND_PASSING,10,0,0,0,22,0,32
370639441,SzFMV2018-Tavasz/AutomatedCar,06/09/18 06:15,spirals-bears,7f781b86-edd9-4c2c-8d35-0759e20819d2_04-18-week4-PASSING_AND_PASSING,10,0,0,0,18,0,28
367337536,SzFMV2018-Tavasz/AutomatedCar,06/09/18 06:16,spirals-bears,7f781b86-edd9-4c2c-8d35-0759e20819d2_04-18-week4-PASSING_AND_PASSING,9,0,0,0,21,0,30
370044515,SzFMV2018-Tavasz/AutomatedCar,06/09/18 06:16,spirals-bears,7f781b86-edd9-4c2c-8d35-0759e20819d2_04-18-week4-PASSING_AND_PASSING,9,0,0,0,21,0,30
370043706,SzFMV2018-Tavasz/AutomatedCar,06/09/18 06:16,spirals-bears,7f781b86-edd9-4c2c-8d35-0759e20819d2_04-18-week4-PASSING_AND_PASSING,9,0,0,0,18,0,27
369995672,SzFMV2018-Tavasz/AutomatedCar,06/09/18 06:16,spirals-bears,7f781b86-edd9-4c2c-8d35-0759e20819d2_04-18-week4-PASSING_AND_PASSING,9,0,0,0,20,0,29
370106359,SzFMV2018-Tavasz/AutomatedCar,06/09/18 06:16,spirals-bears,7f781b86-edd9-4c2c-8d35-0759e20819d2_04-18-week4-PASSING_AND_PASSING,9,0,0,0,21,0,30
370102043,SzFMV2018-Tavasz/AutomatedCar,06/09/18 06:17,spirals-bears,7f781b86-edd9-4c2c-8d35-0759e20819d2_04-18-week4-PASSING_AND_PASSING,10,0,1,0,18,0,29
369842254,SzFMV2018-Tavasz/AutomatedCar,06/09/18 06:17,spirals-bears,7f781b86-edd9-4c2c-8d35-0759e20819d2_04-18-week4-PASSING_AND_PASSING,9,0,0,0,19,0,28
369719761,SzFMV2018-Tavasz/AutomatedCar,06/09/18 06:17,spirals-bears,7f781b86-edd9-4c2c-8d35-0759e20819d2_04-18-week4-PASSING_AND_PASSING,10,0,0,0,21,0,31
369843364,SzFMV2018-Tavasz/AutomatedCar,06/09/18 06:17,spirals-bears,7f781b86-edd9-4c2c-8d35-0759e20819d2_04-18-week4-PASSING_AND_PASSING,9,0,0,4,18,2,33
370002736,SzFMV2018-Tavasz/AutomatedCar,06/09/18 06:18,spirals-bears,7f781b86-edd9-4c2c-8d35-0759e20819d2_04-18-week4-PASSING_AND_PASSING,9,0,0,0,19,0,28
369876535,SzFMV2018-Tavasz/AutomatedCar,06/09/18 06:18,spirals-bears,7f781b86-edd9-4c2c-8d35-0759e20819d2_04-18-week4-PASSING_AND_PASSING,10,0,13,0,4,21,0,2,50
369876121,SzFMV2018-Tavasz/AutomatedCar,06/09/18 06:18,spirals-bears,7f781b86-edd9-4c2c-8d35-0759e20819d2_04-18-week4-PASSING_AND_PASSING,10,0,15,0,0,21,0,0,46
369719148,SzFMV2018-Tavasz/AutomatedCar,06/09/18 06:19,spirals-bears,7f781b86-edd9-4c2c-8d35-0759e20819d2_04-18-week4-PASSING_AND_PASSING,9,0,16,0,0,21,0,0,46
367765481,SzFMV2018-Tavasz/AutomatedCar,06/09/18 06:19,spirals-bears,7f781b86-edd9-4c2c-8d35-0759e20819d2_04-18-week4-PASSING_AND_PASSING,10,0,0,0,18,0,28
368242946,SzFMV2018-Tavasz/AutomatedCar,06/09/18 06:19,spirals-bears,7f781b86-edd9-4c2c-8d35-0759e20819d2_04-18-week4-PASSING_AND_PASSING,9,0,0,0,19,0,28
367724825,SzFMV2018-Tavasz/AutomatedCar,06/09/18 06:20,spirals-bears,7f781b86-edd9-4c2c-8d35-0759e20819d2_04-18-week4-PASSING_AND_PASSING,10,0,0,0,5,13,0,0,0,0,13,0,0,0,10,0,9,0,0,23,83
362330385,SzFMV2018-Tavasz/AutomatedCar,06/09/18 06:20,spirals-bears,7f781b86-edd9-4c2c-8d35-0759e20819d2_04-18-week4-PASSING_AND_PASSING,9,0,0,0,20,0,29
369207868,SzFMV2018-Tavasz/AutomatedCar,06/09/18 06:20,spirals-bears,7f781b86-edd9-4c2c-8d35-0759e20819d2_04-18-week4-PASSING_AND_PASSING,9,0,16,0,0,22,0,0,47
373003697,Activiti/activiti-cloud-service-common,06/09/18 06:21,spirals-bears,7f781b86-edd9-4c2c-8d35-0759e20819d2_04-18-week4-PASSING_AND_PASSING,2,3,3,0,38,0,46
359785036,Activiti/activiti-cloud-service-common,06/09/18 06:21,spirals-bears,7f781b86-edd9-4c2c-8d35-0759e20819d2_04-18-week4-PASSING_AND_PASSING,3,3,3,0,35,0,44
344188462,dhis2/dhis2-core,06/09/18 06:21,spirals-bears,7f781b86-edd9-4c2c-8d35-0759e20819d2_04-18-week4-PASSING_AND_PASSING,23,3,26
371077785,dhis2/dhis2-core,06/09/18 06:33,spirals-bears,7f781b86-edd9-4c2c-8d35-0759e20819d2_04-18-week4-PASSING_AND_PASSING,24,0,453,0,7,191,0,6,681
370567446,dhis2/dhis2-core,06/09/18 06:35,spirals-bears,7f781b86-edd9-4c2c-8d35-0759e20819d2_04-18-week4-PASSING_AND_PASSING,22,0,0,5,109,5,141
370554702,dhis2/dhis2-core,06/09/18 06:36,spirals-bears,7f781b86-edd9-4c2c-8d35-0759e20819d2_04-18-week4-PASSING_AND_PASSING,23,3,26
371482935,dhis2/dhis2-core,06/09/18 06:38,spirals-bears,7f781b86-edd9-4c2c-8d35-0759e20819d2_04-18-week4-PASSING_AND_PASSING,12,6,0,2,10,301,0,1,9,0,463,0,7,1,28,3,23,6,9,202,1083
369032783,dhis2/dhis2-core,06/09/18 06:39,spirals-bears,7f781b86-edd9-4c2c-8d35-0759e20819d2_04-18-week4-PASSING_AND_PASSING,13,7,0,3,10,291,0,0,9,0,465,0,7,1,29,4,24,6,8,198,1075
370546043,dhis2/dhis2-core,06/09/18 06:47,spirals-bears,7f781b86-edd9-4c2c-8d35-0759e20819d2_04-18-week4-PASSING_AND_PASSING,22,0,469,1,1,191,0,1,685
369990841,dhis2/dhis2-core,06/09/18 06:52,spirals-bears,7f781b86-edd9-4c2c-8d35-0759e20819d2_04-18-week4-PASSING_AND_PASSING,11,6,0,0,11,133,0,1,9,0,375,0,0,0,18,0,23,7,6,169,769
361568393,debezium/debezium,06/09/18 06:53,spirals-bears,7f781b86-edd9-4c2c-8d35-0759e20819d2_04-18-week4-PASSING_AND_PASSING,6,3,9
371678908,debezium/debezium,06/09/18 06:53,spirals-bears,7f781b86-edd9-4c2c-8d35-0759e20819d2_04-18-week4-PASSING_AND_PASSING,7,4,11
369477868,debezium/debezium,06/09/18 06:53,spirals-bears,7f781b86-edd9-4c2c-8d35-0759e20819d2_04-18-week4-PASSING_AND_PASSING,6,2,8
368635979,dhis2/dhis2-core,06/09/18 06:57,spirals-bears,7f781b86-edd9-4c2c-8d35-0759e20819d2_04-18-week4-PASSING_AND_PASSING,12,7,0,3,11,304,0,1,8,0,470,0,7,1,27,4,25,7,8,198,1093
369685027,debezium/debezium,06/09/18 06:58,spirals-bears,7f781b86-edd9-4c2c-8d35-0759e20819d2_04-18-week4-PASSING_AND_PASSING,10,1,0,2,5,32,0,1,1,0,45,0,4,0,21,2,6,1,1,122,254
372909947,MyCoRe-Org/mycore,06/09/18 06:59,spirals-bears,7f781b86-edd9-4c2c-8d35-0759e20819d2_04-18-week4-PASSING_AND_PASSING,75,0,75
371542547,MyCoRe-Org/mycore,06/09/18 07:00,spirals-bears,7f781b86-edd9-4c2c-8d35-0759e20819d2_04-18-week4-PASSING_AND_PASSING,44,5,49
371542520,MyCoRe-Org/mycore,06/09/18 07:01,spirals-bears,7f781b86-edd9-4c2c-8d35-0759e20819d2_04-18-week4-PASSING_AND_PASSING,47,0,47
367650099,MyCoRe-Org/mycore,06/09/18 07:02,spirals-bears,7f781b86-edd9-4c2c-8d35-0759e20819d2_04-18-week4-PASSING_AND_PASSING,46,3,49
367650093,MyCoRe-Org/mycore,06/09/18 07:03,spirals-bears,7f781b86-edd9-4c2c-8d35-0759e20819d2_04-18-week4-PASSING_AND_PASSING,82,0,82
370045454,dhis2/dhis2-core,06/09/18 07:03,spirals-bears,7f781b86-edd9-4c2c-8d35-0759e20819d2_04-18-week4-PASSING_AND_PASSING,12,7,0,0,10,155,0,0,8,0,476,0,0,0,20,0,22,8,7,195,920
371558488,MyCoRe-Org/mycore,06/09/18 07:03,spirals-bears,7f781b86-edd9-4c2c-8d35-0759e20819d2_04-18-week4-PASSING_AND_PASSING,50,39,41,0,190,1,321
370536992,MyCoRe-Org/mycore,06/09/18 07:04,spirals-bears,7f781b86-edd9-4c2c-8d35-0759e20819d2_04-18-week4-PASSING_AND_PASSING,51,0,51
371840414,2018swecapstone/h2ms,06/09/18 07:05,spirals-bears,7f781b86-edd9-4c2c-8d35-0759e20819d2_04-18-week4-PASSING_AND_PASSING,3,0,2,4,68,3,80
372789342,2018swecapstone/h2ms,06/09/18 07:05,spirals-bears,7f781b86-edd9-4c2c-8d35-0759e20819d2_04-18-week4-PASSING_AND_PASSING,4,0,2,4,68,3,81
372751454,2018swecapstone/h2ms,06/09/18 07:06,spirals-bears,7f781b86-edd9-4c2c-8d35-0759e20819d2_04-18-week4-PASSING_AND_PASSING,3,0,2,3,67,3,78
372751674,2018swecapstone/h2ms,06/09/18 07:06,spirals-bears,7f781b86-edd9-4c2c-8d35-0759e20819d2_04-18-week4-PASSING_AND_PASSING,3,0,2,0,67,0,72
371359496,2018swecapstone/h2ms,06/09/18 07:07,spirals-bears,7f781b86-edd9-4c2c-8d35-0759e20819d2_04-18-week4-PASSING_AND_PASSING,4,0,2,4,65,2,77
372209377,2018swecapstone/h2ms,06/09/18 07:09,spirals-bears,7f781b86-edd9-4c2c-8d35-0759e20819d2_04-18-week4-PASSING_AND_PASSING,3,0,131,2,4,73,0,2,215
371815796,2018swecapstone/h2ms,06/09/18 07:09,spirals-bears,7f781b86-edd9-4c2c-8d35-0759e20819d2_04-18-week4-PASSING_AND_PASSING,3,0,1,4,63,2,73
371858867,2018swecapstone/h2ms,06/09/18 07:09,spirals-bears,7f781b86-edd9-4c2c-8d35-0759e20819d2_04-18-week4-PASSING_AND_PASSING,4,0,132,2,0,72,0,0,210
371552188,2018swecapstone/h2ms,06/09/18 07:10,spirals-bears,7f781b86-edd9-4c2c-8d35-0759e20819d2_04-18-week4-PASSING_AND_PASSING,4,0,2,3,67,3,79
370853549,2018swecapstone/h2ms,06/09/18 07:10,spirals-bears,7f781b86-edd9-4c2c-8d35-0759e20819d2_04-18-week4-PASSING_AND_PASSING,3,0,2,0,66,0,71
370384117,2018swecapstone/h2ms,06/09/18 07:12,spirals-bears,7f781b86-edd9-4c2c-8d35-0759e20819d2_04-18-week4-PASSING_AND_PASSING,4,0,2,0,65,0,71
368459870,2018swecapstone/h2ms,06/09/18 07:12,spirals-bears,7f781b86-edd9-4c2c-8d35-0759e20819d2_04-18-week4-PASSING_AND_PASSING,4,0,1,4,65,3,77
370883199,2018swecapstone/h2ms,06/09/18 07:13,spirals-bears,7f781b86-edd9-4c2c-8d35-0759e20819d2_04-18-week4-PASSING_AND_PASSING,3,0,130,2,0,71,0,0,206
368909346,2018swecapstone/h2ms,06/09/18 07:13,spirals-bears,7f781b86-edd9-4c2c-8d35-0759e20819d2_04-18-week4-PASSING_AND_PASSING,4,0,2,3,68,2,79
372340670,alipay/sofa-rpc,06/09/18 07:14,spirals-bears,7f781b86-edd9-4c2c-8d35-0759e20819d2_04-18-week4-PASSING_AND_PASSING,4,5,7,0,33,0,49
372464776,alipay/sofa-rpc,06/09/18 07:14,spirals-bears,7f781b86-edd9-4c2c-8d35-0759e20819d2_04-18-week4-PASSING_AND_PASSING,4,1,5
372458463,alipay/sofa-rpc,06/09/18 07:15,spirals-bears,7f781b86-edd9-4c2c-8d35-0759e20819d2_04-18-week4-PASSING_AND_PASSING,4,2,6
372323027,alipay/sofa-rpc,06/09/18 07:15,spirals-bears,7f781b86-edd9-4c2c-8d35-0759e20819d2_04-18-week4-PASSING_AND_PASSING,4,5,6,0,27,0,42
370546865,alipay/sofa-rpc,06/09/18 07:16,spirals-bears,7f781b86-edd9-4c2c-8d35-0759e20819d2_04-18-week4-PASSING_AND_PASSING,4,3,7
370684158,alipay/sofa-rpc,06/09/18 07:16,spirals-bears,7f781b86-edd9-4c2c-8d35-0759e20819d2_04-18-week4-PASSING_AND_PASSING,3,2,5
371491439,alipay/sofa-rpc,06/09/18 07:16,spirals-bears,7f781b86-edd9-4c2c-8d35-0759e20819d2_04-18-week4-PASSING_AND_PASSING,3,3,6
370268233,2018swecapstone/h2ms,06/09/18 07:18,spirals-bears,7f781b86-edd9-4c2c-8d35-0759e20819d2_04-18-week4-PASSING_AND_PASSING,13,1,0,0,4,116,0,1,0,0,121,0,0,0,14,0,3,0,0,72,345
371938653,alipay/sofa-rpc,06/09/18 07:18,spirals-bears,7f781b86-edd9-4c2c-8d35-0759e20819d2_04-18-week4-PASSING_AND_PASSING,5,6,0,13,0,7,1,6,14,0,0,20,0,4,1,44,121
369206210,2018swecapstone/h2ms,06/09/18 07:19,spirals-bears,7f781b86-edd9-4c2c-8d35-0759e20819d2_04-18-week4-PASSING_AND_PASSING,13,0,0,0,5,110,0,1,0,0,109,0,0,0,14,0,5,0,0,71,328
369953870,alipay/sofa-rpc,06/09/18 07:20,spirals-bears,7f781b86-edd9-4c2c-8d35-0759e20819d2_04-18-week4-PASSING_AND_PASSING,4,5,2,15,0,6,2,6,13,6,0,21,2,3,1,47,133
370969982,Activiti/Activiti,06/09/18 07:29,spirals-bears,7f781b86-edd9-4c2c-8d35-0759e20819d2_04-18-week4-PASSING_AND_PASSING,11,2,0,11,0,3,5,0,352,0,0,26,0,35,3,159,607
373191984,jdbi/jdbi,06/09/18 07:33,spirals-bears,7f781b86-edd9-4c2c-8d35-0759e20819d2_04-18-week4-PASSING_AND_PASSING,8,0,2,28,0,1,2,0,25,5,0,192,4,8,2,578,855
373143402,jdbi/jdbi,06/09/18 07:33,spirals-bears,7f781b86-edd9-4c2c-8d35-0759e20819d2_04-18-week4-PASSING_AND_PASSING,8,0,2,28,0,1,2,0,26,5,0,194,4,8,2,480,760
372218778,jdbi/jdbi,06/09/18 07:34,spirals-bears,7f781b86-edd9-4c2c-8d35-0759e20819d2_04-18-week4-PASSING_AND_PASSING,9,3,12
372662809,jdbi/jdbi,06/09/18 07:34,spirals-bears,7f781b86-edd9-4c2c-8d35-0759e20819d2_04-18-week4-PASSING_AND_PASSING,9,0,1,4,274,3,291
371625716,jdbi/jdbi,06/09/18 07:34,spirals-bears,7f781b86-edd9-4c2c-8d35-0759e20819d2_04-18-week4-PASSING_AND_PASSING,8,3,11
371830720,jdbi/jdbi,06/09/18 07:34,spirals-bears,7f781b86-edd9-4c2c-8d35-0759e20819d2_04-18-week4-PASSING_AND_PASSING,9,0,1,0,29,0,39
371919361,jdbi/jdbi,06/09/18 07:36,spirals-bears,7f781b86-edd9-4c2c-8d35-0759e20819d2_04-18-week4-PASSING_AND_PASSING,9,0,10,4,96,4,123
372177486,jdbi/jdbi,06/09/18 07:36,spirals-bears,7f781b86-edd9-4c2c-8d35-0759e20819d2_04-18-week4-PASSING_AND_PASSING,9,0,1,4,122,4,140
371180452,jdbi/jdbi,06/09/18 07:37,spirals-bears,7f781b86-edd9-4c2c-8d35-0759e20819d2_04-18-week4-PASSING_AND_PASSING,8,0,1,0,21,0,30
369835477,jdbi/jdbi,06/09/18 07:37,spirals-bears,7f781b86-edd9-4c2c-8d35-0759e20819d2_04-18-week4-PASSING_AND_PASSING,8,0,1,0,0,9
371124024,jdbi/jdbi,06/09/18 07:38,spirals-bears,7f781b86-edd9-4c2c-8d35-0759e20819d2_04-18-week4-PASSING_AND_PASSING,8,0,1,4,21,4,38
371407028,jdbi/jdbi,06/09/18 07:38,spirals-bears,7f781b86-edd9-4c2c-8d35-0759e20819d2_04-18-week4-PASSING_AND_PASSING,8,0,1,4,239,4,256
371155576,jdbi/jdbi,06/09/18 07:41,spirals-bears,7f781b86-edd9-4c2c-8d35-0759e20819d2_04-18-week4-PASSING_AND_PASSING,8,0,1,5,133,4,151
371142159,jdbi/jdbi,06/09/18 07:41,spirals-bears,7f781b86-edd9-4c2c-8d35-0759e20819d2_04-18-week4-PASSING_AND_PASSING,8,0,1,4,129,5,147
368980287,jdbi/jdbi,06/09/18 07:41,spirals-bears,7f781b86-edd9-4c2c-8d35-0759e20819d2_04-18-week4-PASSING_AND_PASSING,8,2,10
371601188,jdbi/jdbi,06/09/18 07:48,spirals-bears,7f781b86-edd9-4c2c-8d35-0759e20819d2_04-18-week4-PASSING_AND_PASSING,8,0,0,28,0,10,2,0,23,0,0,191,0,8,1,438,709
371128488,jdbi/jdbi,06/09/18 07:51,spirals-bears,7f781b86-edd9-4c2c-8d35-0759e20819d2_04-18-week4-PASSING_AND_PASSING,8,0,1,4,140,4,157
371140683,jdbi/jdbi,06/09/18 07:53,spirals-bears,7f781b86-edd9-4c2c-8d35-0759e20819d2_04-18-week4-PASSING_AND_PASSING,8,0,2,25,0,1,2,0,22,5,0,188,3,8,1,451,716
370775556,jdbi/jdbi,06/09/18 07:53,spirals-bears,7f781b86-edd9-4c2c-8d35-0759e20819d2_04-18-week4-PASSING_AND_PASSING,7,0,0,22,0,1,1,0,22,0,0,183,0,8,2,448,694
370724583,jdbi/jdbi,06/09/18 07:54,spirals-bears,7f781b86-edd9-4c2c-8d35-0759e20819d2_04-18-week4-PASSING_AND_PASSING,8,4,12
371126973,jdbi/jdbi,06/09/18 07:54,spirals-bears,7f781b86-edd9-4c2c-8d35-0759e20819d2_04-18-week4-PASSING_AND_PASSING,8,0,1,5,132,3,149
370274177,jdbi/jdbi,06/09/18 07:54,spirals-bears,7f781b86-edd9-4c2c-8d35-0759e20819d2_04-18-week4-PASSING_AND_PASSING,9,0,1,3,4,17
370246878,jdbi/jdbi,06/09/18 07:55,spirals-bears,7f781b86-edd9-4c2c-8d35-0759e20819d2_04-18-week4-PASSING_AND_PASSING,8,4,12
370242455,jdbi/jdbi,06/09/18 07:55,spirals-bears,7f781b86-edd9-4c2c-8d35-0759e20819d2_04-18-week4-PASSING_AND_PASSING,9,0,1,3,4,17
369058493,jdbi/jdbi,06/09/18 07:55,spirals-bears,7f781b86-edd9-4c2c-8d35-0759e20819d2_04-18-week4-PASSING_AND_PASSING,9,2,11
370812735,jdbi/jdbi,06/09/18 07:56,spirals-bears,7f781b86-edd9-4c2c-8d35-0759e20819d2_04-18-week4-PASSING_AND_PASSING,8,0,1,5,140,4,158
370705037,jdbi/jdbi,06/09/18 07:56,spirals-bears,7f781b86-edd9-4c2c-8d35-0759e20819d2_04-18-week4-PASSING_AND_PASSING,9,0,1,0,123,0,133
369838694,jdbi/jdbi,06/09/18 07:56,spirals-bears,7f781b86-edd9-4c2c-8d35-0759e20819d2_04-18-week4-PASSING_AND_PASSING,8,0,1,0,0,9
369838774,jdbi/jdbi,06/09/18 07:56,spirals-bears,7f781b86-edd9-4c2c-8d35-0759e20819d2_04-18-week4-PASSING_AND_PASSING,9,0,1,4,2,16
369609291,jdbi/jdbi,06/09/18 07:57,spirals-bears,7f781b86-edd9-4c2c-8d35-0759e20819d2_04-18-week4-PASSING_AND_PASSING,9,3,12
369610077,jdbi/jdbi,06/09/18 07:57,spirals-bears,7f781b86-edd9-4c2c-8d35-0759e20819d2_04-18-week4-PASSING_AND_PASSING,10,0,1,4,4,19
372402142,jnidzwetzki/bboxdb,06/09/18 07:58,spirals-bears,7f781b86-edd9-4c2c-8d35-0759e20819d2_04-18-week4-PASSING_AND_PASSING,8,0,0,0,24,0,32
371959740,jnidzwetzki/bboxdb,06/09/18 07:58,spirals-bears,7f781b86-edd9-4c2c-8d35-0759e20819d2_04-18-week4-PASSING_AND_PASSING,7,0,0,0,30,0,37
371513038,jnidzwetzki/bboxdb,06/09/18 07:59,spirals-bears,7f781b86-edd9-4c2c-8d35-0759e20819d2_04-18-week4-PASSING_AND_PASSING,8,0,0,0,28,0,36
371477865,jnidzwetzki/bboxdb,06/09/18 08:00,spirals-bears,7f781b86-edd9-4c2c-8d35-0759e20819d2_04-18-week4-PASSING_AND_PASSING,9,0,0,0,29,0,38
371473144,jnidzwetzki/bboxdb,06/09/18 08:01,spirals-bears,7f781b86-edd9-4c2c-8d35-0759e20819d2_04-18-week4-PASSING_AND_PASSING,8,0,0,0,29,0,37
371237891,jnidzwetzki/bboxdb,06/09/18 08:02,spirals-bears,7f781b86-edd9-4c2c-8d35-0759e20819d2_04-18-week4-PASSING_AND_PASSING,7,0,0,0,29,0,36
371198464,jnidzwetzki/bboxdb,06/09/18 08:02,spirals-bears,7f781b86-edd9-4c2c-8d35-0759e20819d2_04-18-week4-PASSING_AND_PASSING,8,0,0,0,28,0,36
367758875,zalando/zalenium,06/09/18 08:03,spirals-bears,7f781b86-edd9-4c2c-8d35-0759e20819d2_04-18-week4-PASSING_AND_PASSING,12,0,0,118,0,0,0,0,115,0,0,37,0,6,1,56,345
368980191,jdbi/jdbi,06/09/18 08:07,spirals-bears,7f781b86-edd9-4c2c-8d35-0759e20819d2_04-18-week4-PASSING_AND_PASSING,7,0,0,23,0,1,2,0,19,0,0,168,0,9,2,435,666
