341297112,apache/flink,23/08/18 13:30,spirals-bears,11aa25c6-cd5d-4ed3-9c64-3e93d2d5d895_02-18-week2-FAILING_AND_PASSING,59,7,66
341318982,apache/flink,23/08/18 13:30,spirals-bears,11aa25c6-cd5d-4ed3-9c64-3e93d2d5d895_02-18-week2-FAILING_AND_PASSING,61,6,67
339344234,apache/flink,23/08/18 13:31,spirals-bears,11aa25c6-cd5d-4ed3-9c64-3e93d2d5d895_02-18-week2-FAILING_AND_PASSING,74,7,81
329345913,apache/flink,23/08/18 13:32,spirals-bears,11aa25c6-cd5d-4ed3-9c64-3e93d2d5d895_02-18-week2-FAILING_AND_PASSING,61,5,66
340290914,apache/flink,23/08/18 13:32,spirals-bears,11aa25c6-cd5d-4ed3-9c64-3e93d2d5d895_02-18-week2-FAILING_AND_PASSING,60,6,66
319345234,apache/flink,23/08/18 13:33,spirals-bears,11aa25c6-cd5d-4ed3-9c64-3e93d2d5d895_02-18-week2-FAILING_AND_PASSING,60,4,64
340071270,apache/flink,23/08/18 13:33,spirals-bears,11aa25c6-cd5d-4ed3-9c64-3e93d2d5d895_02-18-week2-FAILING_AND_PASSING,61,6,67
340075388,apache/flink,23/08/18 13:34,spirals-bears,11aa25c6-cd5d-4ed3-9c64-3e93d2d5d895_02-18-week2-FAILING_AND_PASSING,64,6,70
340005371,apache/flink,23/08/18 13:35,spirals-bears,11aa25c6-cd5d-4ed3-9c64-3e93d2d5d895_02-18-week2-FAILING_AND_PASSING,60,7,67
339582273,apache/flink,23/08/18 13:36,spirals-bears,11aa25c6-cd5d-4ed3-9c64-3e93d2d5d895_02-18-week2-FAILING_AND_PASSING,61,6,67
339496366,apache/flink,23/08/18 13:36,spirals-bears,11aa25c6-cd5d-4ed3-9c64-3e93d2d5d895_02-18-week2-FAILING_AND_PASSING,59,6,65
339776037,apache/flink,23/08/18 13:37,spirals-bears,11aa25c6-cd5d-4ed3-9c64-3e93d2d5d895_02-18-week2-FAILING_AND_PASSING,59,5,64
339048953,apache/flink,23/08/18 13:37,spirals-bears,11aa25c6-cd5d-4ed3-9c64-3e93d2d5d895_02-18-week2-FAILING_AND_PASSING,85,6,91
339344441,apache/flink,23/08/18 13:38,spirals-bears,11aa25c6-cd5d-4ed3-9c64-3e93d2d5d895_02-18-week2-FAILING_AND_PASSING,60,6,66
339081162,apache/flink,23/08/18 13:39,spirals-bears,11aa25c6-cd5d-4ed3-9c64-3e93d2d5d895_02-18-week2-FAILING_AND_PASSING,67,6,73
339067450,apache/flink,23/08/18 13:40,spirals-bears,11aa25c6-cd5d-4ed3-9c64-3e93d2d5d895_02-18-week2-FAILING_AND_PASSING,59,6,65
339051774,apache/flink,23/08/18 13:40,spirals-bears,11aa25c6-cd5d-4ed3-9c64-3e93d2d5d895_02-18-week2-FAILING_AND_PASSING,59,6,65
339049261,apache/flink,23/08/18 13:41,spirals-bears,11aa25c6-cd5d-4ed3-9c64-3e93d2d5d895_02-18-week2-FAILING_AND_PASSING,65,6,71
340838241,apache/flink,23/08/18 14:14,spirals-bears,11aa25c6-cd5d-4ed3-9c64-3e93d2d5d895_02-18-week2-FAILING_AND_PASSING,12,0,2,1,1,99,0,42,743,5,50,1583,60,1,2599
338395503,apache/flink,23/08/18 14:16,spirals-bears,11aa25c6-cd5d-4ed3-9c64-3e93d2d5d895_02-18-week2-FAILING_AND_PASSING,68,6,74
341423588,prestodb/presto,23/08/18 14:17,spirals-bears,11aa25c6-cd5d-4ed3-9c64-3e93d2d5d895_02-18-week2-FAILING_AND_PASSING,43,6,49
337631921,apache/flink,23/08/18 14:21,spirals-bears,11aa25c6-cd5d-4ed3-9c64-3e93d2d5d895_02-18-week2-FAILING_AND_PASSING,8,0,9,1,2,112,0,62,1311,12,51,1467,61,1,3097
340517284,prestodb/presto,23/08/18 14:22,spirals-bears,11aa25c6-cd5d-4ed3-9c64-3e93d2d5d895_02-18-week2-FAILING_AND_PASSING,45,9,54
340772803,prestodb/presto,23/08/18 14:23,spirals-bears,11aa25c6-cd5d-4ed3-9c64-3e93d2d5d895_02-18-week2-FAILING_AND_PASSING,43,6,49
340674701,prestodb/presto,23/08/18 14:24,spirals-bears,11aa25c6-cd5d-4ed3-9c64-3e93d2d5d895_02-18-week2-FAILING_AND_PASSING,43,6,49
338650641,apache/flink,23/08/18 14:24,spirals-bears,11aa25c6-cd5d-4ed3-9c64-3e93d2d5d895_02-18-week2-FAILING_AND_PASSING,8,0,2,0,2,114,0,42,758,6,51,1559,59,1,2602
338977020,apache/flink,23/08/18 14:25,spirals-bears,11aa25c6-cd5d-4ed3-9c64-3e93d2d5d895_02-18-week2-FAILING_AND_PASSING,13,0,9,0,2,125,0,37,735,13,53,1569,122,4,2682
340419163,prestodb/presto,23/08/18 14:25,spirals-bears,11aa25c6-cd5d-4ed3-9c64-3e93d2d5d895_02-18-week2-FAILING_AND_PASSING,48,8,56
340257134,prestodb/presto,23/08/18 14:26,spirals-bears,11aa25c6-cd5d-4ed3-9c64-3e93d2d5d895_02-18-week2-FAILING_AND_PASSING,44,9,53
340044417,prestodb/presto,23/08/18 14:26,spirals-bears,11aa25c6-cd5d-4ed3-9c64-3e93d2d5d895_02-18-week2-FAILING_AND_PASSING,44,6,50
339974692,prestodb/presto,23/08/18 14:26,spirals-bears,11aa25c6-cd5d-4ed3-9c64-3e93d2d5d895_02-18-week2-FAILING_AND_PASSING,41,5,46
338570393,prestodb/presto,23/08/18 14:27,spirals-bears,11aa25c6-cd5d-4ed3-9c64-3e93d2d5d895_02-18-week2-FAILING_AND_PASSING,44,6,50
341394751,apache/incubator-druid,23/08/18 14:27,spirals-bears,11aa25c6-cd5d-4ed3-9c64-3e93d2d5d895_02-18-week2-FAILING_AND_PASSING,36,4,40
341216382,prestodb/presto,23/08/18 14:45,spirals-bears,11aa25c6-cd5d-4ed3-9c64-3e93d2d5d895_02-18-week2-FAILING_AND_PASSING,802,852,41,0,2,1,1698
339301242,prestodb/presto,23/08/18 14:54,spirals-bears,11aa25c6-cd5d-4ed3-9c64-3e93d2d5d895_02-18-week2-FAILING_AND_PASSING,763,878,42,0,1,1,1685
339270303,apache/incubator-druid,23/08/18 14:55,spirals-bears,11aa25c6-cd5d-4ed3-9c64-3e93d2d5d895_02-18-week2-FAILING_AND_PASSING,1058,548,34,0,6,1,1647
338857130,apache/incubator-druid,23/08/18 14:57,spirals-bears,11aa25c6-cd5d-4ed3-9c64-3e93d2d5d895_02-18-week2-FAILING_AND_PASSING,38,5,43
339201913,apache/incubator-druid,23/08/18 15:23,spirals-bears,11aa25c6-cd5d-4ed3-9c64-3e93d2d5d895_02-18-week2-FAILING_AND_PASSING,1056,509,54,0,12,1,1632
339269311,apache/incubator-druid,23/08/18 15:24,spirals-bears,11aa25c6-cd5d-4ed3-9c64-3e93d2d5d895_02-18-week2-FAILING_AND_PASSING,1112,523,42,0,9,0,1686
333806910,apache/incubator-druid,23/08/18 15:25,spirals-bears,11aa25c6-cd5d-4ed3-9c64-3e93d2d5d895_02-18-week2-FAILING_AND_PASSING,1086,523,41,0,9,1,1660
341136924,thelastpickle/cassandra-reaper,23/08/18 15:26,spirals-bears,11aa25c6-cd5d-4ed3-9c64-3e93d2d5d895_02-18-week2-FAILING_AND_PASSING,7,2,9
341136282,thelastpickle/cassandra-reaper,23/08/18 15:26,spirals-bears,11aa25c6-cd5d-4ed3-9c64-3e93d2d5d895_02-18-week2-FAILING_AND_PASSING,11,0,11
336893965,thelastpickle/cassandra-reaper,23/08/18 15:26,spirals-bears,11aa25c6-cd5d-4ed3-9c64-3e93d2d5d895_02-18-week2-FAILING_AND_PASSING,8,0,8
340163482,thelastpickle/cassandra-reaper,23/08/18 15:28,spirals-bears,11aa25c6-cd5d-4ed3-9c64-3e93d2d5d895_02-18-week2-FAILING_AND_PASSING,45,80,8,0,0,1,0,134
340824398,JMRI/JMRI,23/08/18 15:32,spirals-bears,11aa25c6-cd5d-4ed3-9c64-3e93d2d5d895_02-18-week2-FAILING_AND_PASSING,298,29,327
340823132,apache/incubator-druid,23/08/18 15:49,spirals-bears,11aa25c6-cd5d-4ed3-9c64-3e93d2d5d895_02-18-week2-FAILING_AND_PASSING,11,0,16,1,0,40,0,1334,1032,6,1836,539,52,4,4871
339681329,JMRI/JMRI,23/08/18 15:49,spirals-bears,11aa25c6-cd5d-4ed3-9c64-3e93d2d5d895_02-18-week2-FAILING_AND_PASSING,10,10
339860401,JMRI/JMRI,23/08/18 15:59,spirals-bears,11aa25c6-cd5d-4ed3-9c64-3e93d2d5d895_02-18-week2-FAILING_AND_PASSING,582,5,587
340202084,JMRI/JMRI,23/08/18 16:07,spirals-bears,11aa25c6-cd5d-4ed3-9c64-3e93d2d5d895_02-18-week2-FAILING_AND_PASSING,1647,239,379,0,21,0,13,2299
339889159,JMRI/JMRI,23/08/18 16:08,spirals-bears,11aa25c6-cd5d-4ed3-9c64-3e93d2d5d895_02-18-week2-FAILING_AND_PASSING,1656,164,310,0,31,0,9,2170
338313107,apache/incubator-druid,23/08/18 16:30,spirals-bears,11aa25c6-cd5d-4ed3-9c64-3e93d2d5d895_02-18-week2-FAILING_AND_PASSING,18,0,2,2,1,49,0,1398,338,3,1500,514,46,2,3873
339828827,JMRI/JMRI,23/08/18 16:36,spirals-bears,11aa25c6-cd5d-4ed3-9c64-3e93d2d5d895_02-18-week2-FAILING_AND_PASSING,1735,169,260,0,14,0,8,2186
339245798,JMRI/JMRI,23/08/18 16:44,spirals-bears,11aa25c6-cd5d-4ed3-9c64-3e93d2d5d895_02-18-week2-FAILING_AND_PASSING,1472,335,278,0,29,0,8,2122
339189330,JMRI/JMRI,23/08/18 16:47,spirals-bears,11aa25c6-cd5d-4ed3-9c64-3e93d2d5d895_02-18-week2-FAILING_AND_PASSING,1505,168,600,0,99,0,8,2380
337360739,apache/nifi,23/08/18 16:49,spirals-bears,11aa25c6-cd5d-4ed3-9c64-3e93d2d5d895_02-18-week2-FAILING_AND_PASSING,87,5,92
338788841,JMRI/JMRI,23/08/18 17:07,spirals-bears,11aa25c6-cd5d-4ed3-9c64-3e93d2d5d895_02-18-week2-FAILING_AND_PASSING,1568,168,444,0,14,0,11,2205
339605398,apache/nifi,23/08/18 17:08,spirals-bears,11aa25c6-cd5d-4ed3-9c64-3e93d2d5d895_02-18-week2-FAILING_AND_PASSING,37,6,43
338557362,JMRI/JMRI,23/08/18 17:11,spirals-bears,11aa25c6-cd5d-4ed3-9c64-3e93d2d5d895_02-18-week2-FAILING_AND_PASSING,1611,173,290,0,18,0,14,2106
339628390,apache/nifi,23/08/18 17:14,spirals-bears,11aa25c6-cd5d-4ed3-9c64-3e93d2d5d895_02-18-week2-FAILING_AND_PASSING,1412,39,2,16,5,1474
338757618,apache/nifi,23/08/18 17:14,spirals-bears,11aa25c6-cd5d-4ed3-9c64-3e93d2d5d895_02-18-week2-FAILING_AND_PASSING,34,7,41
337893038,apache/nifi,23/08/18 17:15,spirals-bears,11aa25c6-cd5d-4ed3-9c64-3e93d2d5d895_02-18-week2-FAILING_AND_PASSING,35,8,43
338371187,JMRI/JMRI,23/08/18 17:25,spirals-bears,11aa25c6-cd5d-4ed3-9c64-3e93d2d5d895_02-18-week2-FAILING_AND_PASSING,1629,174,572,0,32,0,12,2419
339613695,INRIA/spoon,23/08/18 17:25,spirals-bears,11aa25c6-cd5d-4ed3-9c64-3e93d2d5d895_02-18-week2-FAILING_AND_PASSING,10,6,16
341632155,INRIA/spoon,23/08/18 17:32,spirals-bears,11aa25c6-cd5d-4ed3-9c64-3e93d2d5d895_02-18-week2-FAILING_AND_PASSING,8,0,7,0,0,5,0,437,28,3,419,59,12,0,978
338708833,INRIA/spoon,23/08/18 17:33,spirals-bears,11aa25c6-cd5d-4ed3-9c64-3e93d2d5d895_02-18-week2-FAILING_AND_PASSING,31,6,37
341457037,EnMasseProject/enmasse,23/08/18 17:34,spirals-bears,11aa25c6-cd5d-4ed3-9c64-3e93d2d5d895_02-18-week2-FAILING_AND_PASSING,28,0,28
341457077,EnMasseProject/enmasse,23/08/18 17:35,spirals-bears,11aa25c6-cd5d-4ed3-9c64-3e93d2d5d895_02-18-week2-FAILING_AND_PASSING,56,3,59
341373350,EnMasseProject/enmasse,23/08/18 17:36,spirals-bears,11aa25c6-cd5d-4ed3-9c64-3e93d2d5d895_02-18-week2-FAILING_AND_PASSING,26,3,29
339505214,apache/nifi,23/08/18 17:36,spirals-bears,11aa25c6-cd5d-4ed3-9c64-3e93d2d5d895_02-18-week2-FAILING_AND_PASSING,1590,41,2,2,5,1640
341373321,EnMasseProject/enmasse,23/08/18 17:36,spirals-bears,11aa25c6-cd5d-4ed3-9c64-3e93d2d5d895_02-18-week2-FAILING_AND_PASSING,26,0,26
341381685,EnMasseProject/enmasse,23/08/18 17:37,spirals-bears,11aa25c6-cd5d-4ed3-9c64-3e93d2d5d895_02-18-week2-FAILING_AND_PASSING,27,0,27
339216375,apache/nifi,23/08/18 17:38,spirals-bears,11aa25c6-cd5d-4ed3-9c64-3e93d2d5d895_02-18-week2-FAILING_AND_PASSING,1526,35,2,2,4,1569
341303678,EnMasseProject/enmasse,23/08/18 17:41,spirals-bears,11aa25c6-cd5d-4ed3-9c64-3e93d2d5d895_02-18-week2-FAILING_AND_PASSING,127,83,29,0,4,1,0,244
340369070,EnMasseProject/enmasse,23/08/18 17:41,spirals-bears,11aa25c6-cd5d-4ed3-9c64-3e93d2d5d895_02-18-week2-FAILING_AND_PASSING,123,76,30,0,1,1,0,231
341637907,batfish/batfish,23/08/18 17:42,spirals-bears,11aa25c6-cd5d-4ed3-9c64-3e93d2d5d895_02-18-week2-FAILING_AND_PASSING,51,4,55
339425760,EnMasseProject/enmasse,23/08/18 17:42,spirals-bears,11aa25c6-cd5d-4ed3-9c64-3e93d2d5d895_02-18-week2-FAILING_AND_PASSING,124,79,28,0,0,3,0,234
341178152,batfish/batfish,23/08/18 17:42,spirals-bears,11aa25c6-cd5d-4ed3-9c64-3e93d2d5d895_02-18-week2-FAILING_AND_PASSING,72,0,72
341584167,batfish/batfish,23/08/18 17:43,spirals-bears,11aa25c6-cd5d-4ed3-9c64-3e93d2d5d895_02-18-week2-FAILING_AND_PASSING,51,3,54
341178178,batfish/batfish,23/08/18 17:43,spirals-bears,11aa25c6-cd5d-4ed3-9c64-3e93d2d5d895_02-18-week2-FAILING_AND_PASSING,52,4,56
339338673,INRIA/spoon,23/08/18 17:43,spirals-bears,11aa25c6-cd5d-4ed3-9c64-3e93d2d5d895_02-18-week2-FAILING_AND_PASSING,13,0,5,0,0,13,0,436,36,4,476,61,9,1,1054
341583043,batfish/batfish,23/08/18 17:43,spirals-bears,11aa25c6-cd5d-4ed3-9c64-3e93d2d5d895_02-18-week2-FAILING_AND_PASSING,58,0,58
340725275,batfish/batfish,23/08/18 17:44,spirals-bears,11aa25c6-cd5d-4ed3-9c64-3e93d2d5d895_02-18-week2-FAILING_AND_PASSING,52,4,56
339367136,batfish/batfish,23/08/18 17:45,spirals-bears,11aa25c6-cd5d-4ed3-9c64-3e93d2d5d895_02-18-week2-FAILING_AND_PASSING,53,0,53
339367258,batfish/batfish,23/08/18 17:45,spirals-bears,11aa25c6-cd5d-4ed3-9c64-3e93d2d5d895_02-18-week2-FAILING_AND_PASSING,77,3,80
339124665,batfish/batfish,23/08/18 17:46,spirals-bears,11aa25c6-cd5d-4ed3-9c64-3e93d2d5d895_02-18-week2-FAILING_AND_PASSING,52,3,55
339124660,batfish/batfish,23/08/18 17:46,spirals-bears,11aa25c6-cd5d-4ed3-9c64-3e93d2d5d895_02-18-week2-FAILING_AND_PASSING,63,0,63
339269176,batfish/batfish,23/08/18 17:47,spirals-bears,11aa25c6-cd5d-4ed3-9c64-3e93d2d5d895_02-18-week2-FAILING_AND_PASSING,49,3,52
339269149,batfish/batfish,23/08/18 17:47,spirals-bears,11aa25c6-cd5d-4ed3-9c64-3e93d2d5d895_02-18-week2-FAILING_AND_PASSING,67,0,67
340296012,batfish/batfish,23/08/18 17:48,spirals-bears,11aa25c6-cd5d-4ed3-9c64-3e93d2d5d895_02-18-week2-FAILING_AND_PASSING,6,226,64,0,2,0,0,298
339583445,batfish/batfish,23/08/18 17:48,spirals-bears,11aa25c6-cd5d-4ed3-9c64-3e93d2d5d895_02-18-week2-FAILING_AND_PASSING,7,226,53,0,3,0,0,289
339218510,batfish/batfish,23/08/18 17:48,spirals-bears,11aa25c6-cd5d-4ed3-9c64-3e93d2d5d895_02-18-week2-FAILING_AND_PASSING,50,4,54
339083310,batfish/batfish,23/08/18 17:48,spirals-bears,11aa25c6-cd5d-4ed3-9c64-3e93d2d5d895_02-18-week2-FAILING_AND_PASSING,53,0,53
338847010,batfish/batfish,23/08/18 17:49,spirals-bears,11aa25c6-cd5d-4ed3-9c64-3e93d2d5d895_02-18-week2-FAILING_AND_PASSING,50,0,50
339083325,batfish/batfish,23/08/18 17:49,spirals-bears,11aa25c6-cd5d-4ed3-9c64-3e93d2d5d895_02-18-week2-FAILING_AND_PASSING,57,3,60
338847012,batfish/batfish,23/08/18 17:49,spirals-bears,11aa25c6-cd5d-4ed3-9c64-3e93d2d5d895_02-18-week2-FAILING_AND_PASSING,59,3,62
340355023,apache/incubator-servicecomb-java-chassis,23/08/18 17:50,spirals-bears,11aa25c6-cd5d-4ed3-9c64-3e93d2d5d895_02-18-week2-FAILING_AND_PASSING,9,4,13
340065929,apache/incubator-servicecomb-java-chassis,23/08/18 17:50,spirals-bears,11aa25c6-cd5d-4ed3-9c64-3e93d2d5d895_02-18-week2-FAILING_AND_PASSING,9,5,14
338796246,batfish/batfish,23/08/18 17:50,spirals-bears,11aa25c6-cd5d-4ed3-9c64-3e93d2d5d895_02-18-week2-FAILING_AND_PASSING,76,0,76
341603527,runelite/runelite,23/08/18 17:50,spirals-bears,11aa25c6-cd5d-4ed3-9c64-3e93d2d5d895_02-18-week2-FAILING_AND_PASSING,12,0,12
341544531,runelite/runelite,23/08/18 17:50,spirals-bears,11aa25c6-cd5d-4ed3-9c64-3e93d2d5d895_02-18-week2-FAILING_AND_PASSING,13,0,13
341244566,runelite/runelite,23/08/18 17:50,spirals-bears,11aa25c6-cd5d-4ed3-9c64-3e93d2d5d895_02-18-week2-FAILING_AND_PASSING,10,0,10
341489148,runelite/runelite,23/08/18 17:50,spirals-bears,11aa25c6-cd5d-4ed3-9c64-3e93d2d5d895_02-18-week2-FAILING_AND_PASSING,12,14,26
340945684,runelite/runelite,23/08/18 17:51,spirals-bears,11aa25c6-cd5d-4ed3-9c64-3e93d2d5d895_02-18-week2-FAILING_AND_PASSING,12,15,27
340769752,runelite/runelite,23/08/18 17:51,spirals-bears,11aa25c6-cd5d-4ed3-9c64-3e93d2d5d895_02-18-week2-FAILING_AND_PASSING,10,0,10
340993139,runelite/runelite,23/08/18 17:51,spirals-bears,11aa25c6-cd5d-4ed3-9c64-3e93d2d5d895_02-18-week2-FAILING_AND_PASSING,11,15,26
340337273,runelite/runelite,23/08/18 17:51,spirals-bears,11aa25c6-cd5d-4ed3-9c64-3e93d2d5d895_02-18-week2-FAILING_AND_PASSING,11,2,13
340419200,runelite/runelite,23/08/18 17:51,spirals-bears,11aa25c6-cd5d-4ed3-9c64-3e93d2d5d895_02-18-week2-FAILING_AND_PASSING,10,0,10
339706135,runelite/runelite,23/08/18 17:51,spirals-bears,11aa25c6-cd5d-4ed3-9c64-3e93d2d5d895_02-18-week2-FAILING_AND_PASSING,11,0,11
339705292,runelite/runelite,23/08/18 17:51,spirals-bears,11aa25c6-cd5d-4ed3-9c64-3e93d2d5d895_02-18-week2-FAILING_AND_PASSING,11,0,11
339732707,runelite/runelite,23/08/18 17:52,spirals-bears,11aa25c6-cd5d-4ed3-9c64-3e93d2d5d895_02-18-week2-FAILING_AND_PASSING,11,12,23
339659988,runelite/runelite,23/08/18 17:52,spirals-bears,11aa25c6-cd5d-4ed3-9c64-3e93d2d5d895_02-18-week2-FAILING_AND_PASSING,11,0,11
339586212,runelite/runelite,23/08/18 17:52,spirals-bears,11aa25c6-cd5d-4ed3-9c64-3e93d2d5d895_02-18-week2-FAILING_AND_PASSING,11,0,11
339281761,runelite/runelite,23/08/18 17:52,spirals-bears,11aa25c6-cd5d-4ed3-9c64-3e93d2d5d895_02-18-week2-FAILING_AND_PASSING,11,14,25
339474765,runelite/runelite,23/08/18 17:52,spirals-bears,11aa25c6-cd5d-4ed3-9c64-3e93d2d5d895_02-18-week2-FAILING_AND_PASSING,11,12,23
338787569,runelite/runelite,23/08/18 17:52,spirals-bears,11aa25c6-cd5d-4ed3-9c64-3e93d2d5d895_02-18-week2-FAILING_AND_PASSING,10,1,11
339302503,runelite/runelite,23/08/18 17:53,spirals-bears,11aa25c6-cd5d-4ed3-9c64-3e93d2d5d895_02-18-week2-FAILING_AND_PASSING,10,16,26
335507235,terasolunaorg/tutorial-apps,23/08/18 17:53,spirals-bears,11aa25c6-cd5d-4ed3-9c64-3e93d2d5d895_02-18-week2-FAILING_AND_PASSING,4,0,4
335507877,terasolunaorg/tutorial-apps,23/08/18 17:53,spirals-bears,11aa25c6-cd5d-4ed3-9c64-3e93d2d5d895_02-18-week2-FAILING_AND_PASSING,4,2,6
335463873,terasolunaorg/tutorial-apps,23/08/18 17:53,spirals-bears,11aa25c6-cd5d-4ed3-9c64-3e93d2d5d895_02-18-week2-FAILING_AND_PASSING,3,0,3
335464245,terasolunaorg/tutorial-apps,23/08/18 17:53,spirals-bears,11aa25c6-cd5d-4ed3-9c64-3e93d2d5d895_02-18-week2-FAILING_AND_PASSING,4,3,7
335464695,terasolunaorg/tutorial-apps,23/08/18 17:53,spirals-bears,11aa25c6-cd5d-4ed3-9c64-3e93d2d5d895_02-18-week2-FAILING_AND_PASSING,4,3,7
335463704,terasolunaorg/tutorial-apps,23/08/18 17:53,spirals-bears,11aa25c6-cd5d-4ed3-9c64-3e93d2d5d895_02-18-week2-FAILING_AND_PASSING,4,0,4
328881986,terasolunaorg/tutorial-apps,23/08/18 17:53,spirals-bears,11aa25c6-cd5d-4ed3-9c64-3e93d2d5d895_02-18-week2-FAILING_AND_PASSING,3,6,4,0,0,0,0,13
327125398,terasolunaorg/tutorial-apps,23/08/18 17:53,spirals-bears,11aa25c6-cd5d-4ed3-9c64-3e93d2d5d895_02-18-week2-FAILING_AND_PASSING,3,6,3,0,0,0,0,12
339732523,CorfuDB/CorfuDB,23/08/18 17:57,spirals-bears,11aa25c6-cd5d-4ed3-9c64-3e93d2d5d895_02-18-week2-FAILING_AND_PASSING,255,0,255
339732547,CorfuDB/CorfuDB,23/08/18 17:58,spirals-bears,11aa25c6-cd5d-4ed3-9c64-3e93d2d5d895_02-18-week2-FAILING_AND_PASSING,251,3,254
339626963,CorfuDB/CorfuDB,23/08/18 17:58,spirals-bears,11aa25c6-cd5d-4ed3-9c64-3e93d2d5d895_02-18-week2-FAILING_AND_PASSING,262,4,266
340367042,apache/incubator-servicecomb-java-chassis,23/08/18 17:58,spirals-bears,11aa25c6-cd5d-4ed3-9c64-3e93d2d5d895_02-18-week2-FAILING_AND_PASSING,284,217,10,1,5,5,0,522
340918789,apache/storm,23/08/18 17:59,spirals-bears,11aa25c6-cd5d-4ed3-9c64-3e93d2d5d895_02-18-week2-FAILING_AND_PASSING,50,7,57
339262697,CorfuDB/CorfuDB,23/08/18 18:02,spirals-bears,11aa25c6-cd5d-4ed3-9c64-3e93d2d5d895_02-18-week2-FAILING_AND_PASSING,268,0,268
330793933,CorfuDB/CorfuDB,23/08/18 18:02,spirals-bears,11aa25c6-cd5d-4ed3-9c64-3e93d2d5d895_02-18-week2-FAILING_AND_PASSING,259,3,262
341289500,linkedin/pinot,23/08/18 18:03,spirals-bears,11aa25c6-cd5d-4ed3-9c64-3e93d2d5d895_02-18-week2-FAILING_AND_PASSING,33,4,37
330793590,CorfuDB/CorfuDB,23/08/18 18:04,spirals-bears,11aa25c6-cd5d-4ed3-9c64-3e93d2d5d895_02-18-week2-FAILING_AND_PASSING,339,0,339
339715328,linkedin/pinot,23/08/18 18:04,spirals-bears,11aa25c6-cd5d-4ed3-9c64-3e93d2d5d895_02-18-week2-FAILING_AND_PASSING,35,4,39
339703237,linkedin/pinot,23/08/18 18:05,spirals-bears,11aa25c6-cd5d-4ed3-9c64-3e93d2d5d895_02-18-week2-FAILING_AND_PASSING,47,4,51
339347349,linkedin/pinot,23/08/18 18:05,spirals-bears,11aa25c6-cd5d-4ed3-9c64-3e93d2d5d895_02-18-week2-FAILING_AND_PASSING,48,3,51
339253897,linkedin/pinot,23/08/18 18:06,spirals-bears,11aa25c6-cd5d-4ed3-9c64-3e93d2d5d895_02-18-week2-FAILING_AND_PASSING,37,4,41
338732155,Azure/azure-libraries-for-java,23/08/18 18:06,spirals-bears,11aa25c6-cd5d-4ed3-9c64-3e93d2d5d895_02-18-week2-FAILING_AND_PASSING,71,5,76
341430526,graphhopper/graphhopper,23/08/18 18:08,spirals-bears,11aa25c6-cd5d-4ed3-9c64-3e93d2d5d895_02-18-week2-FAILING_AND_PASSING,90,18,0,1,0,109
339853476,graphhopper/graphhopper,23/08/18 18:09,spirals-bears,11aa25c6-cd5d-4ed3-9c64-3e93d2d5d895_02-18-week2-FAILING_AND_PASSING,58,19,0,0,0,77
339855028,graphhopper/graphhopper,23/08/18 18:10,spirals-bears,11aa25c6-cd5d-4ed3-9c64-3e93d2d5d895_02-18-week2-FAILING_AND_PASSING,68,123,19,0,0,0,0,210
338832409,graphhopper/graphhopper,23/08/18 18:13,spirals-bears,11aa25c6-cd5d-4ed3-9c64-3e93d2d5d895_02-18-week2-FAILING_AND_PASSING,74,130,19,0,10,1,0,234
341511219,HubSpot/Singularity,23/08/18 18:32,spirals-bears,11aa25c6-cd5d-4ed3-9c64-3e93d2d5d895_02-18-week2-FAILING_AND_PASSING,10,0,2,0,1,11,0,295,292,0,302,366,16,0,1295
341505895,HubSpot/Singularity,23/08/18 18:36,spirals-bears,11aa25c6-cd5d-4ed3-9c64-3e93d2d5d895_02-18-week2-FAILING_AND_PASSING,9,0,0,0,1,6,0,310,318,0,298,376,17,0,1335
340565774,apache/storm,23/08/18 18:37,spirals-bears,11aa25c6-cd5d-4ed3-9c64-3e93d2d5d895_02-18-week2-FAILING_AND_PASSING,22,0,1,0,2,50,0,351,589,1,558,662,38,0,2274
339177248,apache/storm,23/08/18 18:45,spirals-bears,11aa25c6-cd5d-4ed3-9c64-3e93d2d5d895_02-18-week2-FAILING_AND_PASSING,10,0,1,0,1,33,0,602,620,0,573,687,43,1,2571
340586854,HubSpot/Singularity,23/08/18 18:50,spirals-bears,11aa25c6-cd5d-4ed3-9c64-3e93d2d5d895_02-18-week2-FAILING_AND_PASSING,267,19,0,1,2,289
341505835,HubSpot/Singularity,23/08/18 18:55,spirals-bears,11aa25c6-cd5d-4ed3-9c64-3e93d2d5d895_02-18-week2-FAILING_AND_PASSING,9,0,3,0,2,8,0,330,340,4,304,358,20,0,1378
341000150,HubSpot/Singularity,23/08/18 19:00,spirals-bears,11aa25c6-cd5d-4ed3-9c64-3e93d2d5d895_02-18-week2-FAILING_AND_PASSING,19,0,0,0,1,3,0,336,342,0,332,401,17,0,1451
340600672,HubSpot/Singularity,23/08/18 19:01,spirals-bears,11aa25c6-cd5d-4ed3-9c64-3e93d2d5d895_02-18-week2-FAILING_AND_PASSING,20,0,3,0,1,3,0,310,347,4,326,385,19,0,1418
339636452,HubSpot/Singularity,23/08/18 19:02,spirals-bears,11aa25c6-cd5d-4ed3-9c64-3e93d2d5d895_02-18-week2-FAILING_AND_PASSING,369,17,0,3,2,391
339637630,HubSpot/Singularity,23/08/18 19:13,spirals-bears,11aa25c6-cd5d-4ed3-9c64-3e93d2d5d895_02-18-week2-FAILING_AND_PASSING,13,0,0,0,2,5,0,297,306,0,284,427,18,0,1352
340890776,algolia/algoliasearch-client-java-2,23/08/18 19:13,spirals-bears,11aa25c6-cd5d-4ed3-9c64-3e93d2d5d895_02-18-week2-FAILING_AND_PASSING,4,3,7
340311710,visallo/vertexium,23/08/18 19:17,spirals-bears,11aa25c6-cd5d-4ed3-9c64-3e93d2d5d895_02-18-week2-FAILING_AND_PASSING,12,168,7,0,0,0,0,187
340132017,visallo/vertexium,23/08/18 19:17,spirals-bears,11aa25c6-cd5d-4ed3-9c64-3e93d2d5d895_02-18-week2-FAILING_AND_PASSING,7,2,9
341203935,magefree/mage,23/08/18 19:19,spirals-bears,11aa25c6-cd5d-4ed3-9c64-3e93d2d5d895_02-18-week2-FAILING_AND_PASSING,9,0,16,1,0,34,0,189,34,5,221,336,221,1,1067
341071436,StuPro-TOSCAna/TOSCAna,23/08/18 19:20,spirals-bears,11aa25c6-cd5d-4ed3-9c64-3e93d2d5d895_02-18-week2-FAILING_AND_PASSING,17,0,17
340297315,StuPro-TOSCAna/TOSCAna,23/08/18 19:20,spirals-bears,11aa25c6-cd5d-4ed3-9c64-3e93d2d5d895_02-18-week2-FAILING_AND_PASSING,15,3,18
340131864,visallo/vertexium,23/08/18 19:20,spirals-bears,11aa25c6-cd5d-4ed3-9c64-3e93d2d5d895_02-18-week2-FAILING_AND_PASSING,13,187,6,0,0,0,0,206
340292502,StuPro-TOSCAna/TOSCAna,23/08/18 19:21,spirals-bears,11aa25c6-cd5d-4ed3-9c64-3e93d2d5d895_02-18-week2-FAILING_AND_PASSING,15,0,15
339559078,StuPro-TOSCAna/TOSCAna,23/08/18 19:21,spirals-bears,11aa25c6-cd5d-4ed3-9c64-3e93d2d5d895_02-18-week2-FAILING_AND_PASSING,19,0,19
339674243,StuPro-TOSCAna/TOSCAna,23/08/18 19:21,spirals-bears,11aa25c6-cd5d-4ed3-9c64-3e93d2d5d895_02-18-week2-FAILING_AND_PASSING,14,0,14
339674249,StuPro-TOSCAna/TOSCAna,23/08/18 19:21,spirals-bears,11aa25c6-cd5d-4ed3-9c64-3e93d2d5d895_02-18-week2-FAILING_AND_PASSING,13,2,15
339585453,StuPro-TOSCAna/TOSCAna,23/08/18 19:22,spirals-bears,11aa25c6-cd5d-4ed3-9c64-3e93d2d5d895_02-18-week2-FAILING_AND_PASSING,25,0,25
339585467,StuPro-TOSCAna/TOSCAna,23/08/18 19:22,spirals-bears,11aa25c6-cd5d-4ed3-9c64-3e93d2d5d895_02-18-week2-FAILING_AND_PASSING,14,2,16
339627913,StuPro-TOSCAna/TOSCAna,23/08/18 19:22,spirals-bears,11aa25c6-cd5d-4ed3-9c64-3e93d2d5d895_02-18-week2-FAILING_AND_PASSING,14,2,16
338715056,HubSpot/Singularity,23/08/18 19:22,spirals-bears,11aa25c6-cd5d-4ed3-9c64-3e93d2d5d895_02-18-week2-FAILING_AND_PASSING,11,0,0,0,2,26,0,289,307,0,290,361,17,0,1303
339541405,StuPro-TOSCAna/TOSCAna,23/08/18 19:23,spirals-bears,11aa25c6-cd5d-4ed3-9c64-3e93d2d5d895_02-18-week2-FAILING_AND_PASSING,19,0,19
339543612,StuPro-TOSCAna/TOSCAna,23/08/18 19:23,spirals-bears,11aa25c6-cd5d-4ed3-9c64-3e93d2d5d895_02-18-week2-FAILING_AND_PASSING,25,2,27
339410703,StuPro-TOSCAna/TOSCAna,23/08/18 19:23,spirals-bears,11aa25c6-cd5d-4ed3-9c64-3e93d2d5d895_02-18-week2-FAILING_AND_PASSING,17,0,17
339436354,StuPro-TOSCAna/TOSCAna,23/08/18 19:24,spirals-bears,11aa25c6-cd5d-4ed3-9c64-3e93d2d5d895_02-18-week2-FAILING_AND_PASSING,15,0,15
339229773,StuPro-TOSCAna/TOSCAna,23/08/18 19:24,spirals-bears,11aa25c6-cd5d-4ed3-9c64-3e93d2d5d895_02-18-week2-FAILING_AND_PASSING,14,0,14
339026594,StuPro-TOSCAna/TOSCAna,23/08/18 19:25,spirals-bears,11aa25c6-cd5d-4ed3-9c64-3e93d2d5d895_02-18-week2-FAILING_AND_PASSING,14,0,14
339183401,molgenis/molgenis,23/08/18 19:26,spirals-bears,11aa25c6-cd5d-4ed3-9c64-3e93d2d5d895_02-18-week2-FAILING_AND_PASSING,889,498,41,0,9,1,2,1440
339392962,apache/incubator-dubbo,23/08/18 19:27,spirals-bears,11aa25c6-cd5d-4ed3-9c64-3e93d2d5d895_02-18-week2-FAILING_AND_PASSING,9,3,12
339489007,StuPro-TOSCAna/TOSCAna,23/08/18 19:27,spirals-bears,11aa25c6-cd5d-4ed3-9c64-3e93d2d5d895_02-18-week2-FAILING_AND_PASSING,123,106,10,16,0,0,2,4,0,0,0,261
339608386,StuPro-TOSCAna/TOSCAna,23/08/18 19:31,spirals-bears,11aa25c6-cd5d-4ed3-9c64-3e93d2d5d895_02-18-week2-FAILING_AND_PASSING,10,0,1,0,2,2,0,123,30,0,122,211,14,0,515
341061257,ga4gh/dockstore,23/08/18 19:31,spirals-bears,11aa25c6-cd5d-4ed3-9c64-3e93d2d5d895_02-18-week2-FAILING_AND_PASSING,9,0,9
339131739,ga4gh/dockstore,23/08/18 19:31,spirals-bears,11aa25c6-cd5d-4ed3-9c64-3e93d2d5d895_02-18-week2-FAILING_AND_PASSING,9,0,9
338613837,ga4gh/dockstore,23/08/18 19:32,spirals-bears,11aa25c6-cd5d-4ed3-9c64-3e93d2d5d895_02-18-week2-FAILING_AND_PASSING,10,2,12
340001628,atomix/atomix,23/08/18 19:32,spirals-bears,11aa25c6-cd5d-4ed3-9c64-3e93d2d5d895_02-18-week2-FAILING_AND_PASSING,12,2,14
340507769,resteasy/Resteasy,23/08/18 19:33,spirals-bears,11aa25c6-cd5d-4ed3-9c64-3e93d2d5d895_02-18-week2-FAILING_AND_PASSING,20,7,27
340063611,apache/incubator-dubbo,23/08/18 19:34,spirals-bears,11aa25c6-cd5d-4ed3-9c64-3e93d2d5d895_02-18-week2-FAILING_AND_PASSING,196,350,9,0,6,2,0,563
335420644,resteasy/Resteasy,23/08/18 19:35,spirals-bears,11aa25c6-cd5d-4ed3-9c64-3e93d2d5d895_02-18-week2-FAILING_AND_PASSING,19,4,23
341589870,pgjdbc/pgjdbc,23/08/18 19:35,spirals-bears,11aa25c6-cd5d-4ed3-9c64-3e93d2d5d895_02-18-week2-FAILING_AND_PASSING,17,10,0,3,0,30
339338242,apache/incubator-dubbo,23/08/18 19:37,spirals-bears,11aa25c6-cd5d-4ed3-9c64-3e93d2d5d895_02-18-week2-FAILING_AND_PASSING,206,361,10,0,5,1,0,583
338958921,apache/incubator-dubbo,23/08/18 19:37,spirals-bears,11aa25c6-cd5d-4ed3-9c64-3e93d2d5d895_02-18-week2-FAILING_AND_PASSING,189,360,9,0,1,1,0,560
340410507,geoserver/geoserver,23/08/18 19:44,spirals-bears,11aa25c6-cd5d-4ed3-9c64-3e93d2d5d895_02-18-week2-FAILING_AND_PASSING,431,60,0,5,0,496
340146411,geoserver/geoserver,23/08/18 19:45,spirals-bears,11aa25c6-cd5d-4ed3-9c64-3e93d2d5d895_02-18-week2-FAILING_AND_PASSING,390,57,0,8,1,456
338977249,geoserver/geoserver,23/08/18 19:45,spirals-bears,11aa25c6-cd5d-4ed3-9c64-3e93d2d5d895_02-18-week2-FAILING_AND_PASSING,387,58,0,7,1,453
341110997,swagger-api/swagger-codegen,23/08/18 19:50,spirals-bears,11aa25c6-cd5d-4ed3-9c64-3e93d2d5d895_02-18-week2-FAILING_AND_PASSING,49,210,35,0,10,0,0,304
340311059,swagger-api/swagger-codegen,23/08/18 19:51,spirals-bears,11aa25c6-cd5d-4ed3-9c64-3e93d2d5d895_02-18-week2-FAILING_AND_PASSING,33,0,33
340132118,RipMeApp/ripme,23/08/18 20:05,spirals-bears,11aa25c6-cd5d-4ed3-9c64-3e93d2d5d895_02-18-week2-FAILING_AND_PASSING,840,22,4,0,0,0,866
341426440,aicis/fresco,23/08/18 20:09,spirals-bears,11aa25c6-cd5d-4ed3-9c64-3e93d2d5d895_02-18-week2-FAILING_AND_PASSING,10,4,0,0,8,0,0,3,0,992,0,39,0,276,92,10,3,0,1437
340309997,apache/incubator-servicecomb-saga,23/08/18 20:09,spirals-bears,11aa25c6-cd5d-4ed3-9c64-3e93d2d5d895_02-18-week2-FAILING_AND_PASSING,4,2,6
339472559,apache/incubator-servicecomb-saga,23/08/18 20:09,spirals-bears,11aa25c6-cd5d-4ed3-9c64-3e93d2d5d895_02-18-week2-FAILING_AND_PASSING,5,2,7
341030129,datastax/java-driver,23/08/18 20:10,spirals-bears,11aa25c6-cd5d-4ed3-9c64-3e93d2d5d895_02-18-week2-FAILING_AND_PASSING,19,0,19
341031082,datastax/java-driver,23/08/18 20:10,spirals-bears,11aa25c6-cd5d-4ed3-9c64-3e93d2d5d895_02-18-week2-FAILING_AND_PASSING,18,2,20
341399484,aicis/fresco,23/08/18 20:13,spirals-bears,11aa25c6-cd5d-4ed3-9c64-3e93d2d5d895_02-18-week2-FAILING_AND_PASSING,1597,106,9,0,0,0,0,1712
340650511,datastax/java-driver,23/08/18 20:14,spirals-bears,11aa25c6-cd5d-4ed3-9c64-3e93d2d5d895_02-18-week2-FAILING_AND_PASSING,69,100,17,0,0,0,0,186
339467498,vaadin/vaadin-components-testbench,23/08/18 20:14,spirals-bears,11aa25c6-cd5d-4ed3-9c64-3e93d2d5d895_02-18-week2-FAILING_AND_PASSING,2,2,4
339561630,RipMeApp/ripme,23/08/18 20:15,spirals-bears,11aa25c6-cd5d-4ed3-9c64-3e93d2d5d895_02-18-week2-FAILING_AND_PASSING,9,0,0,0,0,0,0,241,12,0,281,21,5,0,569
339672154,datastax/java-driver,23/08/18 20:16,spirals-bears,11aa25c6-cd5d-4ed3-9c64-3e93d2d5d895_02-18-week2-FAILING_AND_PASSING,69,103,18,0,0,0,0,190
339086763,danglotb/dspot,23/08/18 20:17,spirals-bears,11aa25c6-cd5d-4ed3-9c64-3e93d2d5d895_02-18-week2-FAILING_AND_PASSING,84,5,0,0,0,89
338988353,danglotb/dspot,23/08/18 20:17,spirals-bears,11aa25c6-cd5d-4ed3-9c64-3e93d2d5d895_02-18-week2-FAILING_AND_PASSING,5,0,5
340103769,dhis2/dhis2-core,23/08/18 20:19,spirals-bears,11aa25c6-cd5d-4ed3-9c64-3e93d2d5d895_02-18-week2-FAILING_AND_PASSING,87,22,0,2,0,111
330311252,dhis2/dhis2-core,23/08/18 20:20,spirals-bears,11aa25c6-cd5d-4ed3-9c64-3e93d2d5d895_02-18-week2-FAILING_AND_PASSING,24,5,29
341354165,debezium/debezium,23/08/18 20:23,spirals-bears,11aa25c6-cd5d-4ed3-9c64-3e93d2d5d895_02-18-week2-FAILING_AND_PASSING,46,147,7,0,0,0,0,200
331725184,debezium/debezium,23/08/18 20:23,spirals-bears,11aa25c6-cd5d-4ed3-9c64-3e93d2d5d895_02-18-week2-FAILING_AND_PASSING,6,0,6
340417650,debezium/debezium,23/08/18 20:26,spirals-bears,11aa25c6-cd5d-4ed3-9c64-3e93d2d5d895_02-18-week2-FAILING_AND_PASSING,44,118,6,0,0,0,0,168
341459822,danglotb/dspot,23/08/18 20:27,spirals-bears,11aa25c6-cd5d-4ed3-9c64-3e93d2d5d895_02-18-week2-FAILING_AND_PASSING,9,0,0,0,0,1,0,9,47,0,495,183,5,0,749
340072151,debezium/debezium,23/08/18 20:27,spirals-bears,11aa25c6-cd5d-4ed3-9c64-3e93d2d5d895_02-18-week2-FAILING_AND_PASSING,7,4,11
340070145,debezium/debezium,23/08/18 20:27,spirals-bears,11aa25c6-cd5d-4ed3-9c64-3e93d2d5d895_02-18-week2-FAILING_AND_PASSING,6,4,10
340065419,debezium/debezium,23/08/18 20:27,spirals-bears,11aa25c6-cd5d-4ed3-9c64-3e93d2d5d895_02-18-week2-FAILING_AND_PASSING,6,4,10
339062287,danglotb/dspot,23/08/18 20:28,spirals-bears,11aa25c6-cd5d-4ed3-9c64-3e93d2d5d895_02-18-week2-FAILING_AND_PASSING,10,0,0,0,0,1,0,8,50,0,485,132,7,0,693
340917833,MyCoRe-Org/mycore,23/08/18 20:28,spirals-bears,11aa25c6-cd5d-4ed3-9c64-3e93d2d5d895_02-18-week2-FAILING_AND_PASSING,43,0,43
339848791,zalando/zalenium,23/08/18 20:28,spirals-bears,11aa25c6-cd5d-4ed3-9c64-3e93d2d5d895_02-18-week2-FAILING_AND_PASSING,5,2,7
340918869,MyCoRe-Org/mycore,23/08/18 20:29,spirals-bears,11aa25c6-cd5d-4ed3-9c64-3e93d2d5d895_02-18-week2-FAILING_AND_PASSING,48,3,51
338036308,B3Partners/brmo,23/08/18 20:30,spirals-bears,11aa25c6-cd5d-4ed3-9c64-3e93d2d5d895_02-18-week2-FAILING_AND_PASSING,72,0,72
340396678,B3Partners/brmo,23/08/18 20:30,spirals-bears,11aa25c6-cd5d-4ed3-9c64-3e93d2d5d895_02-18-week2-FAILING_AND_PASSING,71,3,74
340980925,keycloak/keycloak-documentation,23/08/18 20:31,spirals-bears,11aa25c6-cd5d-4ed3-9c64-3e93d2d5d895_02-18-week2-FAILING_AND_PASSING,27,3,30
339450156,debezium/debezium,23/08/18 20:31,spirals-bears,11aa25c6-cd5d-4ed3-9c64-3e93d2d5d895_02-18-week2-FAILING_AND_PASSING,48,202,6,0,0,0,0,256
339971331,resteasy/Resteasy,23/08/18 20:32,spirals-bears,11aa25c6-cd5d-4ed3-9c64-3e93d2d5d895_02-18-week2-FAILING_AND_PASSING,8,17,1,8,8,0,2,9,0,1416,0,67,6,1225,744,21,16,1,3549
340094932,jnidzwetzki/bboxdb,23/08/18 20:35,spirals-bears,11aa25c6-cd5d-4ed3-9c64-3e93d2d5d895_02-18-week2-FAILING_AND_PASSING,5,0,0,0,0,1,0,37,71,0,39,140,8,0,301
