328240174,apache/flink,18/08/18 12:20,spirals-bears,6799cc07-95a1-4e50-ad7d-f235eab297e7_01-18-week2-PASSING_AND_PASSING,60,7,67
328145600,apache/flink,18/08/18 12:22,spirals-bears,6799cc07-95a1-4e50-ad7d-f235eab297e7_01-18-week2-PASSING_AND_PASSING,60,0,1,5,8,74
328719002,apache/flink,18/08/18 12:24,spirals-bears,6799cc07-95a1-4e50-ad7d-f235eab297e7_01-18-week2-PASSING_AND_PASSING,67,0,2,1,223,3,296
328472629,apache/flink,18/08/18 12:24,spirals-bears,6799cc07-95a1-4e50-ad7d-f235eab297e7_01-18-week2-PASSING_AND_PASSING,63,0,3,1,226,3,296
328307352,apache/flink,18/08/18 12:24,spirals-bears,6799cc07-95a1-4e50-ad7d-f235eab297e7_01-18-week2-PASSING_AND_PASSING,85,0,1,1,223,3,313
324930487,apache/flink,18/08/18 12:26,spirals-bears,6799cc07-95a1-4e50-ad7d-f235eab297e7_01-18-week2-PASSING_AND_PASSING,60,6,66
327115300,apache/flink,18/08/18 12:27,spirals-bears,6799cc07-95a1-4e50-ad7d-f235eab297e7_01-18-week2-PASSING_AND_PASSING,60,0,1,5,8,74
328116095,apache/flink,18/08/18 12:30,spirals-bears,6799cc07-95a1-4e50-ad7d-f235eab297e7_01-18-week2-PASSING_AND_PASSING,69,0,2,1,249,2,323
327749317,apache/flink,18/08/18 12:33,spirals-bears,6799cc07-95a1-4e50-ad7d-f235eab297e7_01-18-week2-PASSING_AND_PASSING,60,0,2,1,244,3,310
327678981,apache/flink,18/08/18 12:35,spirals-bears,6799cc07-95a1-4e50-ad7d-f235eab297e7_01-18-week2-PASSING_AND_PASSING,61,0,2,1,219,2,285
328019386,apache/flink,18/08/18 12:37,spirals-bears,6799cc07-95a1-4e50-ad7d-f235eab297e7_01-18-week2-PASSING_AND_PASSING,63,0,1,1,822,2,889
319871637,apache/flink,18/08/18 12:37,spirals-bears,6799cc07-95a1-4e50-ad7d-f235eab297e7_01-18-week2-PASSING_AND_PASSING,61,0,2,9,162,12,246
319180914,apache/flink,18/08/18 12:38,spirals-bears,6799cc07-95a1-4e50-ad7d-f235eab297e7_01-18-week2-PASSING_AND_PASSING,60,0,1,7,125,9,202
327912994,apache/flink,18/08/18 12:40,spirals-bears,6799cc07-95a1-4e50-ad7d-f235eab297e7_01-18-week2-PASSING_AND_PASSING,69,0,2,1,842,2,916
327021322,apache/flink,18/08/18 12:40,spirals-bears,6799cc07-95a1-4e50-ad7d-f235eab297e7_01-18-week2-PASSING_AND_PASSING,62,7,69
327021210,apache/flink,18/08/18 12:41,spirals-bears,6799cc07-95a1-4e50-ad7d-f235eab297e7_01-18-week2-PASSING_AND_PASSING,61,6,67
327357643,apache/flink,18/08/18 12:41,spirals-bears,6799cc07-95a1-4e50-ad7d-f235eab297e7_01-18-week2-PASSING_AND_PASSING,62,0,2,7,160,10,241
326491367,apache/flink,18/08/18 12:41,spirals-bears,6799cc07-95a1-4e50-ad7d-f235eab297e7_01-18-week2-PASSING_AND_PASSING,61,0,2,8,162,10,243
326903765,apache/flink,18/08/18 12:42,spirals-bears,6799cc07-95a1-4e50-ad7d-f235eab297e7_01-18-week2-PASSING_AND_PASSING,61,6,67
322743967,apache/flink,18/08/18 12:43,spirals-bears,6799cc07-95a1-4e50-ad7d-f235eab297e7_01-18-week2-PASSING_AND_PASSING,68,6,74
327189413,apache/flink,18/08/18 12:44,spirals-bears,6799cc07-95a1-4e50-ad7d-f235eab297e7_01-18-week2-PASSING_AND_PASSING,71,0,3,1,155,3,233
255244593,apache/flink,18/08/18 12:44,spirals-bears,6799cc07-95a1-4e50-ad7d-f235eab297e7_01-18-week2-PASSING_AND_PASSING,66,7,73
326479893,apache/flink,18/08/18 12:45,spirals-bears,6799cc07-95a1-4e50-ad7d-f235eab297e7_01-18-week2-PASSING_AND_PASSING,60,6,66
326855041,apache/flink,18/08/18 12:47,spirals-bears,6799cc07-95a1-4e50-ad7d-f235eab297e7_01-18-week2-PASSING_AND_PASSING,65,0,2,1,194,2,264
268372005,apache/flink,18/08/18 12:49,spirals-bears,6799cc07-95a1-4e50-ad7d-f235eab297e7_01-18-week2-PASSING_AND_PASSING,69,0,1,5,10,85
326514253,apache/flink,18/08/18 12:49,spirals-bears,6799cc07-95a1-4e50-ad7d-f235eab297e7_01-18-week2-PASSING_AND_PASSING,59,0,1,1,219,2,282
328530231,prestodb/presto,18/08/18 13:18,spirals-bears,6799cc07-95a1-4e50-ad7d-f235eab297e7_01-18-week2-PASSING_AND_PASSING,45,0,793,2,1,902,2,1745
328529747,prestodb/presto,18/08/18 13:18,spirals-bears,6799cc07-95a1-4e50-ad7d-f235eab297e7_01-18-week2-PASSING_AND_PASSING,44,0,815,1,1,898,2,1761
318372926,prestodb/presto,18/08/18 13:20,spirals-bears,6799cc07-95a1-4e50-ad7d-f235eab297e7_01-18-week2-PASSING_AND_PASSING,42,0,1,5,7,55
325282578,prestodb/presto,18/08/18 13:21,spirals-bears,6799cc07-95a1-4e50-ad7d-f235eab297e7_01-18-week2-PASSING_AND_PASSING,43,6,49
327412228,prestodb/presto,18/08/18 13:22,spirals-bears,6799cc07-95a1-4e50-ad7d-f235eab297e7_01-18-week2-PASSING_AND_PASSING,48,0,2,4,5,59
326507339,prestodb/presto,18/08/18 13:23,spirals-bears,6799cc07-95a1-4e50-ad7d-f235eab297e7_01-18-week2-PASSING_AND_PASSING,43,6,49
326933990,apache/flink,18/08/18 13:23,spirals-bears,6799cc07-95a1-4e50-ad7d-f235eab297e7_01-18-week2-PASSING_AND_PASSING,9,0,1,54,1,2,89,0,37,2,2,664,1,70,44,1504,2480
327899889,prestodb/presto,18/08/18 13:24,spirals-bears,6799cc07-95a1-4e50-ad7d-f235eab297e7_01-18-week2-PASSING_AND_PASSING,46,6,52
326939804,prestodb/presto,18/08/18 13:25,spirals-bears,6799cc07-95a1-4e50-ad7d-f235eab297e7_01-18-week2-PASSING_AND_PASSING,43,0,2,5,7,57
325720189,apache/flink,18/08/18 13:25,spirals-bears,6799cc07-95a1-4e50-ad7d-f235eab297e7_01-18-week2-PASSING_AND_PASSING,12,0,2,55,0,1,73,0,44,2,2,566,2,60,39,1521,2379
327966710,prestodb/presto,18/08/18 13:37,spirals-bears,6799cc07-95a1-4e50-ad7d-f235eab297e7_01-18-week2-PASSING_AND_PASSING,44,0,2,1,667,2,716
327824525,prestodb/presto,18/08/18 13:39,spirals-bears,6799cc07-95a1-4e50-ad7d-f235eab297e7_01-18-week2-PASSING_AND_PASSING,44,6,50
328093472,prestodb/presto,18/08/18 13:40,spirals-bears,6799cc07-95a1-4e50-ad7d-f235eab297e7_01-18-week2-PASSING_AND_PASSING,56,9,65
327827362,prestodb/presto,18/08/18 13:41,spirals-bears,6799cc07-95a1-4e50-ad7d-f235eab297e7_01-18-week2-PASSING_AND_PASSING,44,9,53
327611439,prestodb/presto,18/08/18 13:42,spirals-bears,6799cc07-95a1-4e50-ad7d-f235eab297e7_01-18-week2-PASSING_AND_PASSING,45,7,52
327561381,prestodb/presto,18/08/18 13:43,spirals-bears,6799cc07-95a1-4e50-ad7d-f235eab297e7_01-18-week2-PASSING_AND_PASSING,41,5,46
327655893,prestodb/presto,18/08/18 13:44,spirals-bears,6799cc07-95a1-4e50-ad7d-f235eab297e7_01-18-week2-PASSING_AND_PASSING,42,8,50
327824429,prestodb/presto,18/08/18 13:45,spirals-bears,6799cc07-95a1-4e50-ad7d-f235eab297e7_01-18-week2-PASSING_AND_PASSING,42,3,45
327386041,prestodb/presto,18/08/18 13:46,spirals-bears,6799cc07-95a1-4e50-ad7d-f235eab297e7_01-18-week2-PASSING_AND_PASSING,42,3,45
325412281,prestodb/presto,18/08/18 13:47,spirals-bears,6799cc07-95a1-4e50-ad7d-f235eab297e7_01-18-week2-PASSING_AND_PASSING,49,6,55
328528420,prestodb/presto,18/08/18 13:47,spirals-bears,6799cc07-95a1-4e50-ad7d-f235eab297e7_01-18-week2-PASSING_AND_PASSING,44,0,812,1,1,861,1,1720
326980332,prestodb/presto,18/08/18 13:48,spirals-bears,6799cc07-95a1-4e50-ad7d-f235eab297e7_01-18-week2-PASSING_AND_PASSING,41,9,50
327397284,prestodb/presto,18/08/18 13:48,spirals-bears,6799cc07-95a1-4e50-ad7d-f235eab297e7_01-18-week2-PASSING_AND_PASSING,43,3,46
320061089,prestodb/presto,18/08/18 13:49,spirals-bears,6799cc07-95a1-4e50-ad7d-f235eab297e7_01-18-week2-PASSING_AND_PASSING,41,6,47
327081603,prestodb/presto,18/08/18 13:49,spirals-bears,6799cc07-95a1-4e50-ad7d-f235eab297e7_01-18-week2-PASSING_AND_PASSING,46,3,49
326955348,prestodb/presto,18/08/18 13:50,spirals-bears,6799cc07-95a1-4e50-ad7d-f235eab297e7_01-18-week2-PASSING_AND_PASSING,46,4,50
325593700,prestodb/presto,18/08/18 13:50,spirals-bears,6799cc07-95a1-4e50-ad7d-f235eab297e7_01-18-week2-PASSING_AND_PASSING,41,5,46
324332153,prestodb/presto,18/08/18 13:51,spirals-bears,6799cc07-95a1-4e50-ad7d-f235eab297e7_01-18-week2-PASSING_AND_PASSING,44,4,48
326142733,prestodb/presto,18/08/18 13:51,spirals-bears,6799cc07-95a1-4e50-ad7d-f235eab297e7_01-18-week2-PASSING_AND_PASSING,41,5,46
325235418,prestodb/presto,18/08/18 13:52,spirals-bears,6799cc07-95a1-4e50-ad7d-f235eab297e7_01-18-week2-PASSING_AND_PASSING,43,0,1,5,9,58
328353355,prestodb/presto,18/08/18 13:52,spirals-bears,6799cc07-95a1-4e50-ad7d-f235eab297e7_01-18-week2-PASSING_AND_PASSING,44,0,801,1,1,905,3,1755
327082952,apache/incubator-druid,18/08/18 13:54,spirals-bears,6799cc07-95a1-4e50-ad7d-f235eab297e7_01-18-week2-PASSING_AND_PASSING,37,0,1,6,37,11,92
305094966,apache/incubator-druid,18/08/18 13:54,spirals-bears,6799cc07-95a1-4e50-ad7d-f235eab297e7_01-18-week2-PASSING_AND_PASSING,37,0,2,7,31,12,89
328339444,prestodb/presto,18/08/18 13:54,spirals-bears,6799cc07-95a1-4e50-ad7d-f235eab297e7_01-18-week2-PASSING_AND_PASSING,42,0,782,1,1,925,2,1753
325996727,prestodb/presto,18/08/18 13:55,spirals-bears,6799cc07-95a1-4e50-ad7d-f235eab297e7_01-18-week2-PASSING_AND_PASSING,44,0,1,1,205,3,254
327131495,apache/incubator-druid,18/08/18 13:56,spirals-bears,6799cc07-95a1-4e50-ad7d-f235eab297e7_01-18-week2-PASSING_AND_PASSING,39,0,1,6,40,7,93
325528695,apache/incubator-druid,18/08/18 13:56,spirals-bears,6799cc07-95a1-4e50-ad7d-f235eab297e7_01-18-week2-PASSING_AND_PASSING,34,0,1,6,40,8,89
326744688,apache/incubator-druid,18/08/18 13:56,spirals-bears,6799cc07-95a1-4e50-ad7d-f235eab297e7_01-18-week2-PASSING_AND_PASSING,39,10,49
326727958,apache/incubator-druid,18/08/18 13:58,spirals-bears,6799cc07-95a1-4e50-ad7d-f235eab297e7_01-18-week2-PASSING_AND_PASSING,39,0,1,5,33,13,91
319665244,apache/incubator-druid,18/08/18 13:59,spirals-bears,6799cc07-95a1-4e50-ad7d-f235eab297e7_01-18-week2-PASSING_AND_PASSING,43,10,53
325409707,apache/incubator-druid,18/08/18 14:00,spirals-bears,6799cc07-95a1-4e50-ad7d-f235eab297e7_01-18-week2-PASSING_AND_PASSING,46,0,1,5,28,14,94
327377452,apache/incubator-druid,18/08/18 14:21,spirals-bears,6799cc07-95a1-4e50-ad7d-f235eab297e7_01-18-week2-PASSING_AND_PASSING,37,0,1053,1,0,478,2,1571
326033224,apache/incubator-druid,18/08/18 14:21,spirals-bears,6799cc07-95a1-4e50-ad7d-f235eab297e7_01-18-week2-PASSING_AND_PASSING,36,0,1014,1,6,461,8,1526
326662070,apache/incubator-druid,18/08/18 14:23,spirals-bears,6799cc07-95a1-4e50-ad7d-f235eab297e7_01-18-week2-PASSING_AND_PASSING,37,0,1094,1,6,466,12,1616
327599583,thelastpickle/cassandra-reaper,18/08/18 14:25,spirals-bears,6799cc07-95a1-4e50-ad7d-f235eab297e7_01-18-week2-PASSING_AND_PASSING,13,3,16
327598914,thelastpickle/cassandra-reaper,18/08/18 14:25,spirals-bears,6799cc07-95a1-4e50-ad7d-f235eab297e7_01-18-week2-PASSING_AND_PASSING,8,0,8
327555133,thelastpickle/cassandra-reaper,18/08/18 14:25,spirals-bears,6799cc07-95a1-4e50-ad7d-f235eab297e7_01-18-week2-PASSING_AND_PASSING,7,0,0,0,54,0,61
319909961,thelastpickle/cassandra-reaper,18/08/18 14:27,spirals-bears,6799cc07-95a1-4e50-ad7d-f235eab297e7_01-18-week2-PASSING_AND_PASSING,7,0,0,0,50,1,58
324455111,thelastpickle/cassandra-reaper,18/08/18 14:29,spirals-bears,6799cc07-95a1-4e50-ad7d-f235eab297e7_01-18-week2-PASSING_AND_PASSING,11,5,0,0,9,48,0,0,6,0,44,0,0,0,37,0,7,5,5,65,242
328734844,JMRI/JMRI,18/08/18 14:33,spirals-bears,6799cc07-95a1-4e50-ad7d-f235eab297e7_01-18-week2-PASSING_AND_PASSING,400,5,405
328727561,JMRI/JMRI,18/08/18 14:34,spirals-bears,6799cc07-95a1-4e50-ad7d-f235eab297e7_01-18-week2-PASSING_AND_PASSING,271,5,276
328634874,JMRI/JMRI,18/08/18 15:02,spirals-bears,6799cc07-95a1-4e50-ad7d-f235eab297e7_01-18-week2-PASSING_AND_PASSING,265,0,1048,0,8,342,7,1670
326646925,apache/incubator-druid,18/08/18 15:09,spirals-bears,6799cc07-95a1-4e50-ad7d-f235eab297e7_01-18-week2-PASSING_AND_PASSING,9,0,4,1613,2,1,44,0,1382,7,3,524,4,32,16,466,4107
328510941,JMRI/JMRI,18/08/18 15:11,spirals-bears,6799cc07-95a1-4e50-ad7d-f235eab297e7_01-18-week2-PASSING_AND_PASSING,270,0,1567,0,5,321,12,7,2182
325702722,apache/incubator-druid,18/08/18 15:27,spirals-bears,6799cc07-95a1-4e50-ad7d-f235eab297e7_01-18-week2-PASSING_AND_PASSING,10,0,15,1403,1,1,65,0,1296,6,17,345,4,40,17,491,3711
328365233,JMRI/JMRI,18/08/18 15:38,spirals-bears,6799cc07-95a1-4e50-ad7d-f235eab297e7_01-18-week2-PASSING_AND_PASSING,10,0,1,1423,0,108,0,2,6,89,1,244,65,170,2119
327989268,JMRI/JMRI,18/08/18 15:41,spirals-bears,6799cc07-95a1-4e50-ad7d-f235eab297e7_01-18-week2-PASSING_AND_PASSING,312,0,1388,0,6,176,7,8,1897
327814366,JMRI/JMRI,18/08/18 15:44,spirals-bears,6799cc07-95a1-4e50-ad7d-f235eab297e7_01-18-week2-PASSING_AND_PASSING,403,0,1378,0,6,171,6,8,1972
326550021,JMRI/JMRI,18/08/18 15:49,spirals-bears,6799cc07-95a1-4e50-ad7d-f235eab297e7_01-18-week2-PASSING_AND_PASSING,267,0,0,6,162,8,443
327558931,JMRI/JMRI,18/08/18 16:08,spirals-bears,6799cc07-95a1-4e50-ad7d-f235eab297e7_01-18-week2-PASSING_AND_PASSING,10,0,1,1636,0,144,0,5,8,82,1,343,64,179,2473
326572018,JMRI/JMRI,18/08/18 16:16,spirals-bears,6799cc07-95a1-4e50-ad7d-f235eab297e7_01-18-week2-PASSING_AND_PASSING,9,0,0,1401,2,129,0,2,4,84,1,406,66,185,2289
325977567,JMRI/JMRI,18/08/18 16:18,spirals-bears,6799cc07-95a1-4e50-ad7d-f235eab297e7_01-18-week2-PASSING_AND_PASSING,338,0,1420,0,16,177,9,45,2005
328108294,apache/nifi,18/08/18 16:19,spirals-bears,6799cc07-95a1-4e50-ad7d-f235eab297e7_01-18-week2-PASSING_AND_PASSING,34,2,4,6,8,54
326887453,apache/nifi,18/08/18 16:20,spirals-bears,6799cc07-95a1-4e50-ad7d-f235eab297e7_01-18-week2-PASSING_AND_PASSING,39,7,46
327840528,apache/nifi,18/08/18 16:21,spirals-bears,6799cc07-95a1-4e50-ad7d-f235eab297e7_01-18-week2-PASSING_AND_PASSING,37,2,4,6,8,57
327341203,apache/nifi,18/08/18 16:22,spirals-bears,6799cc07-95a1-4e50-ad7d-f235eab297e7_01-18-week2-PASSING_AND_PASSING,44,4,48
327906394,apache/nifi,18/08/18 16:23,spirals-bears,6799cc07-95a1-4e50-ad7d-f235eab297e7_01-18-week2-PASSING_AND_PASSING,37,2,4,7,12,62
326235965,JMRI/JMRI,18/08/18 16:26,spirals-bears,6799cc07-95a1-4e50-ad7d-f235eab297e7_01-18-week2-PASSING_AND_PASSING,11,0,4,1419,0,132,0,14,3,87,6,268,66,173,2183
328264508,apache/nifi,18/08/18 16:34,spirals-bears,6799cc07-95a1-4e50-ad7d-f235eab297e7_01-18-week2-PASSING_AND_PASSING,36,2,4,1,978,2,1023
325543926,apache/nifi,18/08/18 16:35,spirals-bears,6799cc07-95a1-4e50-ad7d-f235eab297e7_01-18-week2-PASSING_AND_PASSING,41,5,46
326217802,JMRI/JMRI,18/08/18 16:47,spirals-bears,6799cc07-95a1-4e50-ad7d-f235eab297e7_01-18-week2-PASSING_AND_PASSING,16,0,6,1427,1,103,0,15,10,94,8,293,83,175,2231
327842232,apache/nifi,18/08/18 16:51,spirals-bears,6799cc07-95a1-4e50-ad7d-f235eab297e7_01-18-week2-PASSING_AND_PASSING,41,2,6,1,1611,2,1663
327779947,apache/nifi,18/08/18 16:55,spirals-bears,6799cc07-95a1-4e50-ad7d-f235eab297e7_01-18-week2-PASSING_AND_PASSING,39,2,4,1,1637,2,1685
326445175,apache/nifi,18/08/18 16:57,spirals-bears,6799cc07-95a1-4e50-ad7d-f235eab297e7_01-18-week2-PASSING_AND_PASSING,37,3,4,10,562,12,628
326427224,apache/nifi,18/08/18 17:02,spirals-bears,6799cc07-95a1-4e50-ad7d-f235eab297e7_01-18-week2-PASSING_AND_PASSING,41,2,5,9,545,10,612
327282068,INRIA/spoon,18/08/18 17:03,spirals-bears,6799cc07-95a1-4e50-ad7d-f235eab297e7_01-18-week2-PASSING_AND_PASSING,10,0,0,4,44,7,65
326672095,apache/nifi,18/08/18 17:04,spirals-bears,6799cc07-95a1-4e50-ad7d-f235eab297e7_01-18-week2-PASSING_AND_PASSING,38,2,5,1,1668,2,1716
326780758,INRIA/spoon,18/08/18 17:04,spirals-bears,6799cc07-95a1-4e50-ad7d-f235eab297e7_01-18-week2-PASSING_AND_PASSING,9,0,0,0,48,1,58
328575113,EnMasseProject/enmasse,18/08/18 17:05,spirals-bears,6799cc07-95a1-4e50-ad7d-f235eab297e7_01-18-week2-PASSING_AND_PASSING,28,2,30
325656632,apache/nifi,18/08/18 17:05,spirals-bears,6799cc07-95a1-4e50-ad7d-f235eab297e7_01-18-week2-PASSING_AND_PASSING,46,2,4,9,535,10,606
328574671,EnMasseProject/enmasse,18/08/18 17:06,spirals-bears,6799cc07-95a1-4e50-ad7d-f235eab297e7_01-18-week2-PASSING_AND_PASSING,28,3,31
328573257,EnMasseProject/enmasse,18/08/18 17:06,spirals-bears,6799cc07-95a1-4e50-ad7d-f235eab297e7_01-18-week2-PASSING_AND_PASSING,29,0,29
328104805,EnMasseProject/enmasse,18/08/18 17:06,spirals-bears,6799cc07-95a1-4e50-ad7d-f235eab297e7_01-18-week2-PASSING_AND_PASSING,31,0,31
328069125,EnMasseProject/enmasse,18/08/18 17:07,spirals-bears,6799cc07-95a1-4e50-ad7d-f235eab297e7_01-18-week2-PASSING_AND_PASSING,26,0,26
328017629,EnMasseProject/enmasse,18/08/18 17:07,spirals-bears,6799cc07-95a1-4e50-ad7d-f235eab297e7_01-18-week2-PASSING_AND_PASSING,30,0,30
327664523,EnMasseProject/enmasse,18/08/18 17:07,spirals-bears,6799cc07-95a1-4e50-ad7d-f235eab297e7_01-18-week2-PASSING_AND_PASSING,28,0,1,0,0,29
327258044,EnMasseProject/enmasse,18/08/18 17:08,spirals-bears,6799cc07-95a1-4e50-ad7d-f235eab297e7_01-18-week2-PASSING_AND_PASSING,27,0,2,4,4,37
327775137,EnMasseProject/enmasse,18/08/18 17:08,spirals-bears,6799cc07-95a1-4e50-ad7d-f235eab297e7_01-18-week2-PASSING_AND_PASSING,28,3,31
327611890,EnMasseProject/enmasse,18/08/18 17:08,spirals-bears,6799cc07-95a1-4e50-ad7d-f235eab297e7_01-18-week2-PASSING_AND_PASSING,27,0,2,4,4,37
327674440,EnMasseProject/enmasse,18/08/18 17:09,spirals-bears,6799cc07-95a1-4e50-ad7d-f235eab297e7_01-18-week2-PASSING_AND_PASSING,28,0,2,0,1,31
327571481,EnMasseProject/enmasse,18/08/18 17:09,spirals-bears,6799cc07-95a1-4e50-ad7d-f235eab297e7_01-18-week2-PASSING_AND_PASSING,26,0,26
327193139,EnMasseProject/enmasse,18/08/18 17:10,spirals-bears,6799cc07-95a1-4e50-ad7d-f235eab297e7_01-18-week2-PASSING_AND_PASSING,30,0,30
326709171,EnMasseProject/enmasse,18/08/18 17:10,spirals-bears,6799cc07-95a1-4e50-ad7d-f235eab297e7_01-18-week2-PASSING_AND_PASSING,25,2,27
327529840,EnMasseProject/enmasse,18/08/18 17:11,spirals-bears,6799cc07-95a1-4e50-ad7d-f235eab297e7_01-18-week2-PASSING_AND_PASSING,26,0,1,1,70,1,99
327255167,EnMasseProject/enmasse,18/08/18 17:13,spirals-bears,6799cc07-95a1-4e50-ad7d-f235eab297e7_01-18-week2-PASSING_AND_PASSING,27,0,1,6,68,4,106
327625312,INRIA/spoon,18/08/18 17:14,spirals-bears,6799cc07-95a1-4e50-ad7d-f235eab297e7_01-18-week2-PASSING_AND_PASSING,8,0,0,412,0,0,4,0,414,0,0,35,0,10,6,60,949
327240853,EnMasseProject/enmasse,18/08/18 17:14,spirals-bears,6799cc07-95a1-4e50-ad7d-f235eab297e7_01-18-week2-PASSING_AND_PASSING,27,2,29
327255154,EnMasseProject/enmasse,18/08/18 17:15,spirals-bears,6799cc07-95a1-4e50-ad7d-f235eab297e7_01-18-week2-PASSING_AND_PASSING,26,0,2,1,69,1,99
327286797,EnMasseProject/enmasse,18/08/18 17:15,spirals-bears,6799cc07-95a1-4e50-ad7d-f235eab297e7_01-18-week2-PASSING_AND_PASSING,28,0,161,1,5,74,0,4,273
327226782,EnMasseProject/enmasse,18/08/18 17:19,spirals-bears,6799cc07-95a1-4e50-ad7d-f235eab297e7_01-18-week2-PASSING_AND_PASSING,27,0,160,1,1,76,0,0,265
327226759,EnMasseProject/enmasse,18/08/18 17:19,spirals-bears,6799cc07-95a1-4e50-ad7d-f235eab297e7_01-18-week2-PASSING_AND_PASSING,26,0,154,1,5,74,0,4,264
327102147,EnMasseProject/enmasse,18/08/18 17:20,spirals-bears,6799cc07-95a1-4e50-ad7d-f235eab297e7_01-18-week2-PASSING_AND_PASSING,29,0,157,2,1,77,0,0,266
325214102,INRIA/spoon,18/08/18 17:20,spirals-bears,6799cc07-95a1-4e50-ad7d-f235eab297e7_01-18-week2-PASSING_AND_PASSING,8,0,0,420,0,0,4,0,418,0,0,33,0,9,6,59,957
327211318,EnMasseProject/enmasse,18/08/18 17:24,spirals-bears,6799cc07-95a1-4e50-ad7d-f235eab297e7_01-18-week2-PASSING_AND_PASSING,27,0,168,1,6,80,0,3,285
327211303,EnMasseProject/enmasse,18/08/18 17:24,spirals-bears,6799cc07-95a1-4e50-ad7d-f235eab297e7_01-18-week2-PASSING_AND_PASSING,28,0,165,1,1,80,0,1,276
327166166,EnMasseProject/enmasse,18/08/18 17:24,spirals-bears,6799cc07-95a1-4e50-ad7d-f235eab297e7_01-18-week2-PASSING_AND_PASSING,32,0,160,2,4,82,0,4,284
326943285,EnMasseProject/enmasse,18/08/18 17:25,spirals-bears,6799cc07-95a1-4e50-ad7d-f235eab297e7_01-18-week2-PASSING_AND_PASSING,27,3,30
326943325,EnMasseProject/enmasse,18/08/18 17:25,spirals-bears,6799cc07-95a1-4e50-ad7d-f235eab297e7_01-18-week2-PASSING_AND_PASSING,29,0,29
327166288,EnMasseProject/enmasse,18/08/18 17:25,spirals-bears,6799cc07-95a1-4e50-ad7d-f235eab297e7_01-18-week2-PASSING_AND_PASSING,31,0,163,2,3,79,0,1,279
326499311,EnMasseProject/enmasse,18/08/18 17:25,spirals-bears,6799cc07-95a1-4e50-ad7d-f235eab297e7_01-18-week2-PASSING_AND_PASSING,32,0,32
326500271,EnMasseProject/enmasse,18/08/18 17:25,spirals-bears,6799cc07-95a1-4e50-ad7d-f235eab297e7_01-18-week2-PASSING_AND_PASSING,32,2,34
327102783,EnMasseProject/enmasse,18/08/18 17:25,spirals-bears,6799cc07-95a1-4e50-ad7d-f235eab297e7_01-18-week2-PASSING_AND_PASSING,29,0,2,5,4,40
326500580,EnMasseProject/enmasse,18/08/18 17:26,spirals-bears,6799cc07-95a1-4e50-ad7d-f235eab297e7_01-18-week2-PASSING_AND_PASSING,31,2,33
326935225,EnMasseProject/enmasse,18/08/18 17:26,spirals-bears,6799cc07-95a1-4e50-ad7d-f235eab297e7_01-18-week2-PASSING_AND_PASSING,33,0,33
326730350,EnMasseProject/enmasse,18/08/18 17:26,spirals-bears,6799cc07-95a1-4e50-ad7d-f235eab297e7_01-18-week2-PASSING_AND_PASSING,30,3,33
326783097,EnMasseProject/enmasse,18/08/18 17:26,spirals-bears,6799cc07-95a1-4e50-ad7d-f235eab297e7_01-18-week2-PASSING_AND_PASSING,31,3,34
326783056,EnMasseProject/enmasse,18/08/18 17:27,spirals-bears,6799cc07-95a1-4e50-ad7d-f235eab297e7_01-18-week2-PASSING_AND_PASSING,29,0,29
325201834,EnMasseProject/enmasse,18/08/18 17:27,spirals-bears,6799cc07-95a1-4e50-ad7d-f235eab297e7_01-18-week2-PASSING_AND_PASSING,29,3,32
325201817,EnMasseProject/enmasse,18/08/18 17:27,spirals-bears,6799cc07-95a1-4e50-ad7d-f235eab297e7_01-18-week2-PASSING_AND_PASSING,29,0,29
326268415,EnMasseProject/enmasse,18/08/18 17:28,spirals-bears,6799cc07-95a1-4e50-ad7d-f235eab297e7_01-18-week2-PASSING_AND_PASSING,29,3,32
326776634,EnMasseProject/enmasse,18/08/18 17:28,spirals-bears,6799cc07-95a1-4e50-ad7d-f235eab297e7_01-18-week2-PASSING_AND_PASSING,31,0,31
326268380,EnMasseProject/enmasse,18/08/18 17:28,spirals-bears,6799cc07-95a1-4e50-ad7d-f235eab297e7_01-18-week2-PASSING_AND_PASSING,28,0,28
326723192,EnMasseProject/enmasse,18/08/18 17:29,spirals-bears,6799cc07-95a1-4e50-ad7d-f235eab297e7_01-18-week2-PASSING_AND_PASSING,30,2,32
326723133,EnMasseProject/enmasse,18/08/18 17:29,spirals-bears,6799cc07-95a1-4e50-ad7d-f235eab297e7_01-18-week2-PASSING_AND_PASSING,30,0,30
326719263,EnMasseProject/enmasse,18/08/18 17:30,spirals-bears,6799cc07-95a1-4e50-ad7d-f235eab297e7_01-18-week2-PASSING_AND_PASSING,28,3,31
326876839,EnMasseProject/enmasse,18/08/18 17:30,spirals-bears,6799cc07-95a1-4e50-ad7d-f235eab297e7_01-18-week2-PASSING_AND_PASSING,34,0,162,3,1,81,0,0,281
326719148,EnMasseProject/enmasse,18/08/18 17:30,spirals-bears,6799cc07-95a1-4e50-ad7d-f235eab297e7_01-18-week2-PASSING_AND_PASSING,28,0,28
326699140,EnMasseProject/enmasse,18/08/18 17:31,spirals-bears,6799cc07-95a1-4e50-ad7d-f235eab297e7_01-18-week2-PASSING_AND_PASSING,30,0,2,1,76,1,110
326699568,EnMasseProject/enmasse,18/08/18 17:31,spirals-bears,6799cc07-95a1-4e50-ad7d-f235eab297e7_01-18-week2-PASSING_AND_PASSING,28,0,2,0,1,31
326724523,EnMasseProject/enmasse,18/08/18 17:32,spirals-bears,6799cc07-95a1-4e50-ad7d-f235eab297e7_01-18-week2-PASSING_AND_PASSING,33,0,161,3,1,82,0,0,280
326434005,EnMasseProject/enmasse,18/08/18 17:32,spirals-bears,6799cc07-95a1-4e50-ad7d-f235eab297e7_01-18-week2-PASSING_AND_PASSING,31,0,31
326500370,EnMasseProject/enmasse,18/08/18 17:33,spirals-bears,6799cc07-95a1-4e50-ad7d-f235eab297e7_01-18-week2-PASSING_AND_PASSING,27,3,30
326366194,EnMasseProject/enmasse,18/08/18 17:33,spirals-bears,6799cc07-95a1-4e50-ad7d-f235eab297e7_01-18-week2-PASSING_AND_PASSING,29,0,1,1,77,0,108
326499054,EnMasseProject/enmasse,18/08/18 17:34,spirals-bears,6799cc07-95a1-4e50-ad7d-f235eab297e7_01-18-week2-PASSING_AND_PASSING,28,0,28
326388338,EnMasseProject/enmasse,18/08/18 17:34,spirals-bears,6799cc07-95a1-4e50-ad7d-f235eab297e7_01-18-week2-PASSING_AND_PASSING,29,0,29
326328331,EnMasseProject/enmasse,18/08/18 17:34,spirals-bears,6799cc07-95a1-4e50-ad7d-f235eab297e7_01-18-week2-PASSING_AND_PASSING,30,0,30
326069610,EnMasseProject/enmasse,18/08/18 17:35,spirals-bears,6799cc07-95a1-4e50-ad7d-f235eab297e7_01-18-week2-PASSING_AND_PASSING,27,2,29
326700838,EnMasseProject/enmasse,18/08/18 17:35,spirals-bears,6799cc07-95a1-4e50-ad7d-f235eab297e7_01-18-week2-PASSING_AND_PASSING,32,0,160,1,1,85,0,1,280
326700995,EnMasseProject/enmasse,18/08/18 17:35,spirals-bears,6799cc07-95a1-4e50-ad7d-f235eab297e7_01-18-week2-PASSING_AND_PASSING,29,0,162,1,5,85,0,4,286
327983282,batfish/batfish,18/08/18 17:36,spirals-bears,6799cc07-95a1-4e50-ad7d-f235eab297e7_01-18-week2-PASSING_AND_PASSING,50,4,54
327983266,batfish/batfish,18/08/18 17:36,spirals-bears,6799cc07-95a1-4e50-ad7d-f235eab297e7_01-18-week2-PASSING_AND_PASSING,50,0,50
327836813,batfish/batfish,18/08/18 17:36,spirals-bears,6799cc07-95a1-4e50-ad7d-f235eab297e7_01-18-week2-PASSING_AND_PASSING,66,0,0,0,37,3,106
327503666,batfish/batfish,18/08/18 17:37,spirals-bears,6799cc07-95a1-4e50-ad7d-f235eab297e7_01-18-week2-PASSING_AND_PASSING,52,2,54
327502497,batfish/batfish,18/08/18 17:37,spirals-bears,6799cc07-95a1-4e50-ad7d-f235eab297e7_01-18-week2-PASSING_AND_PASSING,54,0,1,0,38,1,94
327478456,batfish/batfish,18/08/18 17:37,spirals-bears,6799cc07-95a1-4e50-ad7d-f235eab297e7_01-18-week2-PASSING_AND_PASSING,53,0,53
327351963,batfish/batfish,18/08/18 17:38,spirals-bears,6799cc07-95a1-4e50-ad7d-f235eab297e7_01-18-week2-PASSING_AND_PASSING,67,0,67
327352204,batfish/batfish,18/08/18 17:38,spirals-bears,6799cc07-95a1-4e50-ad7d-f235eab297e7_01-18-week2-PASSING_AND_PASSING,64,3,67
325685380,batfish/batfish,18/08/18 17:38,spirals-bears,6799cc07-95a1-4e50-ad7d-f235eab297e7_01-18-week2-PASSING_AND_PASSING,48,4,52
326651817,batfish/batfish,18/08/18 17:39,spirals-bears,6799cc07-95a1-4e50-ad7d-f235eab297e7_01-18-week2-PASSING_AND_PASSING,49,0,49
326579536,batfish/batfish,18/08/18 17:39,spirals-bears,6799cc07-95a1-4e50-ad7d-f235eab297e7_01-18-week2-PASSING_AND_PASSING,68,0,0,0,1,69
326591514,batfish/batfish,18/08/18 17:40,spirals-bears,6799cc07-95a1-4e50-ad7d-f235eab297e7_01-18-week2-PASSING_AND_PASSING,75,0,1,0,1,77
326591547,batfish/batfish,18/08/18 17:40,spirals-bears,6799cc07-95a1-4e50-ad7d-f235eab297e7_01-18-week2-PASSING_AND_PASSING,50,0,0,4,6,60
326602085,batfish/batfish,18/08/18 17:40,spirals-bears,6799cc07-95a1-4e50-ad7d-f235eab297e7_01-18-week2-PASSING_AND_PASSING,49,0,49
326602130,batfish/batfish,18/08/18 17:41,spirals-bears,6799cc07-95a1-4e50-ad7d-f235eab297e7_01-18-week2-PASSING_AND_PASSING,55,3,58
325680817,batfish/batfish,18/08/18 17:41,spirals-bears,6799cc07-95a1-4e50-ad7d-f235eab297e7_01-18-week2-PASSING_AND_PASSING,52,0,52
326973763,batfish/batfish,18/08/18 17:41,spirals-bears,6799cc07-95a1-4e50-ad7d-f235eab297e7_01-18-week2-PASSING_AND_PASSING,55,0,7,0,0,160,0,1,223
325680831,batfish/batfish,18/08/18 17:41,spirals-bears,6799cc07-95a1-4e50-ad7d-f235eab297e7_01-18-week2-PASSING_AND_PASSING,50,3,53
326571316,batfish/batfish,18/08/18 17:42,spirals-bears,6799cc07-95a1-4e50-ad7d-f235eab297e7_01-18-week2-PASSING_AND_PASSING,53,5,58
326201048,batfish/batfish,18/08/18 17:43,spirals-bears,6799cc07-95a1-4e50-ad7d-f235eab297e7_01-18-week2-PASSING_AND_PASSING,49,0,0,0,46,2,97
318076850,matsim-org/matsim,18/08/18 17:44,spirals-bears,6799cc07-95a1-4e50-ad7d-f235eab297e7_01-18-week2-PASSING_AND_PASSING,182,0,182
316300895,matsim-org/matsim,18/08/18 17:57,spirals-bears,6799cc07-95a1-4e50-ad7d-f235eab297e7_01-18-week2-PASSING_AND_PASSING,161,0,0,1,702,1,865
294877060,matsim-org/matsim,18/08/18 17:59,spirals-bears,6799cc07-95a1-4e50-ad7d-f235eab297e7_01-18-week2-PASSING_AND_PASSING,138,0,0,0,2,140
327346944,matsim-org/matsim,18/08/18 18:13,spirals-bears,6799cc07-95a1-4e50-ad7d-f235eab297e7_01-18-week2-PASSING_AND_PASSING,200,0,0,1,1690,1,1892
325537016,matsim-org/matsim,18/08/18 18:15,spirals-bears,6799cc07-95a1-4e50-ad7d-f235eab297e7_01-18-week2-PASSING_AND_PASSING,177,0,0,3,1750,1,1931
328039811,apache/incubator-servicecomb-java-chassis,18/08/18 18:16,spirals-bears,6799cc07-95a1-4e50-ad7d-f235eab297e7_01-18-week2-PASSING_AND_PASSING,9,1,5,0,25,1,41
326341569,matsim-org/matsim,18/08/18 18:16,spirals-bears,6799cc07-95a1-4e50-ad7d-f235eab297e7_01-18-week2-PASSING_AND_PASSING,151,0,1,1,1741,2,1896
327994959,apache/incubator-servicecomb-java-chassis,18/08/18 18:16,spirals-bears,6799cc07-95a1-4e50-ad7d-f235eab297e7_01-18-week2-PASSING_AND_PASSING,8,0,8
325391628,matsim-org/matsim,18/08/18 18:17,spirals-bears,6799cc07-95a1-4e50-ad7d-f235eab297e7_01-18-week2-PASSING_AND_PASSING,408,0,1,2,660,2,1073
327175733,apache/incubator-servicecomb-java-chassis,18/08/18 18:18,spirals-bears,6799cc07-95a1-4e50-ad7d-f235eab297e7_01-18-week2-PASSING_AND_PASSING,10,3,13
327563025,apache/incubator-servicecomb-java-chassis,18/08/18 18:21,spirals-bears,6799cc07-95a1-4e50-ad7d-f235eab297e7_01-18-week2-PASSING_AND_PASSING,10,1,211,5,0,53,0,1,281
327500081,apache/incubator-servicecomb-java-chassis,18/08/18 18:23,spirals-bears,6799cc07-95a1-4e50-ad7d-f235eab297e7_01-18-week2-PASSING_AND_PASSING,9,1,211,5,0,50,0,2,278
327112740,apache/incubator-servicecomb-java-chassis,18/08/18 18:23,spirals-bears,6799cc07-95a1-4e50-ad7d-f235eab297e7_01-18-week2-PASSING_AND_PASSING,10,1,5,0,50,1,67
326744493,apache/incubator-servicecomb-java-chassis,18/08/18 18:23,spirals-bears,6799cc07-95a1-4e50-ad7d-f235eab297e7_01-18-week2-PASSING_AND_PASSING,10,3,13
327941192,apache/incubator-servicecomb-java-chassis,18/08/18 18:24,spirals-bears,6799cc07-95a1-4e50-ad7d-f235eab297e7_01-18-week2-PASSING_AND_PASSING,10,1,290,5,0,128,1,1,436
327112124,apache/incubator-servicecomb-java-chassis,18/08/18 18:24,spirals-bears,6799cc07-95a1-4e50-ad7d-f235eab297e7_01-18-week2-PASSING_AND_PASSING,10,1,5,0,49,1,66
326798526,apache/incubator-servicecomb-java-chassis,18/08/18 18:24,spirals-bears,6799cc07-95a1-4e50-ad7d-f235eab297e7_01-18-week2-PASSING_AND_PASSING,9,0,9
326703554,apache/incubator-servicecomb-java-chassis,18/08/18 18:25,spirals-bears,6799cc07-95a1-4e50-ad7d-f235eab297e7_01-18-week2-PASSING_AND_PASSING,9,1,5,0,30,1,46
326720285,apache/incubator-servicecomb-java-chassis,18/08/18 18:25,spirals-bears,6799cc07-95a1-4e50-ad7d-f235eab297e7_01-18-week2-PASSING_AND_PASSING,9,1,5,0,49,3,67
326699543,apache/incubator-servicecomb-java-chassis,18/08/18 18:26,spirals-bears,6799cc07-95a1-4e50-ad7d-f235eab297e7_01-18-week2-PASSING_AND_PASSING,9,3,12
326692766,apache/incubator-servicecomb-java-chassis,18/08/18 18:26,spirals-bears,6799cc07-95a1-4e50-ad7d-f235eab297e7_01-18-week2-PASSING_AND_PASSING,10,3,13
324147987,matsim-org/matsim,18/08/18 18:26,spirals-bears,6799cc07-95a1-4e50-ad7d-f235eab297e7_01-18-week2-PASSING_AND_PASSING,170,0,0,1,629,1,801
326693044,apache/incubator-servicecomb-java-chassis,18/08/18 18:27,spirals-bears,6799cc07-95a1-4e50-ad7d-f235eab297e7_01-18-week2-PASSING_AND_PASSING,9,1,5,0,35,1,51
326703289,apache/incubator-servicecomb-java-chassis,18/08/18 18:27,spirals-bears,6799cc07-95a1-4e50-ad7d-f235eab297e7_01-18-week2-PASSING_AND_PASSING,10,1,5,0,39,1,56
326625220,apache/incubator-servicecomb-java-chassis,18/08/18 18:27,spirals-bears,6799cc07-95a1-4e50-ad7d-f235eab297e7_01-18-week2-PASSING_AND_PASSING,9,3,12
326656256,apache/incubator-servicecomb-java-chassis,18/08/18 18:27,spirals-bears,6799cc07-95a1-4e50-ad7d-f235eab297e7_01-18-week2-PASSING_AND_PASSING,10,3,13
326680997,apache/incubator-servicecomb-java-chassis,18/08/18 18:27,spirals-bears,6799cc07-95a1-4e50-ad7d-f235eab297e7_01-18-week2-PASSING_AND_PASSING,9,0,9
326655133,apache/incubator-servicecomb-java-chassis,18/08/18 18:28,spirals-bears,6799cc07-95a1-4e50-ad7d-f235eab297e7_01-18-week2-PASSING_AND_PASSING,9,3,12
326776436,apache/incubator-servicecomb-java-chassis,18/08/18 18:28,spirals-bears,6799cc07-95a1-4e50-ad7d-f235eab297e7_01-18-week2-PASSING_AND_PASSING,9,1,202,5,0,50,0,1,268
326686815,apache/incubator-servicecomb-java-chassis,18/08/18 18:28,spirals-bears,6799cc07-95a1-4e50-ad7d-f235eab297e7_01-18-week2-PASSING_AND_PASSING,10,4,14
326686555,apache/incubator-servicecomb-java-chassis,18/08/18 18:28,spirals-bears,6799cc07-95a1-4e50-ad7d-f235eab297e7_01-18-week2-PASSING_AND_PASSING,9,3,12
326690905,apache/incubator-servicecomb-java-chassis,18/08/18 18:28,spirals-bears,6799cc07-95a1-4e50-ad7d-f235eab297e7_01-18-week2-PASSING_AND_PASSING,10,1,5,0,49,2,67
326653664,apache/incubator-servicecomb-java-chassis,18/08/18 18:28,spirals-bears,6799cc07-95a1-4e50-ad7d-f235eab297e7_01-18-week2-PASSING_AND_PASSING,10,3,13
324445180,apache/incubator-servicecomb-java-chassis,18/08/18 18:29,spirals-bears,6799cc07-95a1-4e50-ad7d-f235eab297e7_01-18-week2-PASSING_AND_PASSING,9,0,9
326688025,apache/incubator-servicecomb-java-chassis,18/08/18 18:29,spirals-bears,6799cc07-95a1-4e50-ad7d-f235eab297e7_01-18-week2-PASSING_AND_PASSING,9,1,7,0,32,2,51
326628915,apache/incubator-servicecomb-java-chassis,18/08/18 18:29,spirals-bears,6799cc07-95a1-4e50-ad7d-f235eab297e7_01-18-week2-PASSING_AND_PASSING,10,3,13
326280722,apache/incubator-servicecomb-java-chassis,18/08/18 18:29,spirals-bears,6799cc07-95a1-4e50-ad7d-f235eab297e7_01-18-week2-PASSING_AND_PASSING,11,0,11
325391530,apache/incubator-servicecomb-java-chassis,18/08/18 18:29,spirals-bears,6799cc07-95a1-4e50-ad7d-f235eab297e7_01-18-week2-PASSING_AND_PASSING,11,3,14
326644392,apache/incubator-servicecomb-java-chassis,18/08/18 18:29,spirals-bears,6799cc07-95a1-4e50-ad7d-f235eab297e7_01-18-week2-PASSING_AND_PASSING,10,3,13
326367223,apache/incubator-servicecomb-java-chassis,18/08/18 18:29,spirals-bears,6799cc07-95a1-4e50-ad7d-f235eab297e7_01-18-week2-PASSING_AND_PASSING,9,3,12
326228935,apache/incubator-servicecomb-java-chassis,18/08/18 18:30,spirals-bears,6799cc07-95a1-4e50-ad7d-f235eab297e7_01-18-week2-PASSING_AND_PASSING,11,5,16
326326672,apache/incubator-servicecomb-java-chassis,18/08/18 18:30,spirals-bears,6799cc07-95a1-4e50-ad7d-f235eab297e7_01-18-week2-PASSING_AND_PASSING,9,3,12
326627727,apache/incubator-servicecomb-java-chassis,18/08/18 18:30,spirals-bears,6799cc07-95a1-4e50-ad7d-f235eab297e7_01-18-week2-PASSING_AND_PASSING,10,1,5,0,30,1,47
326262746,apache/incubator-servicecomb-java-chassis,18/08/18 18:30,spirals-bears,6799cc07-95a1-4e50-ad7d-f235eab297e7_01-18-week2-PASSING_AND_PASSING,9,2,5,5,22,8,51
326279454,apache/incubator-servicecomb-java-chassis,18/08/18 18:30,spirals-bears,6799cc07-95a1-4e50-ad7d-f235eab297e7_01-18-week2-PASSING_AND_PASSING,10,3,13
326365589,apache/incubator-servicecomb-java-chassis,18/08/18 18:31,spirals-bears,6799cc07-95a1-4e50-ad7d-f235eab297e7_01-18-week2-PASSING_AND_PASSING,9,3,12
326622862,apache/incubator-servicecomb-java-chassis,18/08/18 18:31,spirals-bears,6799cc07-95a1-4e50-ad7d-f235eab297e7_01-18-week2-PASSING_AND_PASSING,9,2,5,0,30,2,48
326255229,apache/incubator-servicecomb-java-chassis,18/08/18 18:31,spirals-bears,6799cc07-95a1-4e50-ad7d-f235eab297e7_01-18-week2-PASSING_AND_PASSING,10,1,5,0,22,1,39
326261393,apache/incubator-servicecomb-java-chassis,18/08/18 18:31,spirals-bears,6799cc07-95a1-4e50-ad7d-f235eab297e7_01-18-week2-PASSING_AND_PASSING,9,3,12
326204571,apache/incubator-servicecomb-java-chassis,18/08/18 18:31,spirals-bears,6799cc07-95a1-4e50-ad7d-f235eab297e7_01-18-week2-PASSING_AND_PASSING,10,3,13
326277705,apache/incubator-servicecomb-java-chassis,18/08/18 18:31,spirals-bears,6799cc07-95a1-4e50-ad7d-f235eab297e7_01-18-week2-PASSING_AND_PASSING,9,0,9
324972932,apache/incubator-servicecomb-java-chassis,18/08/18 18:31,spirals-bears,6799cc07-95a1-4e50-ad7d-f235eab297e7_01-18-week2-PASSING_AND_PASSING,10,0,10
326256061,apache/incubator-servicecomb-java-chassis,18/08/18 18:32,spirals-bears,6799cc07-95a1-4e50-ad7d-f235eab297e7_01-18-week2-PASSING_AND_PASSING,9,3,12
325351889,apache/incubator-servicecomb-java-chassis,18/08/18 18:32,spirals-bears,6799cc07-95a1-4e50-ad7d-f235eab297e7_01-18-week2-PASSING_AND_PASSING,10,3,13
326219800,apache/incubator-servicecomb-java-chassis,18/08/18 18:32,spirals-bears,6799cc07-95a1-4e50-ad7d-f235eab297e7_01-18-week2-PASSING_AND_PASSING,9,3,12
326655015,apache/incubator-servicecomb-java-chassis,18/08/18 18:32,spirals-bears,6799cc07-95a1-4e50-ad7d-f235eab297e7_01-18-week2-PASSING_AND_PASSING,9,1,198,5,0,54,0,2,269
324925855,apache/incubator-servicecomb-java-chassis,18/08/18 18:33,spirals-bears,6799cc07-95a1-4e50-ad7d-f235eab297e7_01-18-week2-PASSING_AND_PASSING,9,3,12
325695057,apache/incubator-servicecomb-java-chassis,18/08/18 18:33,spirals-bears,6799cc07-95a1-4e50-ad7d-f235eab297e7_01-18-week2-PASSING_AND_PASSING,10,3,13
326201403,apache/incubator-servicecomb-java-chassis,18/08/18 18:33,spirals-bears,6799cc07-95a1-4e50-ad7d-f235eab297e7_01-18-week2-PASSING_AND_PASSING,9,3,12
328770103,runelite/runelite,18/08/18 18:34,spirals-bears,6799cc07-95a1-4e50-ad7d-f235eab297e7_01-18-week2-PASSING_AND_PASSING,10,0,10
328633601,runelite/runelite,18/08/18 18:34,spirals-bears,6799cc07-95a1-4e50-ad7d-f235eab297e7_01-18-week2-PASSING_AND_PASSING,11,0,11
328727631,runelite/runelite,18/08/18 18:34,spirals-bears,6799cc07-95a1-4e50-ad7d-f235eab297e7_01-18-week2-PASSING_AND_PASSING,11,0,11
328736085,runelite/runelite,18/08/18 18:35,spirals-bears,6799cc07-95a1-4e50-ad7d-f235eab297e7_01-18-week2-PASSING_AND_PASSING,10,0,10
328713084,runelite/runelite,18/08/18 18:35,spirals-bears,6799cc07-95a1-4e50-ad7d-f235eab297e7_01-18-week2-PASSING_AND_PASSING,11,0,11
328616801,runelite/runelite,18/08/18 18:35,spirals-bears,6799cc07-95a1-4e50-ad7d-f235eab297e7_01-18-week2-PASSING_AND_PASSING,11,0,11
326147662,runelite/runelite,18/08/18 18:36,spirals-bears,6799cc07-95a1-4e50-ad7d-f235eab297e7_01-18-week2-PASSING_AND_PASSING,10,14,24
328364832,runelite/runelite,18/08/18 18:36,spirals-bears,6799cc07-95a1-4e50-ad7d-f235eab297e7_01-18-week2-PASSING_AND_PASSING,10,0,10
328364511,runelite/runelite,18/08/18 18:37,spirals-bears,6799cc07-95a1-4e50-ad7d-f235eab297e7_01-18-week2-PASSING_AND_PASSING,11,0,11
325692981,apache/incubator-servicecomb-java-chassis,18/08/18 18:37,spirals-bears,6799cc07-95a1-4e50-ad7d-f235eab297e7_01-18-week2-PASSING_AND_PASSING,9,1,208,5,6,57,0,6,292
328357683,runelite/runelite,18/08/18 18:37,spirals-bears,6799cc07-95a1-4e50-ad7d-f235eab297e7_01-18-week2-PASSING_AND_PASSING,11,0,11
326459596,runelite/runelite,18/08/18 18:37,spirals-bears,6799cc07-95a1-4e50-ad7d-f235eab297e7_01-18-week2-PASSING_AND_PASSING,11,0,11
328245650,runelite/runelite,18/08/18 18:37,spirals-bears,6799cc07-95a1-4e50-ad7d-f235eab297e7_01-18-week2-PASSING_AND_PASSING,11,0,11
326227239,runelite/runelite,18/08/18 18:38,spirals-bears,6799cc07-95a1-4e50-ad7d-f235eab297e7_01-18-week2-PASSING_AND_PASSING,11,0,11
327348130,runelite/runelite,18/08/18 18:38,spirals-bears,6799cc07-95a1-4e50-ad7d-f235eab297e7_01-18-week2-PASSING_AND_PASSING,11,0,11
327907428,runelite/runelite,18/08/18 18:38,spirals-bears,6799cc07-95a1-4e50-ad7d-f235eab297e7_01-18-week2-PASSING_AND_PASSING,10,0,10
327236110,runelite/runelite,18/08/18 18:38,spirals-bears,6799cc07-95a1-4e50-ad7d-f235eab297e7_01-18-week2-PASSING_AND_PASSING,10,0,10
327605848,runelite/runelite,18/08/18 18:39,spirals-bears,6799cc07-95a1-4e50-ad7d-f235eab297e7_01-18-week2-PASSING_AND_PASSING,11,0,11
327627769,runelite/runelite,18/08/18 18:39,spirals-bears,6799cc07-95a1-4e50-ad7d-f235eab297e7_01-18-week2-PASSING_AND_PASSING,13,0,13
326156798,runelite/runelite,18/08/18 18:39,spirals-bears,6799cc07-95a1-4e50-ad7d-f235eab297e7_01-18-week2-PASSING_AND_PASSING,10,0,10
325940466,runelite/runelite,18/08/18 18:39,spirals-bears,6799cc07-95a1-4e50-ad7d-f235eab297e7_01-18-week2-PASSING_AND_PASSING,11,0,11
324225478,runelite/runelite,18/08/18 18:39,spirals-bears,6799cc07-95a1-4e50-ad7d-f235eab297e7_01-18-week2-PASSING_AND_PASSING,11,0,11
326218999,apache/incubator-servicecomb-java-chassis,18/08/18 18:39,spirals-bears,6799cc07-95a1-4e50-ad7d-f235eab297e7_01-18-week2-PASSING_AND_PASSING,11,4,2,2,7,112,0,5,4,1,203,0,6,0,20,3,12,2,3,58,455
326122108,runelite/runelite,18/08/18 18:40,spirals-bears,6799cc07-95a1-4e50-ad7d-f235eab297e7_01-18-week2-PASSING_AND_PASSING,12,14,26
326254985,apache/incubator-servicecomb-java-chassis,18/08/18 18:40,spirals-bears,6799cc07-95a1-4e50-ad7d-f235eab297e7_01-18-week2-PASSING_AND_PASSING,11,2,1,0,7,110,0,5,3,1,208,0,0,0,19,0,9,3,2,57,438
327839809,CorfuDB/CorfuDB,18/08/18 18:44,spirals-bears,6799cc07-95a1-4e50-ad7d-f235eab297e7_01-18-week2-PASSING_AND_PASSING,244,5,249
327946838,CorfuDB/CorfuDB,18/08/18 18:44,spirals-bears,6799cc07-95a1-4e50-ad7d-f235eab297e7_01-18-week2-PASSING_AND_PASSING,249,0,0,3,4,256
327444926,CorfuDB/CorfuDB,18/08/18 18:44,spirals-bears,6799cc07-95a1-4e50-ad7d-f235eab297e7_01-18-week2-PASSING_AND_PASSING,241,0,241
327835157,CorfuDB/CorfuDB,18/08/18 18:47,spirals-bears,6799cc07-95a1-4e50-ad7d-f235eab297e7_01-18-week2-PASSING_AND_PASSING,262,0,0,0,155,0,417
327470045,CorfuDB/CorfuDB,18/08/18 18:48,spirals-bears,6799cc07-95a1-4e50-ad7d-f235eab297e7_01-18-week2-PASSING_AND_PASSING,243,0,1,3,3,250
327898681,CorfuDB/CorfuDB,18/08/18 18:48,spirals-bears,6799cc07-95a1-4e50-ad7d-f235eab297e7_01-18-week2-PASSING_AND_PASSING,244,3,247
327898654,CorfuDB/CorfuDB,18/08/18 18:48,spirals-bears,6799cc07-95a1-4e50-ad7d-f235eab297e7_01-18-week2-PASSING_AND_PASSING,245,0,245
327897566,CorfuDB/CorfuDB,18/08/18 18:51,spirals-bears,6799cc07-95a1-4e50-ad7d-f235eab297e7_01-18-week2-PASSING_AND_PASSING,246,0,246
327897594,CorfuDB/CorfuDB,18/08/18 18:52,spirals-bears,6799cc07-95a1-4e50-ad7d-f235eab297e7_01-18-week2-PASSING_AND_PASSING,242,2,244
327167906,CorfuDB/CorfuDB,18/08/18 18:53,spirals-bears,6799cc07-95a1-4e50-ad7d-f235eab297e7_01-18-week2-PASSING_AND_PASSING,264,0,264
325379256,CorfuDB/CorfuDB,18/08/18 18:55,spirals-bears,6799cc07-95a1-4e50-ad7d-f235eab297e7_01-18-week2-PASSING_AND_PASSING,247,0,0,0,152,0,399
327186306,CorfuDB/CorfuDB,18/08/18 18:55,spirals-bears,6799cc07-95a1-4e50-ad7d-f235eab297e7_01-18-week2-PASSING_AND_PASSING,249,3,252
327025235,CorfuDB/CorfuDB,18/08/18 18:56,spirals-bears,6799cc07-95a1-4e50-ad7d-f235eab297e7_01-18-week2-PASSING_AND_PASSING,240,0,240
327025149,CorfuDB/CorfuDB,18/08/18 18:58,spirals-bears,6799cc07-95a1-4e50-ad7d-f235eab297e7_01-18-week2-PASSING_AND_PASSING,268,2,270
326966438,CorfuDB/CorfuDB,18/08/18 18:59,spirals-bears,6799cc07-95a1-4e50-ad7d-f235eab297e7_01-18-week2-PASSING_AND_PASSING,245,4,249
327037392,CorfuDB/CorfuDB,18/08/18 19:00,spirals-bears,6799cc07-95a1-4e50-ad7d-f235eab297e7_01-18-week2-PASSING_AND_PASSING,258,0,258
327165185,CorfuDB/CorfuDB,18/08/18 19:01,spirals-bears,6799cc07-95a1-4e50-ad7d-f235eab297e7_01-18-week2-PASSING_AND_PASSING,258,0,258
327066218,CorfuDB/CorfuDB,18/08/18 19:02,spirals-bears,6799cc07-95a1-4e50-ad7d-f235eab297e7_01-18-week2-PASSING_AND_PASSING,236,0,236
327035764,CorfuDB/CorfuDB,18/08/18 19:03,spirals-bears,6799cc07-95a1-4e50-ad7d-f235eab297e7_01-18-week2-PASSING_AND_PASSING,241,0,241
327001490,CorfuDB/CorfuDB,18/08/18 19:04,spirals-bears,6799cc07-95a1-4e50-ad7d-f235eab297e7_01-18-week2-PASSING_AND_PASSING,237,0,237
325296473,CorfuDB/CorfuDB,18/08/18 19:06,spirals-bears,6799cc07-95a1-4e50-ad7d-f235eab297e7_01-18-week2-PASSING_AND_PASSING,234,0,234
325285980,CorfuDB/CorfuDB,18/08/18 19:06,spirals-bears,6799cc07-95a1-4e50-ad7d-f235eab297e7_01-18-week2-PASSING_AND_PASSING,292,3,295
326991713,CorfuDB/CorfuDB,18/08/18 19:08,spirals-bears,6799cc07-95a1-4e50-ad7d-f235eab297e7_01-18-week2-PASSING_AND_PASSING,239,0,239
326990951,CorfuDB/CorfuDB,18/08/18 19:08,spirals-bears,6799cc07-95a1-4e50-ad7d-f235eab297e7_01-18-week2-PASSING_AND_PASSING,242,3,245
326965193,CorfuDB/CorfuDB,18/08/18 19:10,spirals-bears,6799cc07-95a1-4e50-ad7d-f235eab297e7_01-18-week2-PASSING_AND_PASSING,235,4,239
326762151,CorfuDB/CorfuDB,18/08/18 19:10,spirals-bears,6799cc07-95a1-4e50-ad7d-f235eab297e7_01-18-week2-PASSING_AND_PASSING,260,3,263
326932682,CorfuDB/CorfuDB,18/08/18 19:12,spirals-bears,6799cc07-95a1-4e50-ad7d-f235eab297e7_01-18-week2-PASSING_AND_PASSING,232,0,232
325681816,CorfuDB/CorfuDB,18/08/18 19:12,spirals-bears,6799cc07-95a1-4e50-ad7d-f235eab297e7_01-18-week2-PASSING_AND_PASSING,260,4,264
326618392,CorfuDB/CorfuDB,18/08/18 19:14,spirals-bears,6799cc07-95a1-4e50-ad7d-f235eab297e7_01-18-week2-PASSING_AND_PASSING,236,0,236
326762128,CorfuDB/CorfuDB,18/08/18 19:15,spirals-bears,6799cc07-95a1-4e50-ad7d-f235eab297e7_01-18-week2-PASSING_AND_PASSING,282,0,282
326618413,CorfuDB/CorfuDB,18/08/18 19:16,spirals-bears,6799cc07-95a1-4e50-ad7d-f235eab297e7_01-18-week2-PASSING_AND_PASSING,236,3,239
326605531,CorfuDB/CorfuDB,18/08/18 19:16,spirals-bears,6799cc07-95a1-4e50-ad7d-f235eab297e7_01-18-week2-PASSING_AND_PASSING,243,3,246
326605519,CorfuDB/CorfuDB,18/08/18 19:19,spirals-bears,6799cc07-95a1-4e50-ad7d-f235eab297e7_01-18-week2-PASSING_AND_PASSING,244,0,244
326533859,CorfuDB/CorfuDB,18/08/18 19:19,spirals-bears,6799cc07-95a1-4e50-ad7d-f235eab297e7_01-18-week2-PASSING_AND_PASSING,240,0,240
326410656,spring-projects/spring-data-jpa,18/08/18 19:19,spirals-bears,6799cc07-95a1-4e50-ad7d-f235eab297e7_01-18-week2-PASSING_AND_PASSING,5,0,3,0,165,0,173
327208807,apache/calcite,18/08/18 19:19,spirals-bears,6799cc07-95a1-4e50-ad7d-f235eab297e7_01-18-week2-PASSING_AND_PASSING,22,4,26
328352452,linkedin/pinot,18/08/18 19:20,spirals-bears,6799cc07-95a1-4e50-ad7d-f235eab297e7_01-18-week2-PASSING_AND_PASSING,35,4,39
328279415,linkedin/pinot,18/08/18 19:20,spirals-bears,6799cc07-95a1-4e50-ad7d-f235eab297e7_01-18-week2-PASSING_AND_PASSING,33,9,42
326533827,CorfuDB/CorfuDB,18/08/18 19:20,spirals-bears,6799cc07-95a1-4e50-ad7d-f235eab297e7_01-18-week2-PASSING_AND_PASSING,254,3,257
328324243,linkedin/pinot,18/08/18 19:21,spirals-bears,6799cc07-95a1-4e50-ad7d-f235eab297e7_01-18-week2-PASSING_AND_PASSING,35,3,38
316310988,spring-projects/spring-data-jpa,18/08/18 19:22,spirals-bears,6799cc07-95a1-4e50-ad7d-f235eab297e7_01-18-week2-PASSING_AND_PASSING,5,0,2,0,174,0,181
327497440,linkedin/pinot,18/08/18 19:22,spirals-bears,6799cc07-95a1-4e50-ad7d-f235eab297e7_01-18-week2-PASSING_AND_PASSING,38,3,41
327964274,linkedin/pinot,18/08/18 19:22,spirals-bears,6799cc07-95a1-4e50-ad7d-f235eab297e7_01-18-week2-PASSING_AND_PASSING,33,4,37
327943429,linkedin/pinot,18/08/18 19:23,spirals-bears,6799cc07-95a1-4e50-ad7d-f235eab297e7_01-18-week2-PASSING_AND_PASSING,37,3,40
328238543,linkedin/pinot,18/08/18 19:24,spirals-bears,6799cc07-95a1-4e50-ad7d-f235eab297e7_01-18-week2-PASSING_AND_PASSING,40,7,47
327933676,linkedin/pinot,18/08/18 19:25,spirals-bears,6799cc07-95a1-4e50-ad7d-f235eab297e7_01-18-week2-PASSING_AND_PASSING,37,0,0,6,199,5,247
327905064,linkedin/pinot,18/08/18 19:25,spirals-bears,6799cc07-95a1-4e50-ad7d-f235eab297e7_01-18-week2-PASSING_AND_PASSING,36,6,42
327863094,linkedin/pinot,18/08/18 19:26,spirals-bears,6799cc07-95a1-4e50-ad7d-f235eab297e7_01-18-week2-PASSING_AND_PASSING,49,3,52
327961434,linkedin/pinot,18/08/18 19:27,spirals-bears,6799cc07-95a1-4e50-ad7d-f235eab297e7_01-18-week2-PASSING_AND_PASSING,52,3,55
328276839,linkedin/pinot,18/08/18 19:28,spirals-bears,6799cc07-95a1-4e50-ad7d-f235eab297e7_01-18-week2-PASSING_AND_PASSING,38,0,0,1,343,1,383
327904835,linkedin/pinot,18/08/18 19:29,spirals-bears,6799cc07-95a1-4e50-ad7d-f235eab297e7_01-18-week2-PASSING_AND_PASSING,36,4,40
327942710,linkedin/pinot,18/08/18 19:29,spirals-bears,6799cc07-95a1-4e50-ad7d-f235eab297e7_01-18-week2-PASSING_AND_PASSING,32,0,0,1,233,3,269
327451592,linkedin/pinot,18/08/18 19:30,spirals-bears,6799cc07-95a1-4e50-ad7d-f235eab297e7_01-18-week2-PASSING_AND_PASSING,35,4,39
327444518,linkedin/pinot,18/08/18 19:32,spirals-bears,6799cc07-95a1-4e50-ad7d-f235eab297e7_01-18-week2-PASSING_AND_PASSING,36,0,1,1,200,3,241
327862054,linkedin/pinot,18/08/18 19:32,spirals-bears,6799cc07-95a1-4e50-ad7d-f235eab297e7_01-18-week2-PASSING_AND_PASSING,37,3,40
327431017,linkedin/pinot,18/08/18 19:35,spirals-bears,6799cc07-95a1-4e50-ad7d-f235eab297e7_01-18-week2-PASSING_AND_PASSING,34,0,0,6,228,8,276
326313339,linkedin/pinot,18/08/18 19:36,spirals-bears,6799cc07-95a1-4e50-ad7d-f235eab297e7_01-18-week2-PASSING_AND_PASSING,49,4,53
324275736,linkedin/pinot,18/08/18 19:37,spirals-bears,6799cc07-95a1-4e50-ad7d-f235eab297e7_01-18-week2-PASSING_AND_PASSING,34,0,1,7,200,6,248
320970308,linkedin/pinot,18/08/18 19:37,spirals-bears,6799cc07-95a1-4e50-ad7d-f235eab297e7_01-18-week2-PASSING_AND_PASSING,36,4,40
327448361,Azure/azure-libraries-for-java,18/08/18 19:39,spirals-bears,6799cc07-95a1-4e50-ad7d-f235eab297e7_01-18-week2-PASSING_AND_PASSING,62,3,65
327369912,Azure/azure-libraries-for-java,18/08/18 19:40,spirals-bears,6799cc07-95a1-4e50-ad7d-f235eab297e7_01-18-week2-PASSING_AND_PASSING,61,3,64
326591902,linkedin/pinot,18/08/18 19:40,spirals-bears,6799cc07-95a1-4e50-ad7d-f235eab297e7_01-18-week2-PASSING_AND_PASSING,32,0,0,1,211,3,247
326383656,graphhopper/graphhopper,18/08/18 19:41,spirals-bears,6799cc07-95a1-4e50-ad7d-f235eab297e7_01-18-week2-PASSING_AND_PASSING,16,0,0,0,25,0,41
316169591,graphhopper/graphhopper,18/08/18 19:42,spirals-bears,6799cc07-95a1-4e50-ad7d-f235eab297e7_01-18-week2-PASSING_AND_PASSING,17,6,23
326849958,HubSpot/Singularity,18/08/18 19:45,spirals-bears,6799cc07-95a1-4e50-ad7d-f235eab297e7_01-18-week2-PASSING_AND_PASSING,17,0,1,0,145,0,163
328119252,molgenis/molgenis,18/08/18 19:46,spirals-bears,6799cc07-95a1-4e50-ad7d-f235eab297e7_01-18-week2-PASSING_AND_PASSING,40,9,49
326607634,graphhopper/graphhopper,18/08/18 19:46,spirals-bears,6799cc07-95a1-4e50-ad7d-f235eab297e7_01-18-week2-PASSING_AND_PASSING,13,4,0,0,8,50,0,0,4,0,73,0,0,0,38,0,17,4,4,123,338
328118299,molgenis/molgenis,18/08/18 19:47,spirals-bears,6799cc07-95a1-4e50-ad7d-f235eab297e7_01-18-week2-PASSING_AND_PASSING,39,0,1,4,10,54
327737888,molgenis/molgenis,18/08/18 19:48,spirals-bears,6799cc07-95a1-4e50-ad7d-f235eab297e7_01-18-week2-PASSING_AND_PASSING,38,0,1,0,50,1,90
327615851,molgenis/molgenis,18/08/18 19:48,spirals-bears,6799cc07-95a1-4e50-ad7d-f235eab297e7_01-18-week2-PASSING_AND_PASSING,39,0,1,0,29,1,70
327614090,molgenis/molgenis,18/08/18 19:49,spirals-bears,6799cc07-95a1-4e50-ad7d-f235eab297e7_01-18-week2-PASSING_AND_PASSING,37,0,2,1,36,1,77
327263651,molgenis/molgenis,18/08/18 19:51,spirals-bears,6799cc07-95a1-4e50-ad7d-f235eab297e7_01-18-week2-PASSING_AND_PASSING,38,0,2,6,49,10,105
327260581,molgenis/molgenis,18/08/18 19:52,spirals-bears,6799cc07-95a1-4e50-ad7d-f235eab297e7_01-18-week2-PASSING_AND_PASSING,41,0,1,5,10,57
327132403,molgenis/molgenis,18/08/18 19:53,spirals-bears,6799cc07-95a1-4e50-ad7d-f235eab297e7_01-18-week2-PASSING_AND_PASSING,43,9,52
326852281,molgenis/molgenis,18/08/18 19:55,spirals-bears,6799cc07-95a1-4e50-ad7d-f235eab297e7_01-18-week2-PASSING_AND_PASSING,43,0,1,1,47,1,93
327140394,molgenis/molgenis,18/08/18 19:56,spirals-bears,6799cc07-95a1-4e50-ad7d-f235eab297e7_01-18-week2-PASSING_AND_PASSING,39,0,1,0,402,2,444
326378056,molgenis/molgenis,18/08/18 19:57,spirals-bears,6799cc07-95a1-4e50-ad7d-f235eab297e7_01-18-week2-PASSING_AND_PASSING,37,0,1,1,49,1,89
328223901,StuPro-TOSCAna/TOSCAna,18/08/18 19:57,spirals-bears,6799cc07-95a1-4e50-ad7d-f235eab297e7_01-18-week2-PASSING_AND_PASSING,15,2,17
328224034,StuPro-TOSCAna/TOSCAna,18/08/18 19:57,spirals-bears,6799cc07-95a1-4e50-ad7d-f235eab297e7_01-18-week2-PASSING_AND_PASSING,15,0,15
328507208,StuPro-TOSCAna/TOSCAna,18/08/18 19:58,spirals-bears,6799cc07-95a1-4e50-ad7d-f235eab297e7_01-18-week2-PASSING_AND_PASSING,20,2,22
328507198,StuPro-TOSCAna/TOSCAna,18/08/18 19:58,spirals-bears,6799cc07-95a1-4e50-ad7d-f235eab297e7_01-18-week2-PASSING_AND_PASSING,13,0,13
328110220,StuPro-TOSCAna/TOSCAna,18/08/18 19:59,spirals-bears,6799cc07-95a1-4e50-ad7d-f235eab297e7_01-18-week2-PASSING_AND_PASSING,15,3,18
328109472,StuPro-TOSCAna/TOSCAna,18/08/18 19:59,spirals-bears,6799cc07-95a1-4e50-ad7d-f235eab297e7_01-18-week2-PASSING_AND_PASSING,18,0,18
327617952,StuPro-TOSCAna/TOSCAna,18/08/18 20:00,spirals-bears,6799cc07-95a1-4e50-ad7d-f235eab297e7_01-18-week2-PASSING_AND_PASSING,14,0,14
328705243,StuPro-TOSCAna/TOSCAna,18/08/18 20:00,spirals-bears,6799cc07-95a1-4e50-ad7d-f235eab297e7_01-18-week2-PASSING_AND_PASSING,13,0,2,0,208,0,223
327618109,StuPro-TOSCAna/TOSCAna,18/08/18 20:00,spirals-bears,6799cc07-95a1-4e50-ad7d-f235eab297e7_01-18-week2-PASSING_AND_PASSING,16,2,18
328062211,StuPro-TOSCAna/TOSCAna,18/08/18 20:01,spirals-bears,6799cc07-95a1-4e50-ad7d-f235eab297e7_01-18-week2-PASSING_AND_PASSING,16,2,18
328062169,StuPro-TOSCAna/TOSCAna,18/08/18 20:01,spirals-bears,6799cc07-95a1-4e50-ad7d-f235eab297e7_01-18-week2-PASSING_AND_PASSING,13,0,13
328062189,StuPro-TOSCAna/TOSCAna,18/08/18 20:01,spirals-bears,6799cc07-95a1-4e50-ad7d-f235eab297e7_01-18-week2-PASSING_AND_PASSING,15,2,17
318670364,StuPro-TOSCAna/TOSCAna,18/08/18 20:02,spirals-bears,6799cc07-95a1-4e50-ad7d-f235eab297e7_01-18-week2-PASSING_AND_PASSING,15,2,17
327925294,StuPro-TOSCAna/TOSCAna,18/08/18 20:04,spirals-bears,6799cc07-95a1-4e50-ad7d-f235eab297e7_01-18-week2-PASSING_AND_PASSING,16,0,1,0,78,0,95
326194163,StuPro-TOSCAna/TOSCAna,18/08/18 20:04,spirals-bears,6799cc07-95a1-4e50-ad7d-f235eab297e7_01-18-week2-PASSING_AND_PASSING,28,0,28
327424746,StuPro-TOSCAna/TOSCAna,18/08/18 20:05,spirals-bears,6799cc07-95a1-4e50-ad7d-f235eab297e7_01-18-week2-PASSING_AND_PASSING,18,0,18
327424763,StuPro-TOSCAna/TOSCAna,18/08/18 20:05,spirals-bears,6799cc07-95a1-4e50-ad7d-f235eab297e7_01-18-week2-PASSING_AND_PASSING,17,2,19
326194171,StuPro-TOSCAna/TOSCAna,18/08/18 20:06,spirals-bears,6799cc07-95a1-4e50-ad7d-f235eab297e7_01-18-week2-PASSING_AND_PASSING,14,2,16
327801565,StuPro-TOSCAna/TOSCAna,18/08/18 20:06,spirals-bears,6799cc07-95a1-4e50-ad7d-f235eab297e7_01-18-week2-PASSING_AND_PASSING,17,0,17
327801660,StuPro-TOSCAna/TOSCAna,18/08/18 20:06,spirals-bears,6799cc07-95a1-4e50-ad7d-f235eab297e7_01-18-week2-PASSING_AND_PASSING,16,2,18
328605997,StuPro-TOSCAna/TOSCAna,18/08/18 20:07,spirals-bears,6799cc07-95a1-4e50-ad7d-f235eab297e7_01-18-week2-PASSING_AND_PASSING,10,0,0,124,0,2,1,0,122,0,0,21,0,15,1,99,395
327887101,StuPro-TOSCAna/TOSCAna,18/08/18 20:07,spirals-bears,6799cc07-95a1-4e50-ad7d-f235eab297e7_01-18-week2-PASSING_AND_PASSING,15,2,17
327887053,StuPro-TOSCAna/TOSCAna,18/08/18 20:07,spirals-bears,6799cc07-95a1-4e50-ad7d-f235eab297e7_01-18-week2-PASSING_AND_PASSING,15,0,15
327873800,StuPro-TOSCAna/TOSCAna,18/08/18 20:08,spirals-bears,6799cc07-95a1-4e50-ad7d-f235eab297e7_01-18-week2-PASSING_AND_PASSING,20,2,22
327873783,StuPro-TOSCAna/TOSCAna,18/08/18 20:08,spirals-bears,6799cc07-95a1-4e50-ad7d-f235eab297e7_01-18-week2-PASSING_AND_PASSING,14,0,14
327610725,StuPro-TOSCAna/TOSCAna,18/08/18 20:09,spirals-bears,6799cc07-95a1-4e50-ad7d-f235eab297e7_01-18-week2-PASSING_AND_PASSING,14,2,16
319245365,StuPro-TOSCAna/TOSCAna,18/08/18 20:09,spirals-bears,6799cc07-95a1-4e50-ad7d-f235eab297e7_01-18-week2-PASSING_AND_PASSING,14,0,14
319245378,StuPro-TOSCAna/TOSCAna,18/08/18 20:10,spirals-bears,6799cc07-95a1-4e50-ad7d-f235eab297e7_01-18-week2-PASSING_AND_PASSING,18,2,20
327290236,StuPro-TOSCAna/TOSCAna,18/08/18 20:10,spirals-bears,6799cc07-95a1-4e50-ad7d-f235eab297e7_01-18-week2-PASSING_AND_PASSING,17,2,19
327419606,StuPro-TOSCAna/TOSCAna,18/08/18 20:11,spirals-bears,6799cc07-95a1-4e50-ad7d-f235eab297e7_01-18-week2-PASSING_AND_PASSING,13,2,15
327419616,StuPro-TOSCAna/TOSCAna,18/08/18 20:11,spirals-bears,6799cc07-95a1-4e50-ad7d-f235eab297e7_01-18-week2-PASSING_AND_PASSING,21,0,21
326091580,StuPro-TOSCAna/TOSCAna,18/08/18 20:11,spirals-bears,6799cc07-95a1-4e50-ad7d-f235eab297e7_01-18-week2-PASSING_AND_PASSING,15,2,17
326091576,StuPro-TOSCAna/TOSCAna,18/08/18 20:12,spirals-bears,6799cc07-95a1-4e50-ad7d-f235eab297e7_01-18-week2-PASSING_AND_PASSING,14,0,14
327707569,StuPro-TOSCAna/TOSCAna,18/08/18 20:15,spirals-bears,6799cc07-95a1-4e50-ad7d-f235eab297e7_01-18-week2-PASSING_AND_PASSING,11,0,0,124,0,2,1,0,122,0,0,23,0,13,1,207,504
326981135,StuPro-TOSCAna/TOSCAna,18/08/18 20:16,spirals-bears,6799cc07-95a1-4e50-ad7d-f235eab297e7_01-18-week2-PASSING_AND_PASSING,33,2,35
326981078,StuPro-TOSCAna/TOSCAna,18/08/18 20:16,spirals-bears,6799cc07-95a1-4e50-ad7d-f235eab297e7_01-18-week2-PASSING_AND_PASSING,19,0,19
326900529,StuPro-TOSCAna/TOSCAna,18/08/18 20:17,spirals-bears,6799cc07-95a1-4e50-ad7d-f235eab297e7_01-18-week2-PASSING_AND_PASSING,17,2,19
326900463,StuPro-TOSCAna/TOSCAna,18/08/18 20:17,spirals-bears,6799cc07-95a1-4e50-ad7d-f235eab297e7_01-18-week2-PASSING_AND_PASSING,14,0,14
326839098,StuPro-TOSCAna/TOSCAna,18/08/18 20:18,spirals-bears,6799cc07-95a1-4e50-ad7d-f235eab297e7_01-18-week2-PASSING_AND_PASSING,38,2,40
326838802,StuPro-TOSCAna/TOSCAna,18/08/18 20:18,spirals-bears,6799cc07-95a1-4e50-ad7d-f235eab297e7_01-18-week2-PASSING_AND_PASSING,14,0,14
327366406,StuPro-TOSCAna/TOSCAna,18/08/18 20:19,spirals-bears,6799cc07-95a1-4e50-ad7d-f235eab297e7_01-18-week2-PASSING_AND_PASSING,11,0,0,125,0,1,1,0,124,0,0,31,0,18,2,93,406
326455494,StuPro-TOSCAna/TOSCAna,18/08/18 20:19,spirals-bears,6799cc07-95a1-4e50-ad7d-f235eab297e7_01-18-week2-PASSING_AND_PASSING,20,0,20
326459457,StuPro-TOSCAna/TOSCAna,18/08/18 20:20,spirals-bears,6799cc07-95a1-4e50-ad7d-f235eab297e7_01-18-week2-PASSING_AND_PASSING,17,2,19
326369036,StuPro-TOSCAna/TOSCAna,18/08/18 20:20,spirals-bears,6799cc07-95a1-4e50-ad7d-f235eab297e7_01-18-week2-PASSING_AND_PASSING,15,2,17
326088347,StuPro-TOSCAna/TOSCAna,18/08/18 20:20,spirals-bears,6799cc07-95a1-4e50-ad7d-f235eab297e7_01-18-week2-PASSING_AND_PASSING,16,0,2,0,90,0,108
328332756,linkedin/pinot,18/08/18 20:23,spirals-bears,6799cc07-95a1-4e50-ad7d-f235eab297e7_01-18-week2-PASSING_AND_PASSING,37,0,3274,0,1,447,0,2,3761
327282950,languagetool-org/languagetool,18/08/18 20:26,spirals-bears,6799cc07-95a1-4e50-ad7d-f235eab297e7_01-18-week2-PASSING_AND_PASSING,269,0,1,2,31,1,304
327841528,linkedin/pinot,18/08/18 20:35,spirals-bears,6799cc07-95a1-4e50-ad7d-f235eab297e7_01-18-week2-PASSING_AND_PASSING,38,0,3417,0,6,432,1,7,3901
326471143,languagetool-org/languagetool,18/08/18 20:46,spirals-bears,6799cc07-95a1-4e50-ad7d-f235eab297e7_01-18-week2-PASSING_AND_PASSING,283,0,770,4,1,134,3,4,1199
328059601,languagetool-org/languagetool,18/08/18 20:48,spirals-bears,6799cc07-95a1-4e50-ad7d-f235eab297e7_01-18-week2-PASSING_AND_PASSING,9,37,0,0,28,188,0,0,34,0,776,0,0,0,79,0,281,48,32,106,1618
326966072,languagetool-org/languagetool,18/08/18 20:50,spirals-bears,6799cc07-95a1-4e50-ad7d-f235eab297e7_01-18-week2-PASSING_AND_PASSING,9,38,0,0,28,211,0,0,37,0,764,0,0,0,63,0,272,35,40,107,1604
327195655,apache/incubator-dubbo,18/08/18 20:51,spirals-bears,6799cc07-95a1-4e50-ad7d-f235eab297e7_01-18-week2-PASSING_AND_PASSING,9,0,9
327140840,apache/incubator-dubbo,18/08/18 20:51,spirals-bears,6799cc07-95a1-4e50-ad7d-f235eab297e7_01-18-week2-PASSING_AND_PASSING,8,0,8
327207405,apache/incubator-dubbo,18/08/18 20:55,spirals-bears,6799cc07-95a1-4e50-ad7d-f235eab297e7_01-18-week2-PASSING_AND_PASSING,8,0,152,1,0,264,0,1,426
328157943,ga4gh/dockstore,18/08/18 21:01,spirals-bears,6799cc07-95a1-4e50-ad7d-f235eab297e7_01-18-week2-PASSING_AND_PASSING,22,0,0,0,556,0,578
327451554,ga4gh/dockstore,18/08/18 21:01,spirals-bears,6799cc07-95a1-4e50-ad7d-f235eab297e7_01-18-week2-PASSING_AND_PASSING,9,2,11
327438368,ga4gh/dockstore,18/08/18 21:01,spirals-bears,6799cc07-95a1-4e50-ad7d-f235eab297e7_01-18-week2-PASSING_AND_PASSING,9,0,9
326819638,apache/incubator-dubbo,18/08/18 21:02,spirals-bears,6799cc07-95a1-4e50-ad7d-f235eab297e7_01-18-week2-PASSING_AND_PASSING,10,0,2,152,0,4,4,0,160,6,0,167,3,8,4,392,912
327291859,ga4gh/dockstore,18/08/18 21:02,spirals-bears,6799cc07-95a1-4e50-ad7d-f235eab297e7_01-18-week2-PASSING_AND_PASSING,9,2,11
326084325,languagetool-org/languagetool,18/08/18 21:08,spirals-bears,6799cc07-95a1-4e50-ad7d-f235eab297e7_01-18-week2-PASSING_AND_PASSING,10,41,0,0,27,590,0,0,28,0,770,0,0,0,61,0,266,37,36,106,1972
327845212,ga4gh/dockstore,18/08/18 21:08,spirals-bears,6799cc07-95a1-4e50-ad7d-f235eab297e7_01-18-week2-PASSING_AND_PASSING,9,0,0,0,778,0,787
326962099,ga4gh/dockstore,18/08/18 21:08,spirals-bears,6799cc07-95a1-4e50-ad7d-f235eab297e7_01-18-week2-PASSING_AND_PASSING,8,2,10
326961168,ga4gh/dockstore,18/08/18 21:09,spirals-bears,6799cc07-95a1-4e50-ad7d-f235eab297e7_01-18-week2-PASSING_AND_PASSING,10,0,10
326503637,ga4gh/dockstore,18/08/18 21:09,spirals-bears,6799cc07-95a1-4e50-ad7d-f235eab297e7_01-18-week2-PASSING_AND_PASSING,10,2,12
315555850,ga4gh/dockstore,18/08/18 21:09,spirals-bears,6799cc07-95a1-4e50-ad7d-f235eab297e7_01-18-week2-PASSING_AND_PASSING,10,0,10
327409513,ga4gh/dockstore,18/08/18 21:12,spirals-bears,6799cc07-95a1-4e50-ad7d-f235eab297e7_01-18-week2-PASSING_AND_PASSING,10,0,0,0,537,0,547
327290824,ga4gh/dockstore,18/08/18 21:16,spirals-bears,6799cc07-95a1-4e50-ad7d-f235eab297e7_01-18-week2-PASSING_AND_PASSING,6,0,0,12,0,0,2,0,11,0,0,78,0,9,3,754,875
326503689,ga4gh/dockstore,18/08/18 21:16,spirals-bears,6799cc07-95a1-4e50-ad7d-f235eab297e7_01-18-week2-PASSING_AND_PASSING,10,0,10
325638000,ga4gh/dockstore,18/08/18 21:17,spirals-bears,6799cc07-95a1-4e50-ad7d-f235eab297e7_01-18-week2-PASSING_AND_PASSING,10,2,12
326549882,ga4gh/dockstore,18/08/18 21:17,spirals-bears,6799cc07-95a1-4e50-ad7d-f235eab297e7_01-18-week2-PASSING_AND_PASSING,9,0,0,0,514,0,523
326444114,ga4gh/dockstore,18/08/18 21:20,spirals-bears,6799cc07-95a1-4e50-ad7d-f235eab297e7_01-18-week2-PASSING_AND_PASSING,10,0,0,0,504,0,514
325610719,ga4gh/dockstore,18/08/18 21:23,spirals-bears,6799cc07-95a1-4e50-ad7d-f235eab297e7_01-18-week2-PASSING_AND_PASSING,5,0,0,12,0,0,1,0,9,0,0,67,0,9,1,724,828
327707843,apache/jackrabbit-oak,18/08/18 21:24,spirals-bears,6799cc07-95a1-4e50-ad7d-f235eab297e7_01-18-week2-PASSING_AND_PASSING,37,0,2,0,380,2,421
327766248,apache/jackrabbit-oak,18/08/18 21:24,spirals-bears,6799cc07-95a1-4e50-ad7d-f235eab297e7_01-18-week2-PASSING_AND_PASSING,36,0,2,0,372,1,411
326194032,apache/jackrabbit-oak,18/08/18 21:59,spirals-bears,6799cc07-95a1-4e50-ad7d-f235eab297e7_01-18-week2-PASSING_AND_PASSING,35,0,1952,1,0,154,1,3,2146
326194002,apache/jackrabbit-oak,18/08/18 22:17,spirals-bears,6799cc07-95a1-4e50-ad7d-f235eab297e7_01-18-week2-PASSING_AND_PASSING,7,0,0,1429,0,1,7,0,1195,0,1,187,1,36,12,272,3148
327624255,apache/jackrabbit-oak,18/08/18 22:18,spirals-bears,6799cc07-95a1-4e50-ad7d-f235eab297e7_01-18-week2-PASSING_AND_PASSING,8,0,0,621,1,2,9,0,1686,1,1,404,0,35,13,462,3243
327707786,apache/jackrabbit-oak,18/08/18 22:32,spirals-bears,6799cc07-95a1-4e50-ad7d-f235eab297e7_01-18-week2-PASSING_AND_PASSING,8,0,0,1716,0,2,22,0,1647,0,2,397,0,34,18,466,4312
327173713,apache/jackrabbit-oak,18/08/18 22:52,spirals-bears,6799cc07-95a1-4e50-ad7d-f235eab297e7_01-18-week2-PASSING_AND_PASSING,35,0,664,1,0,473,1,1174
326986523,apache/jackrabbit-oak,18/08/18 23:02,spirals-bears,6799cc07-95a1-4e50-ad7d-f235eab297e7_01-18-week2-PASSING_AND_PASSING,11,0,0,1492,2,1,9,0,1726,0,1,180,0,38,14,283,3757
326823914,apache/jackrabbit-oak,18/08/18 23:30,spirals-bears,6799cc07-95a1-4e50-ad7d-f235eab297e7_01-18-week2-PASSING_AND_PASSING,9,0,0,1661,1,2,13,0,1694,1,1,402,0,36,25,476,4321
327176703,apache/jackrabbit-oak,18/08/18 23:32,spirals-bears,6799cc07-95a1-4e50-ad7d-f235eab297e7_01-18-week2-PASSING_AND_PASSING,14,0,0,1687,1,2,13,0,1711,0,1,399,0,38,18,481,4365
326986596,apache/jackrabbit-oak,19/08/18 00:06,spirals-bears,6799cc07-95a1-4e50-ad7d-f235eab297e7_01-18-week2-PASSING_AND_PASSING,16,0,0,1689,1,2,24,0,1707,1,4,394,0,38,18,494,4388
326823729,apache/jackrabbit-oak,19/08/18 00:17,spirals-bears,6799cc07-95a1-4e50-ad7d-f235eab297e7_01-18-week2-PASSING_AND_PASSING,10,0,0,1757,1,2,15,0,1777,1,1,385,0,37,24,467,4477
326193958,apache/jackrabbit-oak,19/08/18 00:39,spirals-bears,6799cc07-95a1-4e50-ad7d-f235eab297e7_01-18-week2-PASSING_AND_PASSING,10,0,0,1727,1,1,14,0,1816,0,1,201,0,48,15,284,4118
326817220,apache/jackrabbit-oak,19/08/18 00:45,spirals-bears,6799cc07-95a1-4e50-ad7d-f235eab297e7_01-18-week2-PASSING_AND_PASSING,17,0,0,1689,0,2,17,0,1696,1,1,421,1,36,18,477,4376
322578985,apache/jackrabbit-oak,19/08/18 00:53,spirals-bears,6799cc07-95a1-4e50-ad7d-f235eab297e7_01-18-week2-PASSING_AND_PASSING,10,0,0,1241,0,2,9,0,1005,1,1,196,0,38,13,292,2808
327019394,atomix/atomix,19/08/18 00:53,spirals-bears,6799cc07-95a1-4e50-ad7d-f235eab297e7_01-18-week2-PASSING_AND_PASSING,11,2,13
327077440,airlift/airlift,19/08/18 00:54,spirals-bears,6799cc07-95a1-4e50-ad7d-f235eab297e7_01-18-week2-PASSING_AND_PASSING,13,3,16
325676800,airlift/airlift,19/08/18 00:54,spirals-bears,6799cc07-95a1-4e50-ad7d-f235eab297e7_01-18-week2-PASSING_AND_PASSING,12,3,15
324869823,airlift/airlift,19/08/18 00:55,spirals-bears,6799cc07-95a1-4e50-ad7d-f235eab297e7_01-18-week2-PASSING_AND_PASSING,13,2,15
322915824,apache/jackrabbit-oak,19/08/18 00:55,spirals-bears,6799cc07-95a1-4e50-ad7d-f235eab297e7_01-18-week2-PASSING_AND_PASSING,37,0,2043,1,0,161,1,1,2244
327794525,resteasy/Resteasy,19/08/18 00:56,spirals-bears,6799cc07-95a1-4e50-ad7d-f235eab297e7_01-18-week2-PASSING_AND_PASSING,17,2,1,20
319893220,resteasy/Resteasy,19/08/18 00:56,spirals-bears,6799cc07-95a1-4e50-ad7d-f235eab297e7_01-18-week2-PASSING_AND_PASSING,20,2,1,23
318103084,resteasy/Resteasy,19/08/18 00:57,spirals-bears,6799cc07-95a1-4e50-ad7d-f235eab297e7_01-18-week2-PASSING_AND_PASSING,17,2,6,25
327009952,resteasy/Resteasy,19/08/18 00:57,spirals-bears,6799cc07-95a1-4e50-ad7d-f235eab297e7_01-18-week2-PASSING_AND_PASSING,18,2,1,21
326899927,resteasy/Resteasy,19/08/18 00:58,spirals-bears,6799cc07-95a1-4e50-ad7d-f235eab297e7_01-18-week2-PASSING_AND_PASSING,18,2,1,21
326894259,resteasy/Resteasy,19/08/18 00:58,spirals-bears,6799cc07-95a1-4e50-ad7d-f235eab297e7_01-18-week2-PASSING_AND_PASSING,19,2,2,23
322239136,pgjdbc/pgjdbc,19/08/18 00:59,spirals-bears,6799cc07-95a1-4e50-ad7d-f235eab297e7_01-18-week2-PASSING_AND_PASSING,9,0,0,4,29,4,46
327812291,geoserver/geoserver,19/08/18 01:01,spirals-bears,6799cc07-95a1-4e50-ad7d-f235eab297e7_01-18-week2-PASSING_AND_PASSING,56,0,1,7,13,77
327989553,openzipkin/zipkin,19/08/18 01:08,spirals-bears,6799cc07-95a1-4e50-ad7d-f235eab297e7_01-18-week2-PASSING_AND_PASSING,9,6,0,0,6,19,0,2,5,0,267,0,0,0,154,0,25,6,6,287,792
327422903,geoserver/geoserver,19/08/18 01:16,spirals-bears,6799cc07-95a1-4e50-ad7d-f235eab297e7_01-18-week2-PASSING_AND_PASSING,56,0,1,3,410,5,475
326600826,geoserver/geoserver,19/08/18 01:24,spirals-bears,6799cc07-95a1-4e50-ad7d-f235eab297e7_01-18-week2-PASSING_AND_PASSING,53,0,1,9,381,18,462
320212937,geoserver/geoserver,19/08/18 01:29,spirals-bears,6799cc07-95a1-4e50-ad7d-f235eab297e7_01-18-week2-PASSING_AND_PASSING,11,0,0,452,0,1,30,0,438,1,0,33,0,49,25,604,1644
327670527,aicis/fresco,19/08/18 01:29,spirals-bears,6799cc07-95a1-4e50-ad7d-f235eab297e7_01-18-week2-PASSING_AND_PASSING,8,0,0,4,25,5,42
327647048,aicis/fresco,19/08/18 01:30,spirals-bears,6799cc07-95a1-4e50-ad7d-f235eab297e7_01-18-week2-PASSING_AND_PASSING,9,0,0,5,29,3,46
325555988,geoserver/geoserver,19/08/18 01:32,spirals-bears,6799cc07-95a1-4e50-ad7d-f235eab297e7_01-18-week2-PASSING_AND_PASSING,66,0,0,2,369,6,443
322563887,apache/jackrabbit-oak,19/08/18 01:46,spirals-bears,6799cc07-95a1-4e50-ad7d-f235eab297e7_01-18-week2-PASSING_AND_PASSING,9,0,0,1797,1,2,11,0,1676,1,1,192,0,36,15,295,4036
320116550,aicis/fresco,19/08/18 01:47,spirals-bears,6799cc07-95a1-4e50-ad7d-f235eab297e7_01-18-week2-PASSING_AND_PASSING,8,0,0,0,33,0,41
324478882,apache/jackrabbit-oak,19/08/18 01:49,spirals-bears,6799cc07-95a1-4e50-ad7d-f235eab297e7_01-18-week2-PASSING_AND_PASSING,10,0,0,1748,0,2,12,0,1044,1,1,404,0,40,21,517,3800
326276808,aicis/fresco,19/08/18 01:50,spirals-bears,6799cc07-95a1-4e50-ad7d-f235eab297e7_01-18-week2-PASSING_AND_PASSING,8,0,0,0,40,0,48
320227195,aicis/fresco,19/08/18 01:51,spirals-bears,6799cc07-95a1-4e50-ad7d-f235eab297e7_01-18-week2-PASSING_AND_PASSING,9,0,0,1,39,0,49
328666762,swagger-api/swagger-codegen,19/08/18 01:52,spirals-bears,6799cc07-95a1-4e50-ad7d-f235eab297e7_01-18-week2-PASSING_AND_PASSING,35,0,0,0,2,37
328670217,swagger-api/swagger-codegen,19/08/18 01:57,spirals-bears,6799cc07-95a1-4e50-ad7d-f235eab297e7_01-18-week2-PASSING_AND_PASSING,32,0,50,1,1,220,0,1,305
327282741,aicis/fresco,19/08/18 02:04,spirals-bears,6799cc07-95a1-4e50-ad7d-f235eab297e7_01-18-week2-PASSING_AND_PASSING,9,0,1816,0,5,93,0,3,1926
328667067,swagger-api/swagger-codegen,19/08/18 02:05,spirals-bears,6799cc07-95a1-4e50-ad7d-f235eab297e7_01-18-week2-PASSING_AND_PASSING,7,13,0,0,10,40,0,0,12,0,53,0,1,0,72,0,33,12,12,198,463
328338250,swagger-api/swagger-codegen,19/08/18 02:05,spirals-bears,6799cc07-95a1-4e50-ad7d-f235eab297e7_01-18-week2-PASSING_AND_PASSING,34,0,34
328316491,swagger-api/swagger-codegen,19/08/18 02:06,spirals-bears,6799cc07-95a1-4e50-ad7d-f235eab297e7_01-18-week2-PASSING_AND_PASSING,34,0,34
328110267,swagger-api/swagger-codegen,19/08/18 02:11,spirals-bears,6799cc07-95a1-4e50-ad7d-f235eab297e7_01-18-week2-PASSING_AND_PASSING,34,0,53,0,2,202,0,3,294
327600186,aicis/fresco,19/08/18 02:12,spirals-bears,6799cc07-95a1-4e50-ad7d-f235eab297e7_01-18-week2-PASSING_AND_PASSING,9,4,0,2,7,427,0,0,3,0,1860,0,5,0,45,2,9,4,3,101,2481
327938114,swagger-api/swagger-codegen,19/08/18 02:13,spirals-bears,6799cc07-95a1-4e50-ad7d-f235eab297e7_01-18-week2-PASSING_AND_PASSING,35,5,40
328110988,swagger-api/swagger-codegen,19/08/18 02:13,spirals-bears,6799cc07-95a1-4e50-ad7d-f235eab297e7_01-18-week2-PASSING_AND_PASSING,7,13,0,0,10,37,0,0,14,0,55,0,3,0,70,1,34,12,13,201,470
326316460,swagger-api/swagger-codegen,19/08/18 02:14,spirals-bears,6799cc07-95a1-4e50-ad7d-f235eab297e7_01-18-week2-PASSING_AND_PASSING,35,4,39
327714519,swagger-api/swagger-codegen,19/08/18 02:14,spirals-bears,6799cc07-95a1-4e50-ad7d-f235eab297e7_01-18-week2-PASSING_AND_PASSING,35,4,39
326451620,swagger-api/swagger-codegen,19/08/18 02:15,spirals-bears,6799cc07-95a1-4e50-ad7d-f235eab297e7_01-18-week2-PASSING_AND_PASSING,34,4,38
327722114,swagger-api/swagger-codegen,19/08/18 02:19,spirals-bears,6799cc07-95a1-4e50-ad7d-f235eab297e7_01-18-week2-PASSING_AND_PASSING,7,12,0,0,10,41,0,0,13,0,56,0,1,0,69,0,34,13,14,212,482
327534038,swagger-api/swagger-codegen,19/08/18 02:19,spirals-bears,6799cc07-95a1-4e50-ad7d-f235eab297e7_01-18-week2-PASSING_AND_PASSING,35,0,55,1,2,208,0,2,303
327091981,swagger-api/swagger-codegen,19/08/18 02:20,spirals-bears,6799cc07-95a1-4e50-ad7d-f235eab297e7_01-18-week2-PASSING_AND_PASSING,34,0,58,0,1,208,0,3,304
328158227,rabbitmq/rabbitmq-perf-test,19/08/18 02:20,spirals-bears,6799cc07-95a1-4e50-ad7d-f235eab297e7_01-18-week2-PASSING_AND_PASSING,3,0,15,0,0,23,0,0,41
328143255,rabbitmq/rabbitmq-perf-test,19/08/18 02:21,spirals-bears,6799cc07-95a1-4e50-ad7d-f235eab297e7_01-18-week2-PASSING_AND_PASSING,3,0,15,0,0,24,0,0,42
328061176,rabbitmq/rabbitmq-perf-test,19/08/18 02:21,spirals-bears,6799cc07-95a1-4e50-ad7d-f235eab297e7_01-18-week2-PASSING_AND_PASSING,3,0,15,0,0,23,0,0,41
324189821,rabbitmq/rabbitmq-perf-test,19/08/18 02:21,spirals-bears,6799cc07-95a1-4e50-ad7d-f235eab297e7_01-18-week2-PASSING_AND_PASSING,3,2,5
325697636,swagger-api/swagger-codegen,19/08/18 02:21,spirals-bears,6799cc07-95a1-4e50-ad7d-f235eab297e7_01-18-week2-PASSING_AND_PASSING,35,0,0,2,62,2,101
327738895,spring-cloud/spring-cloud-gcp,19/08/18 02:22,spirals-bears,6799cc07-95a1-4e50-ad7d-f235eab297e7_01-18-week2-PASSING_AND_PASSING,4,2,6
328037099,rabbitmq/rabbitmq-perf-test,19/08/18 02:22,spirals-bears,6799cc07-95a1-4e50-ad7d-f235eab297e7_01-18-week2-PASSING_AND_PASSING,3,0,0,0,22,0,25
327863257,spring-cloud/spring-cloud-gcp,19/08/18 02:22,spirals-bears,6799cc07-95a1-4e50-ad7d-f235eab297e7_01-18-week2-PASSING_AND_PASSING,4,2,6
327878155,spring-cloud/spring-cloud-gcp,19/08/18 02:22,spirals-bears,6799cc07-95a1-4e50-ad7d-f235eab297e7_01-18-week2-PASSING_AND_PASSING,5,2,7
327260910,spring-cloud/spring-cloud-gcp,19/08/18 02:22,spirals-bears,6799cc07-95a1-4e50-ad7d-f235eab297e7_01-18-week2-PASSING_AND_PASSING,4,2,6
327351901,spring-cloud/spring-cloud-gcp,19/08/18 02:22,spirals-bears,6799cc07-95a1-4e50-ad7d-f235eab297e7_01-18-week2-PASSING_AND_PASSING,4,2,6
327373463,spring-cloud/spring-cloud-gcp,19/08/18 02:23,spirals-bears,6799cc07-95a1-4e50-ad7d-f235eab297e7_01-18-week2-PASSING_AND_PASSING,4,2,6
326983479,spring-cloud/spring-cloud-gcp,19/08/18 02:23,spirals-bears,6799cc07-95a1-4e50-ad7d-f235eab297e7_01-18-week2-PASSING_AND_PASSING,4,1,5
319236552,spring-cloud/spring-cloud-gcp,19/08/18 02:23,spirals-bears,6799cc07-95a1-4e50-ad7d-f235eab297e7_01-18-week2-PASSING_AND_PASSING,3,2,5
326309603,rabbitmq/rabbitmq-perf-test,19/08/18 02:23,spirals-bears,6799cc07-95a1-4e50-ad7d-f235eab297e7_01-18-week2-PASSING_AND_PASSING,12,0,0,2,4,15,0,0,0,0,12,0,4,0,12,2,3,0,0,23,89
325642658,spring-cloud/spring-cloud-gcp,19/08/18 02:23,spirals-bears,6799cc07-95a1-4e50-ad7d-f235eab297e7_01-18-week2-PASSING_AND_PASSING,5,2,7
320278252,spring-cloud/spring-cloud-gcp,19/08/18 02:23,spirals-bears,6799cc07-95a1-4e50-ad7d-f235eab297e7_01-18-week2-PASSING_AND_PASSING,4,2,6
324743572,spring-cloud/spring-cloud-gcp,19/08/18 02:24,spirals-bears,6799cc07-95a1-4e50-ad7d-f235eab297e7_01-18-week2-PASSING_AND_PASSING,4,2,6
326993133,spring-cloud/spring-cloud-gcp,19/08/18 02:24,spirals-bears,6799cc07-95a1-4e50-ad7d-f235eab297e7_01-18-week2-PASSING_AND_PASSING,5,2,7
326987800,spring-cloud/spring-cloud-gcp,19/08/18 02:24,spirals-bears,6799cc07-95a1-4e50-ad7d-f235eab297e7_01-18-week2-PASSING_AND_PASSING,4,2,6
326989563,spring-cloud/spring-cloud-gcp,19/08/18 02:24,spirals-bears,6799cc07-95a1-4e50-ad7d-f235eab297e7_01-18-week2-PASSING_AND_PASSING,4,3,7
326981427,spring-cloud/spring-cloud-gcp,19/08/18 02:24,spirals-bears,6799cc07-95a1-4e50-ad7d-f235eab297e7_01-18-week2-PASSING_AND_PASSING,4,2,6
324232230,spring-cloud/spring-cloud-gcp,19/08/18 02:24,spirals-bears,6799cc07-95a1-4e50-ad7d-f235eab297e7_01-18-week2-PASSING_AND_PASSING,5,2,7
326352434,aicis/fresco,19/08/18 02:25,spirals-bears,6799cc07-95a1-4e50-ad7d-f235eab297e7_01-18-week2-PASSING_AND_PASSING,10,6,0,0,8,945,0,0,5,0,1117,0,0,0,38,0,9,6,7,84,2235
327735572,spring-cloud/spring-cloud-gcp,19/08/18 02:26,spirals-bears,6799cc07-95a1-4e50-ad7d-f235eab297e7_01-18-week2-PASSING_AND_PASSING,4,1,4,0,243,0,252
328493877,apache/incubator-servicecomb-saga,19/08/18 02:27,spirals-bears,6799cc07-95a1-4e50-ad7d-f235eab297e7_01-18-week2-PASSING_AND_PASSING,5,0,4,0,98,0,107
328404401,apache/incubator-servicecomb-saga,19/08/18 02:27,spirals-bears,6799cc07-95a1-4e50-ad7d-f235eab297e7_01-18-week2-PASSING_AND_PASSING,5,2,7
328404376,apache/incubator-servicecomb-saga,19/08/18 02:27,spirals-bears,6799cc07-95a1-4e50-ad7d-f235eab297e7_01-18-week2-PASSING_AND_PASSING,5,0,5
327129944,apache/incubator-servicecomb-saga,19/08/18 02:27,spirals-bears,6799cc07-95a1-4e50-ad7d-f235eab297e7_01-18-week2-PASSING_AND_PASSING,5,0,5
327140872,apache/incubator-servicecomb-saga,19/08/18 02:28,spirals-bears,6799cc07-95a1-4e50-ad7d-f235eab297e7_01-18-week2-PASSING_AND_PASSING,5,2,7
327066648,apache/incubator-servicecomb-saga,19/08/18 02:28,spirals-bears,6799cc07-95a1-4e50-ad7d-f235eab297e7_01-18-week2-PASSING_AND_PASSING,5,0,5
327059801,apache/incubator-servicecomb-saga,19/08/18 02:30,spirals-bears,6799cc07-95a1-4e50-ad7d-f235eab297e7_01-18-week2-PASSING_AND_PASSING,4,0,4,0,101,0,109
327059090,apache/incubator-servicecomb-saga,19/08/18 02:30,spirals-bears,6799cc07-95a1-4e50-ad7d-f235eab297e7_01-18-week2-PASSING_AND_PASSING,4,1,5
326633780,apache/incubator-servicecomb-saga,19/08/18 02:32,spirals-bears,6799cc07-95a1-4e50-ad7d-f235eab297e7_01-18-week2-PASSING_AND_PASSING,4,0,4,0,91,0,99
326736354,apache/incubator-servicecomb-saga,19/08/18 02:32,spirals-bears,6799cc07-95a1-4e50-ad7d-f235eab297e7_01-18-week2-PASSING_AND_PASSING,5,2,7
326821442,apache/incubator-servicecomb-saga,19/08/18 02:32,spirals-bears,6799cc07-95a1-4e50-ad7d-f235eab297e7_01-18-week2-PASSING_AND_PASSING,5,2,7
328471087,apache/incubator-servicecomb-saga,19/08/18 02:33,spirals-bears,6799cc07-95a1-4e50-ad7d-f235eab297e7_01-18-week2-PASSING_AND_PASSING,4,0,208,4,0,124,0,0,340
326717100,apache/incubator-servicecomb-saga,19/08/18 02:33,spirals-bears,6799cc07-95a1-4e50-ad7d-f235eab297e7_01-18-week2-PASSING_AND_PASSING,5,3,8
326651849,apache/incubator-servicecomb-saga,19/08/18 02:33,spirals-bears,6799cc07-95a1-4e50-ad7d-f235eab297e7_01-18-week2-PASSING_AND_PASSING,5,3,8
326348020,apache/incubator-servicecomb-saga,19/08/18 02:33,spirals-bears,6799cc07-95a1-4e50-ad7d-f235eab297e7_01-18-week2-PASSING_AND_PASSING,5,3,8
326208965,apache/incubator-servicecomb-saga,19/08/18 02:33,spirals-bears,6799cc07-95a1-4e50-ad7d-f235eab297e7_01-18-week2-PASSING_AND_PASSING,4,0,4
325988513,apache/incubator-servicecomb-saga,19/08/18 02:33,spirals-bears,6799cc07-95a1-4e50-ad7d-f235eab297e7_01-18-week2-PASSING_AND_PASSING,4,3,7
326496710,datastax/java-driver,19/08/18 02:34,spirals-bears,6799cc07-95a1-4e50-ad7d-f235eab297e7_01-18-week2-PASSING_AND_PASSING,16,0,16
326848548,spring-cloud/spring-cloud-gcp,19/08/18 02:35,spirals-bears,6799cc07-95a1-4e50-ad7d-f235eab297e7_01-18-week2-PASSING_AND_PASSING,27,6,0,0,5,28,0,4,1,0,76,0,0,0,96,0,4,1,1,365,614
326959015,datastax/java-driver,19/08/18 02:35,spirals-bears,6799cc07-95a1-4e50-ad7d-f235eab297e7_01-18-week2-PASSING_AND_PASSING,16,2,18
326485160,datastax/java-driver,19/08/18 02:35,spirals-bears,6799cc07-95a1-4e50-ad7d-f235eab297e7_01-18-week2-PASSING_AND_PASSING,17,0,0,0,67,0,84
326947669,datastax/java-driver,19/08/18 02:36,spirals-bears,6799cc07-95a1-4e50-ad7d-f235eab297e7_01-18-week2-PASSING_AND_PASSING,16,0,16
328484758,RipMeApp/ripme,19/08/18 02:36,spirals-bears,6799cc07-95a1-4e50-ad7d-f235eab297e7_01-18-week2-PASSING_AND_PASSING,4,0,644,0,4,25,2,679
326947693,datastax/java-driver,19/08/18 02:36,spirals-bears,6799cc07-95a1-4e50-ad7d-f235eab297e7_01-18-week2-PASSING_AND_PASSING,17,2,19
326946493,datastax/java-driver,19/08/18 02:36,spirals-bears,6799cc07-95a1-4e50-ad7d-f235eab297e7_01-18-week2-PASSING_AND_PASSING,16,0,16
326946455,datastax/java-driver,19/08/18 02:36,spirals-bears,6799cc07-95a1-4e50-ad7d-f235eab297e7_01-18-week2-PASSING_AND_PASSING,17,2,19
326943639,datastax/java-driver,19/08/18 02:36,spirals-bears,6799cc07-95a1-4e50-ad7d-f235eab297e7_01-18-week2-PASSING_AND_PASSING,17,2,19
325137099,datastax/java-driver,19/08/18 02:36,spirals-bears,6799cc07-95a1-4e50-ad7d-f235eab297e7_01-18-week2-PASSING_AND_PASSING,17,2,19
281310958,datastax/java-driver,19/08/18 02:37,spirals-bears,6799cc07-95a1-4e50-ad7d-f235eab297e7_01-18-week2-PASSING_AND_PASSING,17,0,0,4,3,24
281310943,datastax/java-driver,19/08/18 02:37,spirals-bears,6799cc07-95a1-4e50-ad7d-f235eab297e7_01-18-week2-PASSING_AND_PASSING,16,0,0,0,0,16
327944536,datastax/java-driver,19/08/18 02:37,spirals-bears,6799cc07-95a1-4e50-ad7d-f235eab297e7_01-18-week2-PASSING_AND_PASSING,17,0,68,0,1,103,0,0,189
324345031,datastax/java-driver,19/08/18 02:37,spirals-bears,6799cc07-95a1-4e50-ad7d-f235eab297e7_01-18-week2-PASSING_AND_PASSING,18,2,20
326470914,datastax/java-driver,19/08/18 02:37,spirals-bears,6799cc07-95a1-4e50-ad7d-f235eab297e7_01-18-week2-PASSING_AND_PASSING,17,0,17
327300511,dhis2/dhis2-core,19/08/18 02:38,spirals-bears,6799cc07-95a1-4e50-ad7d-f235eab297e7_01-18-week2-PASSING_AND_PASSING,23,0,0,1,68,3,95
326793685,dhis2/dhis2-core,19/08/18 02:39,spirals-bears,6799cc07-95a1-4e50-ad7d-f235eab297e7_01-18-week2-PASSING_AND_PASSING,25,0,1,0,93,2,121
326719693,dhis2/dhis2-core,19/08/18 02:39,spirals-bears,6799cc07-95a1-4e50-ad7d-f235eab297e7_01-18-week2-PASSING_AND_PASSING,23,3,26
316613936,dhis2/dhis2-core,19/08/18 02:46,spirals-bears,6799cc07-95a1-4e50-ad7d-f235eab297e7_01-18-week2-PASSING_AND_PASSING,22,0,333,0,1,168,0,3,527
324755320,debezium/debezium,19/08/18 02:46,spirals-bears,6799cc07-95a1-4e50-ad7d-f235eab297e7_01-18-week2-PASSING_AND_PASSING,6,0,0,4,4,14
303423969,debezium/debezium,19/08/18 02:47,spirals-bears,6799cc07-95a1-4e50-ad7d-f235eab297e7_01-18-week2-PASSING_AND_PASSING,6,0,6
324822973,debezium/debezium,19/08/18 02:47,spirals-bears,6799cc07-95a1-4e50-ad7d-f235eab297e7_01-18-week2-PASSING_AND_PASSING,6,3,9
326057248,dhis2/dhis2-core,19/08/18 02:47,spirals-bears,6799cc07-95a1-4e50-ad7d-f235eab297e7_01-18-week2-PASSING_AND_PASSING,13,0,2,29,0,0,8,0,209,6,0,28,3,23,7,181,509
327628031,debezium/debezium,19/08/18 02:48,spirals-bears,6799cc07-95a1-4e50-ad7d-f235eab297e7_01-18-week2-PASSING_AND_PASSING,6,0,0,3,5,14
326931993,dhis2/dhis2-core,19/08/18 02:48,spirals-bears,6799cc07-95a1-4e50-ad7d-f235eab297e7_01-18-week2-PASSING_AND_PASSING,13,0,0,209,0,0,9,0,203,0,0,13,0,25,6,171,649
320454743,debezium/debezium,19/08/18 02:49,spirals-bears,6799cc07-95a1-4e50-ad7d-f235eab297e7_01-18-week2-PASSING_AND_PASSING,6,3,9
328077065,debezium/debezium,19/08/18 02:50,spirals-bears,6799cc07-95a1-4e50-ad7d-f235eab297e7_01-18-week2-PASSING_AND_PASSING,6,0,47,0,0,130,0,0,183
327281209,debezium/debezium,19/08/18 02:51,spirals-bears,6799cc07-95a1-4e50-ad7d-f235eab297e7_01-18-week2-PASSING_AND_PASSING,6,0,46,0,0,95,0,0,147
326702580,dhis2/dhis2-core,19/08/18 02:51,spirals-bears,6799cc07-95a1-4e50-ad7d-f235eab297e7_01-18-week2-PASSING_AND_PASSING,12,0,0,207,0,1,8,0,204,0,0,16,0,23,7,177,655
327754087,MyCoRe-Org/mycore,19/08/18 02:51,spirals-bears,6799cc07-95a1-4e50-ad7d-f235eab297e7_01-18-week2-PASSING_AND_PASSING,45,0,45
328093314,fabric8io/fabric8-maven-plugin,19/08/18 02:51,spirals-bears,6799cc07-95a1-4e50-ad7d-f235eab297e7_01-18-week2-PASSING_AND_PASSING,32,5,37
328085720,fabric8io/fabric8-maven-plugin,19/08/18 02:51,spirals-bears,6799cc07-95a1-4e50-ad7d-f235eab297e7_01-18-week2-PASSING_AND_PASSING,30,5,35
326770843,fabric8io/fabric8-maven-plugin,19/08/18 02:52,spirals-bears,6799cc07-95a1-4e50-ad7d-f235eab297e7_01-18-week2-PASSING_AND_PASSING,29,5,34
326319643,Activiti/Activiti,19/08/18 02:52,spirals-bears,6799cc07-95a1-4e50-ad7d-f235eab297e7_01-18-week2-PASSING_AND_PASSING,35,0,35
325431120,debezium/debezium,19/08/18 02:52,spirals-bears,6799cc07-95a1-4e50-ad7d-f235eab297e7_01-18-week2-PASSING_AND_PASSING,9,3,0,0,5,38,0,0,1,0,39,0,0,0,18,0,6,2,1,94,216
326497401,Activiti/Activiti,19/08/18 02:52,spirals-bears,6799cc07-95a1-4e50-ad7d-f235eab297e7_01-18-week2-PASSING_AND_PASSING,38,3,41
322631778,Activiti/Activiti,19/08/18 02:53,spirals-bears,6799cc07-95a1-4e50-ad7d-f235eab297e7_01-18-week2-PASSING_AND_PASSING,33,2,35
327362311,jordilucas/ponto-inteligente-api,19/08/18 02:53,spirals-bears,6799cc07-95a1-4e50-ad7d-f235eab297e7_01-18-week2-PASSING_AND_PASSING,3,0,27,1,0,24,0,0,55
325391291,zalando/zalenium,19/08/18 02:54,spirals-bears,6799cc07-95a1-4e50-ad7d-f235eab297e7_01-18-week2-PASSING_AND_PASSING,5,0,0,0,25,0,30
326299292,Spirals-Team/repairnator,19/08/18 02:54,spirals-bears,6799cc07-95a1-4e50-ad7d-f235eab297e7_01-18-week2-PASSING_AND_PASSING,15,0,0,1,16
326299878,Spirals-Team/repairnator,19/08/18 02:54,spirals-bears,6799cc07-95a1-4e50-ad7d-f235eab297e7_01-18-week2-PASSING_AND_PASSING,18,2,20
307971552,Spirals-Team/repairnator,19/08/18 02:54,spirals-bears,6799cc07-95a1-4e50-ad7d-f235eab297e7_01-18-week2-PASSING_AND_PASSING,19,0,0,0,19
327392431,jnidzwetzki/bboxdb,19/08/18 02:55,spirals-bears,6799cc07-95a1-4e50-ad7d-f235eab297e7_01-18-week2-PASSING_AND_PASSING,10,0,0,0,32,0,42
327727200,jdbi/jdbi,19/08/18 02:55,spirals-bears,6799cc07-95a1-4e50-ad7d-f235eab297e7_01-18-week2-PASSING_AND_PASSING,9,0,1,0,154,0,164
326337838,jnidzwetzki/bboxdb,19/08/18 02:56,spirals-bears,6799cc07-95a1-4e50-ad7d-f235eab297e7_01-18-week2-PASSING_AND_PASSING,8,0,0,0,31,0,39
325611855,jnidzwetzki/bboxdb,19/08/18 02:56,spirals-bears,6799cc07-95a1-4e50-ad7d-f235eab297e7_01-18-week2-PASSING_AND_PASSING,8,0,0,0,24,0,32
325386071,fabric8io/fabric8-maven-plugin,19/08/18 02:59,spirals-bears,6799cc07-95a1-4e50-ad7d-f235eab297e7_01-18-week2-PASSING_AND_PASSING,30,0,118,2,0,307,0,0,457
327174330,jnidzwetzki/bboxdb,19/08/18 03:02,spirals-bears,6799cc07-95a1-4e50-ad7d-f235eab297e7_01-18-week2-PASSING_AND_PASSING,5,0,0,39,0,0,1,0,38,0,0,70,0,9,1,261,424
