327769310,apache/flink,17/08/18 22:14,spirals-bears,c4edf6f8-133a-4cec-9a5e-4ad4ea8b0f50_01-18-week2-FAILING_AND_PASSING,58,7,65
328106573,apache/flink,17/08/18 22:14,spirals-bears,c4edf6f8-133a-4cec-9a5e-4ad4ea8b0f50_01-18-week2-FAILING_AND_PASSING,61,7,68
327913978,apache/flink,17/08/18 22:14,spirals-bears,c4edf6f8-133a-4cec-9a5e-4ad4ea8b0f50_01-18-week2-FAILING_AND_PASSING,66,7,73
328739781,apache/flink,17/08/18 22:14,spirals-bears,c4edf6f8-133a-4cec-9a5e-4ad4ea8b0f50_01-18-week2-FAILING_AND_PASSING,72,7,79
311729670,apache/flink,17/08/18 22:16,spirals-bears,c4edf6f8-133a-4cec-9a5e-4ad4ea8b0f50_01-18-week2-FAILING_AND_PASSING,64,6,70
327913601,apache/flink,17/08/18 22:16,spirals-bears,c4edf6f8-133a-4cec-9a5e-4ad4ea8b0f50_01-18-week2-FAILING_AND_PASSING,68,7,75
327659353,apache/flink,17/08/18 22:16,spirals-bears,c4edf6f8-133a-4cec-9a5e-4ad4ea8b0f50_01-18-week2-FAILING_AND_PASSING,62,6,68
327274223,apache/flink,17/08/18 22:17,spirals-bears,c4edf6f8-133a-4cec-9a5e-4ad4ea8b0f50_01-18-week2-FAILING_AND_PASSING,62,7,69
327249387,apache/flink,17/08/18 22:17,spirals-bears,c4edf6f8-133a-4cec-9a5e-4ad4ea8b0f50_01-18-week2-FAILING_AND_PASSING,62,5,67
326913472,apache/flink,17/08/18 22:18,spirals-bears,c4edf6f8-133a-4cec-9a5e-4ad4ea8b0f50_01-18-week2-FAILING_AND_PASSING,62,6,68
326304584,apache/flink,17/08/18 22:20,spirals-bears,c4edf6f8-133a-4cec-9a5e-4ad4ea8b0f50_01-18-week2-FAILING_AND_PASSING,61,9,70
327620440,apache/flink,17/08/18 22:55,spirals-bears,c4edf6f8-133a-4cec-9a5e-4ad4ea8b0f50_01-18-week2-FAILING_AND_PASSING,10,0,2,1,2,86,0,56,670,1,51,1483,64,1,2427
326401229,apache/flink,17/08/18 22:57,spirals-bears,c4edf6f8-133a-4cec-9a5e-4ad4ea8b0f50_01-18-week2-FAILING_AND_PASSING,61,12,73
326396853,apache/flink,17/08/18 22:58,spirals-bears,c4edf6f8-133a-4cec-9a5e-4ad4ea8b0f50_01-18-week2-FAILING_AND_PASSING,60,8,68
327281847,apache/flink,17/08/18 22:59,spirals-bears,c4edf6f8-133a-4cec-9a5e-4ad4ea8b0f50_01-18-week2-FAILING_AND_PASSING,16,0,2,0,1,70,1,44,779,3,61,1497,73,1,2548
326832400,apache/flink,17/08/18 22:59,spirals-bears,c4edf6f8-133a-4cec-9a5e-4ad4ea8b0f50_01-18-week2-FAILING_AND_PASSING,9,0,2,0,2,90,0,39,708,4,62,1515,69,1,2501
326466354,apache/flink,17/08/18 22:59,spirals-bears,c4edf6f8-133a-4cec-9a5e-4ad4ea8b0f50_01-18-week2-FAILING_AND_PASSING,64,7,71
326208845,apache/flink,17/08/18 23:00,spirals-bears,c4edf6f8-133a-4cec-9a5e-4ad4ea8b0f50_01-18-week2-FAILING_AND_PASSING,66,4,70
326376095,apache/flink,17/08/18 23:01,spirals-bears,c4edf6f8-133a-4cec-9a5e-4ad4ea8b0f50_01-18-week2-FAILING_AND_PASSING,63,9,72
326356244,apache/flink,17/08/18 23:01,spirals-bears,c4edf6f8-133a-4cec-9a5e-4ad4ea8b0f50_01-18-week2-FAILING_AND_PASSING,60,5,65
327629423,prestodb/presto,17/08/18 23:02,spirals-bears,c4edf6f8-133a-4cec-9a5e-4ad4ea8b0f50_01-18-week2-FAILING_AND_PASSING,45,10,55
326307663,apache/flink,17/08/18 23:07,spirals-bears,c4edf6f8-133a-4cec-9a5e-4ad4ea8b0f50_01-18-week2-FAILING_AND_PASSING,13,0,13,0,1,94,0,46,964,14,54,1508,77,2,2786
327390250,prestodb/presto,17/08/18 23:08,spirals-bears,c4edf6f8-133a-4cec-9a5e-4ad4ea8b0f50_01-18-week2-FAILING_AND_PASSING,44,5,49
291487192,prestodb/presto,17/08/18 23:09,spirals-bears,c4edf6f8-133a-4cec-9a5e-4ad4ea8b0f50_01-18-week2-FAILING_AND_PASSING,41,7,48
327907552,prestodb/presto,17/08/18 23:10,spirals-bears,c4edf6f8-133a-4cec-9a5e-4ad4ea8b0f50_01-18-week2-FAILING_AND_PASSING,41,9,50
326979223,prestodb/presto,17/08/18 23:11,spirals-bears,c4edf6f8-133a-4cec-9a5e-4ad4ea8b0f50_01-18-week2-FAILING_AND_PASSING,41,10,51
326746489,prestodb/presto,17/08/18 23:12,spirals-bears,c4edf6f8-133a-4cec-9a5e-4ad4ea8b0f50_01-18-week2-FAILING_AND_PASSING,42,11,53
326728278,prestodb/presto,17/08/18 23:13,spirals-bears,c4edf6f8-133a-4cec-9a5e-4ad4ea8b0f50_01-18-week2-FAILING_AND_PASSING,41,9,50
326248068,prestodb/presto,17/08/18 23:14,spirals-bears,c4edf6f8-133a-4cec-9a5e-4ad4ea8b0f50_01-18-week2-FAILING_AND_PASSING,45,7,52
328405416,prestodb/presto,17/08/18 23:30,spirals-bears,c4edf6f8-133a-4cec-9a5e-4ad4ea8b0f50_01-18-week2-FAILING_AND_PASSING,815,873,43,0,2,2,1735
328327473,prestodb/presto,17/08/18 23:30,spirals-bears,c4edf6f8-133a-4cec-9a5e-4ad4ea8b0f50_01-18-week2-FAILING_AND_PASSING,792,876,43,0,2,2,1715
326352304,apache/flink,17/08/18 23:40,spirals-bears,c4edf6f8-133a-4cec-9a5e-4ad4ea8b0f50_01-18-week2-FAILING_AND_PASSING,8,0,2,0,1,78,0,41,729,4,49,1453,71,2,2438
327516130,apache/incubator-druid,17/08/18 23:59,spirals-bears,c4edf6f8-133a-4cec-9a5e-4ad4ea8b0f50_01-18-week2-FAILING_AND_PASSING,1042,446,46,0,14,1,1549
328118954,apache/incubator-druid,17/08/18 23:59,spirals-bears,c4edf6f8-133a-4cec-9a5e-4ad4ea8b0f50_01-18-week2-FAILING_AND_PASSING,8,0,6,22,1,33,0,157,640,1,1288,505,43,2,2706
325498791,apache/incubator-druid,18/08/18 00:04,spirals-bears,c4edf6f8-133a-4cec-9a5e-4ad4ea8b0f50_01-18-week2-FAILING_AND_PASSING,270,489,10,35,0,7,1,349,0,219,2,8,1390
326907790,apache/incubator-druid,18/08/18 00:39,spirals-bears,c4edf6f8-133a-4cec-9a5e-4ad4ea8b0f50_01-18-week2-FAILING_AND_PASSING,7,0,7,1,1,9,0,1498,300,3,35,443,44,0,2348
325681487,apache/incubator-druid,18/08/18 00:42,spirals-bears,c4edf6f8-133a-4cec-9a5e-4ad4ea8b0f50_01-18-week2-FAILING_AND_PASSING,13,0,2,0,1,30,0,29,302,0,1389,451,35,2,2254
326696435,jruby/jruby,18/08/18 00:44,spirals-bears,c4edf6f8-133a-4cec-9a5e-4ad4ea8b0f50_01-18-week2-FAILING_AND_PASSING,14,143,98,0,3,0,0,258
327309261,apache/incubator-druid,18/08/18 00:46,spirals-bears,c4edf6f8-133a-4cec-9a5e-4ad4ea8b0f50_01-18-week2-FAILING_AND_PASSING,13,0,2,0,1,56,0,1419,557,1,1787,466,37,2,4341
328726200,JMRI/JMRI,18/08/18 00:46,spirals-bears,c4edf6f8-133a-4cec-9a5e-4ad4ea8b0f50_01-18-week2-FAILING_AND_PASSING,251,7,258
327093462,apache/incubator-druid,18/08/18 01:03,spirals-bears,c4edf6f8-133a-4cec-9a5e-4ad4ea8b0f50_01-18-week2-FAILING_AND_PASSING,8,0,2,0,1,68,0,1367,306,1,1521,457,36,9,3776
328338407,JMRI/JMRI,18/08/18 01:19,spirals-bears,c4edf6f8-133a-4cec-9a5e-4ad4ea8b0f50_01-18-week2-FAILING_AND_PASSING,1432,174,304,1,8,0,12,1931
328578279,JMRI/JMRI,18/08/18 01:19,spirals-bears,c4edf6f8-133a-4cec-9a5e-4ad4ea8b0f50_01-18-week2-FAILING_AND_PASSING,1489,187,348,0,79,0,9,2112
328334755,JMRI/JMRI,18/08/18 01:24,spirals-bears,c4edf6f8-133a-4cec-9a5e-4ad4ea8b0f50_01-18-week2-FAILING_AND_PASSING,1468,171,13,340,0,34,0,151,0,88,8,8,2281
327143608,JMRI/JMRI,18/08/18 01:35,spirals-bears,c4edf6f8-133a-4cec-9a5e-4ad4ea8b0f50_01-18-week2-FAILING_AND_PASSING,1443,169,283,0,6,1,9,1911
326965916,JMRI/JMRI,18/08/18 01:54,spirals-bears,c4edf6f8-133a-4cec-9a5e-4ad4ea8b0f50_01-18-week2-FAILING_AND_PASSING,1419,175,437,0,7,1,9,2048
326431404,JMRI/JMRI,18/08/18 01:55,spirals-bears,c4edf6f8-133a-4cec-9a5e-4ad4ea8b0f50_01-18-week2-FAILING_AND_PASSING,1382,175,10,295,0,36,1,142,0,84,6,7,2138
327024507,JMRI/JMRI,18/08/18 01:59,spirals-bears,c4edf6f8-133a-4cec-9a5e-4ad4ea8b0f50_01-18-week2-FAILING_AND_PASSING,1359,173,9,309,0,37,0,99,0,70,4,5,2065
326591764,JMRI/JMRI,18/08/18 02:09,spirals-bears,c4edf6f8-133a-4cec-9a5e-4ad4ea8b0f50_01-18-week2-FAILING_AND_PASSING,1380,170,429,0,40,0,7,2026
326221833,JMRI/JMRI,18/08/18 02:15,spirals-bears,c4edf6f8-133a-4cec-9a5e-4ad4ea8b0f50_01-18-week2-FAILING_AND_PASSING,305,25,330
326893989,JMRI/JMRI,18/08/18 02:29,spirals-bears,c4edf6f8-133a-4cec-9a5e-4ad4ea8b0f50_01-18-week2-FAILING_AND_PASSING,1399,170,10,254,0,29,0,114,0,88,8,7,2079
327232548,apache/nifi,18/08/18 02:30,spirals-bears,c4edf6f8-133a-4cec-9a5e-4ad4ea8b0f50_01-18-week2-FAILING_AND_PASSING,40,6,46
325070287,apache/nifi,18/08/18 02:31,spirals-bears,c4edf6f8-133a-4cec-9a5e-4ad4ea8b0f50_01-18-week2-FAILING_AND_PASSING,36,8,44
326593605,apache/nifi,18/08/18 02:32,spirals-bears,c4edf6f8-133a-4cec-9a5e-4ad4ea8b0f50_01-18-week2-FAILING_AND_PASSING,39,8,47
326618710,JMRI/JMRI,18/08/18 02:35,spirals-bears,c4edf6f8-133a-4cec-9a5e-4ad4ea8b0f50_01-18-week2-FAILING_AND_PASSING,1416,174,11,478,0,35,0,208,0,72,8,5,2407
326432356,JMRI/JMRI,18/08/18 02:35,spirals-bears,c4edf6f8-133a-4cec-9a5e-4ad4ea8b0f50_01-18-week2-FAILING_AND_PASSING,1411,170,11,286,0,9,0,183,0,74,21,1,2166
328322282,INRIA/spoon,18/08/18 02:48,spirals-bears,c4edf6f8-133a-4cec-9a5e-4ad4ea8b0f50_01-18-week2-FAILING_AND_PASSING,7,0,8,0,1,4,0,392,31,2,406,63,12,0,926
327571483,EnMasseProject/enmasse,18/08/18 02:48,spirals-bears,c4edf6f8-133a-4cec-9a5e-4ad4ea8b0f50_01-18-week2-FAILING_AND_PASSING,27,3,30
326197132,JMRI/JMRI,18/08/18 02:49,spirals-bears,c4edf6f8-133a-4cec-9a5e-4ad4ea8b0f50_01-18-week2-FAILING_AND_PASSING,1382,168,11,252,0,38,0,64,0,85,2,7,2009
327524262,EnMasseProject/enmasse,18/08/18 02:49,spirals-bears,c4edf6f8-133a-4cec-9a5e-4ad4ea8b0f50_01-18-week2-FAILING_AND_PASSING,27,3,30
326467564,EnMasseProject/enmasse,18/08/18 02:49,spirals-bears,c4edf6f8-133a-4cec-9a5e-4ad4ea8b0f50_01-18-week2-FAILING_AND_PASSING,27,3,30
326271720,EnMasseProject/enmasse,18/08/18 02:50,spirals-bears,c4edf6f8-133a-4cec-9a5e-4ad4ea8b0f50_01-18-week2-FAILING_AND_PASSING,30,5,35
326069604,EnMasseProject/enmasse,18/08/18 02:50,spirals-bears,c4edf6f8-133a-4cec-9a5e-4ad4ea8b0f50_01-18-week2-FAILING_AND_PASSING,27,0,27
327599514,INRIA/spoon,18/08/18 02:51,spirals-bears,c4edf6f8-133a-4cec-9a5e-4ad4ea8b0f50_01-18-week2-FAILING_AND_PASSING,6,0,5,0,0,4,0,408,32,3,387,57,11,0,913
327912741,batfish/batfish,18/08/18 02:51,spirals-bears,c4edf6f8-133a-4cec-9a5e-4ad4ea8b0f50_01-18-week2-FAILING_AND_PASSING,46,4,50
328262530,batfish/batfish,18/08/18 02:51,spirals-bears,c4edf6f8-133a-4cec-9a5e-4ad4ea8b0f50_01-18-week2-FAILING_AND_PASSING,75,0,75
327251978,INRIA/spoon,18/08/18 02:51,spirals-bears,c4edf6f8-133a-4cec-9a5e-4ad4ea8b0f50_01-18-week2-FAILING_AND_PASSING,9,0,7,0,0,4,0,414,35,3,398,58,11,0,939
327912692,batfish/batfish,18/08/18 02:52,spirals-bears,c4edf6f8-133a-4cec-9a5e-4ad4ea8b0f50_01-18-week2-FAILING_AND_PASSING,48,0,48
326969843,batfish/batfish,18/08/18 02:52,spirals-bears,c4edf6f8-133a-4cec-9a5e-4ad4ea8b0f50_01-18-week2-FAILING_AND_PASSING,48,3,51
326969837,batfish/batfish,18/08/18 02:53,spirals-bears,c4edf6f8-133a-4cec-9a5e-4ad4ea8b0f50_01-18-week2-FAILING_AND_PASSING,71,0,71
326628409,batfish/batfish,18/08/18 02:53,spirals-bears,c4edf6f8-133a-4cec-9a5e-4ad4ea8b0f50_01-18-week2-FAILING_AND_PASSING,54,0,54
326624273,batfish/batfish,18/08/18 02:53,spirals-bears,c4edf6f8-133a-4cec-9a5e-4ad4ea8b0f50_01-18-week2-FAILING_AND_PASSING,55,0,55
326598959,batfish/batfish,18/08/18 02:54,spirals-bears,c4edf6f8-133a-4cec-9a5e-4ad4ea8b0f50_01-18-week2-FAILING_AND_PASSING,48,0,48
326599409,batfish/batfish,18/08/18 02:54,spirals-bears,c4edf6f8-133a-4cec-9a5e-4ad4ea8b0f50_01-18-week2-FAILING_AND_PASSING,55,4,59
326566739,batfish/batfish,18/08/18 02:54,spirals-bears,c4edf6f8-133a-4cec-9a5e-4ad4ea8b0f50_01-18-week2-FAILING_AND_PASSING,53,0,53
326566748,batfish/batfish,18/08/18 02:55,spirals-bears,c4edf6f8-133a-4cec-9a5e-4ad4ea8b0f50_01-18-week2-FAILING_AND_PASSING,52,4,56
327816340,batfish/batfish,18/08/18 02:55,spirals-bears,c4edf6f8-133a-4cec-9a5e-4ad4ea8b0f50_01-18-week2-FAILING_AND_PASSING,8,159,50,0,1,0,0,218
326511898,batfish/batfish,18/08/18 02:55,spirals-bears,c4edf6f8-133a-4cec-9a5e-4ad4ea8b0f50_01-18-week2-FAILING_AND_PASSING,54,3,57
327121087,apache/incubator-servicecomb-java-chassis,18/08/18 02:55,spirals-bears,c4edf6f8-133a-4cec-9a5e-4ad4ea8b0f50_01-18-week2-FAILING_AND_PASSING,8,0,8
326508127,batfish/batfish,18/08/18 02:55,spirals-bears,c4edf6f8-133a-4cec-9a5e-4ad4ea8b0f50_01-18-week2-FAILING_AND_PASSING,54,0,54
327097378,apache/incubator-servicecomb-java-chassis,18/08/18 02:56,spirals-bears,c4edf6f8-133a-4cec-9a5e-4ad4ea8b0f50_01-18-week2-FAILING_AND_PASSING,11,3,14
327078980,apache/incubator-servicecomb-java-chassis,18/08/18 02:56,spirals-bears,c4edf6f8-133a-4cec-9a5e-4ad4ea8b0f50_01-18-week2-FAILING_AND_PASSING,9,5,14
326797815,apache/incubator-servicecomb-java-chassis,18/08/18 02:56,spirals-bears,c4edf6f8-133a-4cec-9a5e-4ad4ea8b0f50_01-18-week2-FAILING_AND_PASSING,9,3,12
326797575,apache/incubator-servicecomb-java-chassis,18/08/18 02:56,spirals-bears,c4edf6f8-133a-4cec-9a5e-4ad4ea8b0f50_01-18-week2-FAILING_AND_PASSING,10,1,11
326256349,apache/incubator-servicecomb-java-chassis,18/08/18 02:57,spirals-bears,c4edf6f8-133a-4cec-9a5e-4ad4ea8b0f50_01-18-week2-FAILING_AND_PASSING,9,4,13
328625956,runelite/runelite,18/08/18 02:57,spirals-bears,c4edf6f8-133a-4cec-9a5e-4ad4ea8b0f50_01-18-week2-FAILING_AND_PASSING,14,0,14
328597920,runelite/runelite,18/08/18 02:57,spirals-bears,c4edf6f8-133a-4cec-9a5e-4ad4ea8b0f50_01-18-week2-FAILING_AND_PASSING,9,1,10
328622852,runelite/runelite,18/08/18 02:57,spirals-bears,c4edf6f8-133a-4cec-9a5e-4ad4ea8b0f50_01-18-week2-FAILING_AND_PASSING,9,13,22
328545717,runelite/runelite,18/08/18 02:58,spirals-bears,c4edf6f8-133a-4cec-9a5e-4ad4ea8b0f50_01-18-week2-FAILING_AND_PASSING,10,0,10
328605297,runelite/runelite,18/08/18 02:58,spirals-bears,c4edf6f8-133a-4cec-9a5e-4ad4ea8b0f50_01-18-week2-FAILING_AND_PASSING,9,14,23
327945042,runelite/runelite,18/08/18 02:58,spirals-bears,c4edf6f8-133a-4cec-9a5e-4ad4ea8b0f50_01-18-week2-FAILING_AND_PASSING,11,0,11
327778183,runelite/runelite,18/08/18 02:58,spirals-bears,c4edf6f8-133a-4cec-9a5e-4ad4ea8b0f50_01-18-week2-FAILING_AND_PASSING,13,0,13
327985814,runelite/runelite,18/08/18 02:58,spirals-bears,c4edf6f8-133a-4cec-9a5e-4ad4ea8b0f50_01-18-week2-FAILING_AND_PASSING,15,26,41
327627518,runelite/runelite,18/08/18 02:59,spirals-bears,c4edf6f8-133a-4cec-9a5e-4ad4ea8b0f50_01-18-week2-FAILING_AND_PASSING,11,0,11
327601983,runelite/runelite,18/08/18 02:59,spirals-bears,c4edf6f8-133a-4cec-9a5e-4ad4ea8b0f50_01-18-week2-FAILING_AND_PASSING,10,0,10
326851282,runelite/runelite,18/08/18 02:59,spirals-bears,c4edf6f8-133a-4cec-9a5e-4ad4ea8b0f50_01-18-week2-FAILING_AND_PASSING,11,0,11
326513660,runelite/runelite,18/08/18 03:00,spirals-bears,c4edf6f8-133a-4cec-9a5e-4ad4ea8b0f50_01-18-week2-FAILING_AND_PASSING,10,22,32
326302011,runelite/runelite,18/08/18 03:00,spirals-bears,c4edf6f8-133a-4cec-9a5e-4ad4ea8b0f50_01-18-week2-FAILING_AND_PASSING,10,0,10
326389739,runelite/runelite,18/08/18 03:01,spirals-bears,c4edf6f8-133a-4cec-9a5e-4ad4ea8b0f50_01-18-week2-FAILING_AND_PASSING,11,6,17
326386280,runelite/runelite,18/08/18 03:01,spirals-bears,c4edf6f8-133a-4cec-9a5e-4ad4ea8b0f50_01-18-week2-FAILING_AND_PASSING,12,0,12
326300822,runelite/runelite,18/08/18 03:01,spirals-bears,c4edf6f8-133a-4cec-9a5e-4ad4ea8b0f50_01-18-week2-FAILING_AND_PASSING,12,0,12
326165996,runelite/runelite,18/08/18 03:02,spirals-bears,c4edf6f8-133a-4cec-9a5e-4ad4ea8b0f50_01-18-week2-FAILING_AND_PASSING,10,0,10
327284848,runelite/runelite,18/08/18 03:03,spirals-bears,c4edf6f8-133a-4cec-9a5e-4ad4ea8b0f50_01-18-week2-FAILING_AND_PASSING,247,10,0,13,0,270
327932370,CorfuDB/CorfuDB,18/08/18 03:08,spirals-bears,c4edf6f8-133a-4cec-9a5e-4ad4ea8b0f50_01-18-week2-FAILING_AND_PASSING,256,0,256
327932386,CorfuDB/CorfuDB,18/08/18 03:08,spirals-bears,c4edf6f8-133a-4cec-9a5e-4ad4ea8b0f50_01-18-week2-FAILING_AND_PASSING,374,4,378
325557750,matsim-org/matsim,18/08/18 03:23,spirals-bears,c4edf6f8-133a-4cec-9a5e-4ad4ea8b0f50_01-18-week2-FAILING_AND_PASSING,1527,164,0,6,0,1697
327927652,CorfuDB/CorfuDB,18/08/18 03:26,spirals-bears,c4edf6f8-133a-4cec-9a5e-4ad4ea8b0f50_01-18-week2-FAILING_AND_PASSING,595,198,295,0,4,0,0,1092
328178215,matsim-org/matsim,18/08/18 03:27,spirals-bears,c4edf6f8-133a-4cec-9a5e-4ad4ea8b0f50_01-18-week2-FAILING_AND_PASSING,1751,167,0,2,1,1921
327025294,CorfuDB/CorfuDB,18/08/18 03:28,spirals-bears,c4edf6f8-133a-4cec-9a5e-4ad4ea8b0f50_01-18-week2-FAILING_AND_PASSING,263,0,263
327001510,CorfuDB/CorfuDB,18/08/18 03:31,spirals-bears,c4edf6f8-133a-4cec-9a5e-4ad4ea8b0f50_01-18-week2-FAILING_AND_PASSING,244,3,247
326990928,CorfuDB/CorfuDB,18/08/18 03:31,spirals-bears,c4edf6f8-133a-4cec-9a5e-4ad4ea8b0f50_01-18-week2-FAILING_AND_PASSING,260,0,260
326748061,CorfuDB/CorfuDB,18/08/18 03:33,spirals-bears,c4edf6f8-133a-4cec-9a5e-4ad4ea8b0f50_01-18-week2-FAILING_AND_PASSING,277,0,277
326748063,CorfuDB/CorfuDB,18/08/18 03:35,spirals-bears,c4edf6f8-133a-4cec-9a5e-4ad4ea8b0f50_01-18-week2-FAILING_AND_PASSING,278,3,281
327375660,apache/storm,18/08/18 03:36,spirals-bears,c4edf6f8-133a-4cec-9a5e-4ad4ea8b0f50_01-18-week2-FAILING_AND_PASSING,45,4,49
325572890,apache/storm,18/08/18 03:37,spirals-bears,c4edf6f8-133a-4cec-9a5e-4ad4ea8b0f50_01-18-week2-FAILING_AND_PASSING,37,4,41
327904324,CorfuDB/CorfuDB,18/08/18 03:41,spirals-bears,c4edf6f8-133a-4cec-9a5e-4ad4ea8b0f50_01-18-week2-FAILING_AND_PASSING,9,4,0,0,5,0,0,3,0,692,0,79,0,635,200,304,4,0,1935
328330158,linkedin/pinot,18/08/18 03:41,spirals-bears,c4edf6f8-133a-4cec-9a5e-4ad4ea8b0f50_01-18-week2-FAILING_AND_PASSING,33,3,36
327803073,linkedin/pinot,18/08/18 03:42,spirals-bears,c4edf6f8-133a-4cec-9a5e-4ad4ea8b0f50_01-18-week2-FAILING_AND_PASSING,33,4,37
327112754,linkedin/pinot,18/08/18 03:43,spirals-bears,c4edf6f8-133a-4cec-9a5e-4ad4ea8b0f50_01-18-week2-FAILING_AND_PASSING,36,4,40
327565847,apache/calcite,18/08/18 03:45,spirals-bears,c4edf6f8-133a-4cec-9a5e-4ad4ea8b0f50_01-18-week2-FAILING_AND_PASSING,659,117,20,0,1,0,0,797
326617487,linkedin/pinot,18/08/18 03:46,spirals-bears,c4edf6f8-133a-4cec-9a5e-4ad4ea8b0f50_01-18-week2-FAILING_AND_PASSING,33,3,36
325259645,apache/calcite,18/08/18 03:48,spirals-bears,c4edf6f8-133a-4cec-9a5e-4ad4ea8b0f50_01-18-week2-FAILING_AND_PASSING,788,120,21,0,0,1,0,930
327463124,Azure/azure-libraries-for-java,18/08/18 03:50,spirals-bears,c4edf6f8-133a-4cec-9a5e-4ad4ea8b0f50_01-18-week2-FAILING_AND_PASSING,65,3,68
326639702,Azure/azure-libraries-for-java,18/08/18 03:51,spirals-bears,c4edf6f8-133a-4cec-9a5e-4ad4ea8b0f50_01-18-week2-FAILING_AND_PASSING,64,3,67
327882158,Azure/azure-libraries-for-java,18/08/18 03:54,spirals-bears,c4edf6f8-133a-4cec-9a5e-4ad4ea8b0f50_01-18-week2-FAILING_AND_PASSING,11,0,12,0,1,17,0,91,77,5,97,92,60,0,463
325553827,apache/storm,18/08/18 03:55,spirals-bears,c4edf6f8-133a-4cec-9a5e-4ad4ea8b0f50_01-18-week2-FAILING_AND_PASSING,1003,37,0,2,2,1044
328338357,magefree/mage,18/08/18 04:10,spirals-bears,c4edf6f8-133a-4cec-9a5e-4ad4ea8b0f50_01-18-week2-FAILING_AND_PASSING,8,0,12,0,0,39,0,210,29,1,193,332,167,1,992
326515667,HubSpot/Singularity,18/08/18 04:12,spirals-bears,c4edf6f8-133a-4cec-9a5e-4ad4ea8b0f50_01-18-week2-FAILING_AND_PASSING,11,0,5,0,1,6,0,280,296,3,267,341,19,0,1229
328306636,magefree/mage,18/08/18 04:12,spirals-bears,c4edf6f8-133a-4cec-9a5e-4ad4ea8b0f50_01-18-week2-FAILING_AND_PASSING,9,0,12,0,0,25,0,226,41,3,199,332,169,1,1017
328114436,molgenis/molgenis,18/08/18 04:14,spirals-bears,c4edf6f8-133a-4cec-9a5e-4ad4ea8b0f50_01-18-week2-FAILING_AND_PASSING,66,8,74
327759144,molgenis/molgenis,18/08/18 04:23,spirals-bears,c4edf6f8-133a-4cec-9a5e-4ad4ea8b0f50_01-18-week2-FAILING_AND_PASSING,489,44,0,9,1,543
328050724,magefree/mage,18/08/18 04:26,spirals-bears,c4edf6f8-133a-4cec-9a5e-4ad4ea8b0f50_01-18-week2-FAILING_AND_PASSING,9,0,12,0,1,27,0,174,33,1,188,324,171,1,941
327654067,molgenis/molgenis,18/08/18 04:28,spirals-bears,c4edf6f8-133a-4cec-9a5e-4ad4ea8b0f50_01-18-week2-FAILING_AND_PASSING,56,8,64
327810656,magefree/mage,18/08/18 04:29,spirals-bears,c4edf6f8-133a-4cec-9a5e-4ad4ea8b0f50_01-18-week2-FAILING_AND_PASSING,9,0,12,0,1,30,0,202,137,1,161,329,166,1,1049
327130890,molgenis/molgenis,18/08/18 04:31,spirals-bears,c4edf6f8-133a-4cec-9a5e-4ad4ea8b0f50_01-18-week2-FAILING_AND_PASSING,47,9,56
328178891,StuPro-TOSCAna/TOSCAna,18/08/18 04:31,spirals-bears,c4edf6f8-133a-4cec-9a5e-4ad4ea8b0f50_01-18-week2-FAILING_AND_PASSING,20,2,22
328160076,StuPro-TOSCAna/TOSCAna,18/08/18 04:32,spirals-bears,c4edf6f8-133a-4cec-9a5e-4ad4ea8b0f50_01-18-week2-FAILING_AND_PASSING,22,0,22
327646168,molgenis/molgenis,18/08/18 04:32,spirals-bears,c4edf6f8-133a-4cec-9a5e-4ad4ea8b0f50_01-18-week2-FAILING_AND_PASSING,480,44,0,9,1,534
327795469,StuPro-TOSCAna/TOSCAna,18/08/18 04:32,spirals-bears,c4edf6f8-133a-4cec-9a5e-4ad4ea8b0f50_01-18-week2-FAILING_AND_PASSING,12,0,12
325858569,StuPro-TOSCAna/TOSCAna,18/08/18 04:33,spirals-bears,c4edf6f8-133a-4cec-9a5e-4ad4ea8b0f50_01-18-week2-FAILING_AND_PASSING,13,2,15
327795513,StuPro-TOSCAna/TOSCAna,18/08/18 04:33,spirals-bears,c4edf6f8-133a-4cec-9a5e-4ad4ea8b0f50_01-18-week2-FAILING_AND_PASSING,14,2,16
325858563,StuPro-TOSCAna/TOSCAna,18/08/18 04:33,spirals-bears,c4edf6f8-133a-4cec-9a5e-4ad4ea8b0f50_01-18-week2-FAILING_AND_PASSING,14,0,14
326012230,StuPro-TOSCAna/TOSCAna,18/08/18 04:33,spirals-bears,c4edf6f8-133a-4cec-9a5e-4ad4ea8b0f50_01-18-week2-FAILING_AND_PASSING,18,0,18
326012232,StuPro-TOSCAna/TOSCAna,18/08/18 04:34,spirals-bears,c4edf6f8-133a-4cec-9a5e-4ad4ea8b0f50_01-18-week2-FAILING_AND_PASSING,16,2,18
327143365,molgenis/molgenis,18/08/18 04:37,spirals-bears,c4edf6f8-133a-4cec-9a5e-4ad4ea8b0f50_01-18-week2-FAILING_AND_PASSING,489,38,0,10,1,538
328312438,languagetool-org/languagetool,18/08/18 04:54,spirals-bears,c4edf6f8-133a-4cec-9a5e-4ad4ea8b0f50_01-18-week2-FAILING_AND_PASSING,799,127,300,0,2,1,1,1230
328230106,ga4gh/dockstore,18/08/18 04:54,spirals-bears,c4edf6f8-133a-4cec-9a5e-4ad4ea8b0f50_01-18-week2-FAILING_AND_PASSING,9,2,11
328229586,ga4gh/dockstore,18/08/18 04:55,spirals-bears,c4edf6f8-133a-4cec-9a5e-4ad4ea8b0f50_01-18-week2-FAILING_AND_PASSING,9,0,9
327731299,ga4gh/dockstore,18/08/18 04:55,spirals-bears,c4edf6f8-133a-4cec-9a5e-4ad4ea8b0f50_01-18-week2-FAILING_AND_PASSING,9,2,11
327729410,ga4gh/dockstore,18/08/18 04:56,spirals-bears,c4edf6f8-133a-4cec-9a5e-4ad4ea8b0f50_01-18-week2-FAILING_AND_PASSING,8,0,8
325813222,languagetool-org/languagetool,18/08/18 05:02,spirals-bears,c4edf6f8-133a-4cec-9a5e-4ad4ea8b0f50_01-18-week2-FAILING_AND_PASSING,9,37,0,6,27,0,0,32,0,777,0,76,4,119,106,275,35,0,1503
326527869,ga4gh/dockstore,18/08/18 05:03,spirals-bears,c4edf6f8-133a-4cec-9a5e-4ad4ea8b0f50_01-18-week2-FAILING_AND_PASSING,9,2,11
326523385,ga4gh/dockstore,18/08/18 05:03,spirals-bears,c4edf6f8-133a-4cec-9a5e-4ad4ea8b0f50_01-18-week2-FAILING_AND_PASSING,9,0,9
327426292,linkedin/pinot,18/08/18 05:05,spirals-bears,c4edf6f8-133a-4cec-9a5e-4ad4ea8b0f50_01-18-week2-FAILING_AND_PASSING,9,33,0,7,18,1,1,39,0,3300,0,98,3,830,442,59,62,0,4902
327564166,languagetool-org/languagetool,18/08/18 05:10,spirals-bears,c4edf6f8-133a-4cec-9a5e-4ad4ea8b0f50_01-18-week2-FAILING_AND_PASSING,9,37,0,3,27,0,1,52,0,780,0,60,0,757,119,280,39,0,2164
327327056,ga4gh/dockstore,18/08/18 05:11,spirals-bears,c4edf6f8-133a-4cec-9a5e-4ad4ea8b0f50_01-18-week2-FAILING_AND_PASSING,5,0,0,0,0,2,0,10,103,0,13,762,8,0,903
327328166,dropwizard/metrics,18/08/18 05:11,spirals-bears,c4edf6f8-133a-4cec-9a5e-4ad4ea8b0f50_01-18-week2-FAILING_AND_PASSING,6,0,6
327328110,dropwizard/metrics,18/08/18 05:11,spirals-bears,c4edf6f8-133a-4cec-9a5e-4ad4ea8b0f50_01-18-week2-FAILING_AND_PASSING,6,2,8
327338649,dropwizard/metrics,18/08/18 05:12,spirals-bears,c4edf6f8-133a-4cec-9a5e-4ad4ea8b0f50_01-18-week2-FAILING_AND_PASSING,6,0,6
325598818,dropwizard/metrics,18/08/18 05:15,spirals-bears,c4edf6f8-133a-4cec-9a5e-4ad4ea8b0f50_01-18-week2-FAILING_AND_PASSING,65,115,6,3,0,4,0,193
327276433,dropwizard/metrics,18/08/18 05:15,spirals-bears,c4edf6f8-133a-4cec-9a5e-4ad4ea8b0f50_01-18-week2-FAILING_AND_PASSING,7,0,7
327007903,dropwizard/metrics,18/08/18 05:16,spirals-bears,c4edf6f8-133a-4cec-9a5e-4ad4ea8b0f50_01-18-week2-FAILING_AND_PASSING,9,0,9
327008108,dropwizard/metrics,18/08/18 05:16,spirals-bears,c4edf6f8-133a-4cec-9a5e-4ad4ea8b0f50_01-18-week2-FAILING_AND_PASSING,9,3,12
327475959,airlift/airlift,18/08/18 05:17,spirals-bears,c4edf6f8-133a-4cec-9a5e-4ad4ea8b0f50_01-18-week2-FAILING_AND_PASSING,13,3,16
327429177,airlift/airlift,18/08/18 05:17,spirals-bears,c4edf6f8-133a-4cec-9a5e-4ad4ea8b0f50_01-18-week2-FAILING_AND_PASSING,12,4,16
327325035,airlift/airlift,18/08/18 05:17,spirals-bears,c4edf6f8-133a-4cec-9a5e-4ad4ea8b0f50_01-18-week2-FAILING_AND_PASSING,14,3,17
327073491,airlift/airlift,18/08/18 05:18,spirals-bears,c4edf6f8-133a-4cec-9a5e-4ad4ea8b0f50_01-18-week2-FAILING_AND_PASSING,13,3,16
327060874,airlift/airlift,18/08/18 05:18,spirals-bears,c4edf6f8-133a-4cec-9a5e-4ad4ea8b0f50_01-18-week2-FAILING_AND_PASSING,13,3,16
328008753,openzipkin/zipkin,18/08/18 05:19,spirals-bears,c4edf6f8-133a-4cec-9a5e-4ad4ea8b0f50_01-18-week2-FAILING_AND_PASSING,26,2,28
327096011,openzipkin/zipkin,18/08/18 05:19,spirals-bears,c4edf6f8-133a-4cec-9a5e-4ad4ea8b0f50_01-18-week2-FAILING_AND_PASSING,24,0,24
324714672,ga4gh/dockstore,18/08/18 05:20,spirals-bears,c4edf6f8-133a-4cec-9a5e-4ad4ea8b0f50_01-18-week2-FAILING_AND_PASSING,994,10,0,2,1,1007
326980935,atomix/atomix,18/08/18 05:27,spirals-bears,c4edf6f8-133a-4cec-9a5e-4ad4ea8b0f50_01-18-week2-FAILING_AND_PASSING,894,103,13,0,0,1,1011
326779089,openzipkin/zipkin,18/08/18 05:29,spirals-bears,c4edf6f8-133a-4cec-9a5e-4ad4ea8b0f50_01-18-week2-FAILING_AND_PASSING,269,292,24,0,0,2,0,587
327327396,pgjdbc/pgjdbc,18/08/18 05:30,spirals-bears,c4edf6f8-133a-4cec-9a5e-4ad4ea8b0f50_01-18-week2-FAILING_AND_PASSING,11,0,4,2,0,3,0,39,21,3,36,42,10,2,173
327763662,pgjdbc/pgjdbc,18/08/18 05:33,spirals-bears,c4edf6f8-133a-4cec-9a5e-4ad4ea8b0f50_01-18-week2-FAILING_AND_PASSING,20,0,3,2,0,4,0,33,18,4,37,43,10,2,176
327810637,geoserver/geoserver,18/08/18 05:40,spirals-bears,c4edf6f8-133a-4cec-9a5e-4ad4ea8b0f50_01-18-week2-FAILING_AND_PASSING,474,55,0,19,1,549
324409759,geoserver/geoserver,18/08/18 06:00,spirals-bears,c4edf6f8-133a-4cec-9a5e-4ad4ea8b0f50_01-18-week2-FAILING_AND_PASSING,12,0,6,0,1,32,0,462,32,1,455,560,52,1,1614
327147111,resteasy/Resteasy,18/08/18 06:03,spirals-bears,c4edf6f8-133a-4cec-9a5e-4ad4ea8b0f50_01-18-week2-FAILING_AND_PASSING,1770,729,18,1,2,2,1,2523
322857354,apache/jackrabbit-oak,18/08/18 06:08,spirals-bears,c4edf6f8-133a-4cec-9a5e-4ad4ea8b0f50_01-18-week2-FAILING_AND_PASSING,9,0,2,0,0,8,0,1646,176,0,1599,287,38,1,3766
326142370,arcao/geocaching-api,18/08/18 06:10,spirals-bears,c4edf6f8-133a-4cec-9a5e-4ad4ea8b0f50_01-18-week2-FAILING_AND_PASSING,9,0,0,0,0,0,0,16,9,0,15,21,3,0,73
326239095,swagger-api/swagger-codegen,18/08/18 06:10,spirals-bears,c4edf6f8-133a-4cec-9a5e-4ad4ea8b0f50_01-18-week2-FAILING_AND_PASSING,33,6,39
325301099,swagger-api/swagger-codegen,18/08/18 06:13,spirals-bears,c4edf6f8-133a-4cec-9a5e-4ad4ea8b0f50_01-18-week2-FAILING_AND_PASSING,87,35,0,9,0,131
325299419,swagger-api/swagger-codegen,18/08/18 06:15,spirals-bears,c4edf6f8-133a-4cec-9a5e-4ad4ea8b0f50_01-18-week2-FAILING_AND_PASSING,67,36,0,2,0,105
327600162,aicis/fresco,18/08/18 06:33,spirals-bears,c4edf6f8-133a-4cec-9a5e-4ad4ea8b0f50_01-18-week2-FAILING_AND_PASSING,1840,109,9,0,0,0,0,1958
328264950,spring-cloud/spring-cloud-gcp,18/08/18 06:33,spirals-bears,c4edf6f8-133a-4cec-9a5e-4ad4ea8b0f50_01-18-week2-FAILING_AND_PASSING,4,2,6
326245507,Blazebit/blaze-persistence,18/08/18 06:34,spirals-bears,c4edf6f8-133a-4cec-9a5e-4ad4ea8b0f50_01-18-week2-FAILING_AND_PASSING,9,0,2,0,1,5,0,431,108,1,430,161,10,0,1158
328402424,apache/incubator-servicecomb-saga,18/08/18 06:35,spirals-bears,c4edf6f8-133a-4cec-9a5e-4ad4ea8b0f50_01-18-week2-FAILING_AND_PASSING,5,2,7
328402422,apache/incubator-servicecomb-saga,18/08/18 06:35,spirals-bears,c4edf6f8-133a-4cec-9a5e-4ad4ea8b0f50_01-18-week2-FAILING_AND_PASSING,4,0,4
327562652,apache/incubator-servicecomb-saga,18/08/18 06:35,spirals-bears,c4edf6f8-133a-4cec-9a5e-4ad4ea8b0f50_01-18-week2-FAILING_AND_PASSING,4,0,4
327562705,apache/incubator-servicecomb-saga,18/08/18 06:35,spirals-bears,c4edf6f8-133a-4cec-9a5e-4ad4ea8b0f50_01-18-week2-FAILING_AND_PASSING,4,2,6
327548613,apache/incubator-servicecomb-saga,18/08/18 06:35,spirals-bears,c4edf6f8-133a-4cec-9a5e-4ad4ea8b0f50_01-18-week2-FAILING_AND_PASSING,4,0,4
327548619,apache/incubator-servicecomb-saga,18/08/18 06:36,spirals-bears,c4edf6f8-133a-4cec-9a5e-4ad4ea8b0f50_01-18-week2-FAILING_AND_PASSING,5,2,7
327513390,apache/incubator-servicecomb-saga,18/08/18 06:36,spirals-bears,c4edf6f8-133a-4cec-9a5e-4ad4ea8b0f50_01-18-week2-FAILING_AND_PASSING,4,2,6
327129952,apache/incubator-servicecomb-saga,18/08/18 06:36,spirals-bears,c4edf6f8-133a-4cec-9a5e-4ad4ea8b0f50_01-18-week2-FAILING_AND_PASSING,4,2,6
327130373,apache/incubator-servicecomb-saga,18/08/18 06:36,spirals-bears,c4edf6f8-133a-4cec-9a5e-4ad4ea8b0f50_01-18-week2-FAILING_AND_PASSING,4,2,6
327059078,apache/incubator-servicecomb-saga,18/08/18 06:37,spirals-bears,c4edf6f8-133a-4cec-9a5e-4ad4ea8b0f50_01-18-week2-FAILING_AND_PASSING,4,0,4
327556888,apache/incubator-servicecomb-saga,18/08/18 06:38,spirals-bears,c4edf6f8-133a-4cec-9a5e-4ad4ea8b0f50_01-18-week2-FAILING_AND_PASSING,194,119,4,0,0,4,0,321
326256835,dhis2/dhis2-core,18/08/18 06:39,spirals-bears,c4edf6f8-133a-4cec-9a5e-4ad4ea8b0f50_01-18-week2-FAILING_AND_PASSING,23,3,26
325338677,dhis2/dhis2-core,18/08/18 06:40,spirals-bears,c4edf6f8-133a-4cec-9a5e-4ad4ea8b0f50_01-18-week2-FAILING_AND_PASSING,23,3,26
327217902,debezium/debezium,18/08/18 06:40,spirals-bears,c4edf6f8-133a-4cec-9a5e-4ad4ea8b0f50_01-18-week2-FAILING_AND_PASSING,6,4,10
326911705,debezium/debezium,18/08/18 06:40,spirals-bears,c4edf6f8-133a-4cec-9a5e-4ad4ea8b0f50_01-18-week2-FAILING_AND_PASSING,6,4,10
327278481,aicis/fresco,18/08/18 06:41,spirals-bears,c4edf6f8-133a-4cec-9a5e-4ad4ea8b0f50_01-18-week2-FAILING_AND_PASSING,9,5,0,4,6,0,0,3,0,1739,0,38,4,343,104,9,4,0,2268
326050874,apache/incubator-servicecomb-saga,18/08/18 06:41,spirals-bears,c4edf6f8-133a-4cec-9a5e-4ad4ea8b0f50_01-18-week2-FAILING_AND_PASSING,164,95,4,0,0,3,0,266
326715423,MyCoRe-Org/mycore,18/08/18 06:42,spirals-bears,c4edf6f8-133a-4cec-9a5e-4ad4ea8b0f50_01-18-week2-FAILING_AND_PASSING,46,0,46
328699105,Activiti/Activiti,18/08/18 06:42,spirals-bears,c4edf6f8-133a-4cec-9a5e-4ad4ea8b0f50_01-18-week2-FAILING_AND_PASSING,37,0,37
326715430,MyCoRe-Org/mycore,18/08/18 06:42,spirals-bears,c4edf6f8-133a-4cec-9a5e-4ad4ea8b0f50_01-18-week2-FAILING_AND_PASSING,92,3,95
327453596,Activiti/Activiti,18/08/18 06:42,spirals-bears,c4edf6f8-133a-4cec-9a5e-4ad4ea8b0f50_01-18-week2-FAILING_AND_PASSING,31,0,31
326373002,Spirals-Team/repairnator,18/08/18 06:43,spirals-bears,c4edf6f8-133a-4cec-9a5e-4ad4ea8b0f50_01-18-week2-FAILING_AND_PASSING,17,0,17
327313711,Activiti/Activiti,18/08/18 06:43,spirals-bears,c4edf6f8-133a-4cec-9a5e-4ad4ea8b0f50_01-18-week2-FAILING_AND_PASSING,35,0,35
326373028,Spirals-Team/repairnator,18/08/18 06:43,spirals-bears,c4edf6f8-133a-4cec-9a5e-4ad4ea8b0f50_01-18-week2-FAILING_AND_PASSING,18,2,20
326299905,Spirals-Team/repairnator,18/08/18 06:43,spirals-bears,c4edf6f8-133a-4cec-9a5e-4ad4ea8b0f50_01-18-week2-FAILING_AND_PASSING,18,0,18
326295994,Spirals-Team/repairnator,18/08/18 06:44,spirals-bears,c4edf6f8-133a-4cec-9a5e-4ad4ea8b0f50_01-18-week2-FAILING_AND_PASSING,17,2,19
327809153,jordilucas/ponto-inteligente-api,18/08/18 06:44,spirals-bears,c4edf6f8-133a-4cec-9a5e-4ad4ea8b0f50_01-18-week2-FAILING_AND_PASSING,13,0,0,0,2,2,0,27,8,0,27,27,2,0,108
326330530,jnidzwetzki/bboxdb,18/08/18 06:48,spirals-bears,c4edf6f8-133a-4cec-9a5e-4ad4ea8b0f50_01-18-week2-FAILING_AND_PASSING,6,0,0,0,0,1,0,35,54,0,37,114,8,0,255
327151469,jnidzwetzki/bboxdb,18/08/18 06:48,spirals-bears,c4edf6f8-133a-4cec-9a5e-4ad4ea8b0f50_01-18-week2-FAILING_AND_PASSING,6,0,0,0,0,1,0,35,52,0,37,146,8,0,285
327670496,aicis/fresco,18/08/18 07:02,spirals-bears,c4edf6f8-133a-4cec-9a5e-4ad4ea8b0f50_01-18-week2-FAILING_AND_PASSING,9,4,0,0,7,0,0,3,0,1894,0,41,0,2834,99,8,4,0,4903
