361500420,apache/flink,01/09/18 13:05,spirals-bears,cbc977a0-20a7-4a06-bcfb-bc20c5ff9a19_04-18-week1-FAILING_AND_PASSING,70,6,76
361515786,apache/flink,01/09/18 13:52,spirals-bears,cbc977a0-20a7-4a06-bcfb-bc20c5ff9a19_04-18-week1-FAILING_AND_PASSING,9,0,3,0,1,195,0,61,821,13,56,1669,60,3,2891
363039103,apache/flink,01/09/18 13:53,spirals-bears,cbc977a0-20a7-4a06-bcfb-bc20c5ff9a19_04-18-week1-FAILING_AND_PASSING,17,0,2,0,2,217,0,55,777,15,53,1697,64,2,2901
361494607,apache/flink,01/09/18 13:54,spirals-bears,cbc977a0-20a7-4a06-bcfb-bc20c5ff9a19_04-18-week1-FAILING_AND_PASSING,11,0,7,1,1,200,0,53,811,13,57,1675,62,4,2895
361515968,apache/flink,01/09/18 13:54,spirals-bears,cbc977a0-20a7-4a06-bcfb-bc20c5ff9a19_04-18-week1-FAILING_AND_PASSING,16,0,3,1,2,231,0,49,833,3,62,1718,62,4,2984
361170413,apache/flink,01/09/18 13:54,spirals-bears,cbc977a0-20a7-4a06-bcfb-bc20c5ff9a19_04-18-week1-FAILING_AND_PASSING,68,7,75
358774536,apache/flink,01/09/18 13:54,spirals-bears,cbc977a0-20a7-4a06-bcfb-bc20c5ff9a19_04-18-week1-FAILING_AND_PASSING,69,7,76
362737777,prestodb/presto,01/09/18 13:55,spirals-bears,cbc977a0-20a7-4a06-bcfb-bc20c5ff9a19_04-18-week1-FAILING_AND_PASSING,44,5,49
363382680,prestodb/presto,01/09/18 13:55,spirals-bears,cbc977a0-20a7-4a06-bcfb-bc20c5ff9a19_04-18-week1-FAILING_AND_PASSING,47,5,52
363318092,prestodb/presto,01/09/18 13:55,spirals-bears,cbc977a0-20a7-4a06-bcfb-bc20c5ff9a19_04-18-week1-FAILING_AND_PASSING,50,5,55
362764317,prestodb/presto,01/09/18 13:56,spirals-bears,cbc977a0-20a7-4a06-bcfb-bc20c5ff9a19_04-18-week1-FAILING_AND_PASSING,45,8,53
362414880,prestodb/presto,01/09/18 13:56,spirals-bears,cbc977a0-20a7-4a06-bcfb-bc20c5ff9a19_04-18-week1-FAILING_AND_PASSING,47,5,52
361418135,prestodb/presto,01/09/18 13:56,spirals-bears,cbc977a0-20a7-4a06-bcfb-bc20c5ff9a19_04-18-week1-FAILING_AND_PASSING,47,7,54
358704291,prestodb/presto,01/09/18 13:57,spirals-bears,cbc977a0-20a7-4a06-bcfb-bc20c5ff9a19_04-18-week1-FAILING_AND_PASSING,44,8,52
362095261,prestodb/presto,01/09/18 13:57,spirals-bears,cbc977a0-20a7-4a06-bcfb-bc20c5ff9a19_04-18-week1-FAILING_AND_PASSING,45,9,54
361937455,prestodb/presto,01/09/18 13:57,spirals-bears,cbc977a0-20a7-4a06-bcfb-bc20c5ff9a19_04-18-week1-FAILING_AND_PASSING,50,7,57
362027607,prestodb/presto,01/09/18 13:59,spirals-bears,cbc977a0-20a7-4a06-bcfb-bc20c5ff9a19_04-18-week1-FAILING_AND_PASSING,44,5,49
361623053,prestodb/presto,01/09/18 13:59,spirals-bears,cbc977a0-20a7-4a06-bcfb-bc20c5ff9a19_04-18-week1-FAILING_AND_PASSING,44,9,53
361198628,prestodb/presto,01/09/18 14:00,spirals-bears,cbc977a0-20a7-4a06-bcfb-bc20c5ff9a19_04-18-week1-FAILING_AND_PASSING,46,15,61
307792549,prestodb/presto,01/09/18 14:00,spirals-bears,cbc977a0-20a7-4a06-bcfb-bc20c5ff9a19_04-18-week1-FAILING_AND_PASSING,48,14,62
363268106,prestodb/presto,01/09/18 14:24,spirals-bears,cbc977a0-20a7-4a06-bcfb-bc20c5ff9a19_04-18-week1-FAILING_AND_PASSING,821,888,53,0,2,2,1766
361876900,prestodb/presto,01/09/18 14:27,spirals-bears,cbc977a0-20a7-4a06-bcfb-bc20c5ff9a19_04-18-week1-FAILING_AND_PASSING,798,907,47,0,2,1,1755
363087969,apache/incubator-druid,01/09/18 15:17,spirals-bears,cbc977a0-20a7-4a06-bcfb-bc20c5ff9a19_04-18-week1-FAILING_AND_PASSING,11,0,2,1,85,0,1405,430,4,1628,965,54,5,4590
362950183,apache/incubator-druid,01/09/18 15:17,spirals-bears,cbc977a0-20a7-4a06-bcfb-bc20c5ff9a19_04-18-week1-FAILING_AND_PASSING,11,0,2,1,72,0,1419,419,4,1634,981,38,9,4590
361924287,apache/incubator-druid,01/09/18 15:38,spirals-bears,cbc977a0-20a7-4a06-bcfb-bc20c5ff9a19_04-18-week1-FAILING_AND_PASSING,13,0,7,2,1,58,0,96,498,7,2314,899,40,6,3941
360455039,apache/incubator-druid,01/09/18 15:39,spirals-bears,cbc977a0-20a7-4a06-bcfb-bc20c5ff9a19_04-18-week1-FAILING_AND_PASSING,35,5,40
361370203,apache/incubator-druid,01/09/18 15:39,spirals-bears,cbc977a0-20a7-4a06-bcfb-bc20c5ff9a19_04-18-week1-FAILING_AND_PASSING,144,919,11,36,0,11,1,53,0,113,2,6,1296
360271279,thelastpickle/cassandra-reaper,01/09/18 15:40,spirals-bears,cbc977a0-20a7-4a06-bcfb-bc20c5ff9a19_04-18-week1-FAILING_AND_PASSING,8,3,11
360271242,thelastpickle/cassandra-reaper,01/09/18 15:40,spirals-bears,cbc977a0-20a7-4a06-bcfb-bc20c5ff9a19_04-18-week1-FAILING_AND_PASSING,7,0,7
363446580,thelastpickle/cassandra-reaper,01/09/18 15:41,spirals-bears,cbc977a0-20a7-4a06-bcfb-bc20c5ff9a19_04-18-week1-FAILING_AND_PASSING,42,69,8,0,1,0,0,120
361962760,apache/incubator-druid,01/09/18 15:49,spirals-bears,cbc977a0-20a7-4a06-bcfb-bc20c5ff9a19_04-18-week1-FAILING_AND_PASSING,13,0,3,1,1,50,0,1316,414,2,2010,1227,39,10,5086
363333951,JMRI/JMRI,01/09/18 16:19,spirals-bears,cbc977a0-20a7-4a06-bcfb-bc20c5ff9a19_04-18-week1-FAILING_AND_PASSING,1845,107,320,0,3,0,11,2286
363310448,JMRI/JMRI,01/09/18 16:21,spirals-bears,cbc977a0-20a7-4a06-bcfb-bc20c5ff9a19_04-18-week1-FAILING_AND_PASSING,1505,109,12,306,0,28,0,243,0,87,152,12,2454
362797752,JMRI/JMRI,01/09/18 16:24,spirals-bears,cbc977a0-20a7-4a06-bcfb-bc20c5ff9a19_04-18-week1-FAILING_AND_PASSING,1731,103,258,0,4,1,8,2105
361767715,apache/incubator-druid,01/09/18 16:28,spirals-bears,cbc977a0-20a7-4a06-bcfb-bc20c5ff9a19_04-18-week1-FAILING_AND_PASSING,9,0,7,1,1,44,4,1400,410,6,1395,923,37,2,4239
362339821,JMRI/JMRI,01/09/18 16:51,spirals-bears,cbc977a0-20a7-4a06-bcfb-bc20c5ff9a19_04-18-week1-FAILING_AND_PASSING,1472,108,270,0,30,0,5,1885
361946280,JMRI/JMRI,01/09/18 16:54,spirals-bears,cbc977a0-20a7-4a06-bcfb-bc20c5ff9a19_04-18-week1-FAILING_AND_PASSING,1573,105,267,0,33,0,3,1981
361706883,JMRI/JMRI,01/09/18 17:00,spirals-bears,cbc977a0-20a7-4a06-bcfb-bc20c5ff9a19_04-18-week1-FAILING_AND_PASSING,1504,115,270,0,13,0,6,1908
361609163,JMRI/JMRI,01/09/18 17:01,spirals-bears,cbc977a0-20a7-4a06-bcfb-bc20c5ff9a19_04-18-week1-FAILING_AND_PASSING,1540,121,10,282,0,5,1,107,0,91,4,2,2163
363465735,apache/nifi,01/09/18 17:02,spirals-bears,cbc977a0-20a7-4a06-bcfb-bc20c5ff9a19_04-18-week1-FAILING_AND_PASSING,35,7,42
363172236,apache/nifi,01/09/18 17:02,spirals-bears,cbc977a0-20a7-4a06-bcfb-bc20c5ff9a19_04-18-week1-FAILING_AND_PASSING,36,5,41
363446977,apache/nifi,01/09/18 17:03,spirals-bears,cbc977a0-20a7-4a06-bcfb-bc20c5ff9a19_04-18-week1-FAILING_AND_PASSING,36,5,41
363247976,apache/nifi,01/09/18 17:26,spirals-bears,cbc977a0-20a7-4a06-bcfb-bc20c5ff9a19_04-18-week1-FAILING_AND_PASSING,1309,40,2,2,3,1356
360708446,JMRI/JMRI,01/09/18 17:27,spirals-bears,cbc977a0-20a7-4a06-bcfb-bc20c5ff9a19_04-18-week1-FAILING_AND_PASSING,1680,113,261,0,39,0,31,2124
361204416,JMRI/JMRI,01/09/18 17:33,spirals-bears,cbc977a0-20a7-4a06-bcfb-bc20c5ff9a19_04-18-week1-FAILING_AND_PASSING,1694,111,12,263,0,4,1,132,0,87,17,6,2327
360976176,JMRI/JMRI,01/09/18 17:41,spirals-bears,cbc977a0-20a7-4a06-bcfb-bc20c5ff9a19_04-18-week1-FAILING_AND_PASSING,1771,111,503,0,4,0,11,2400
362751269,apache/nifi,01/09/18 17:55,spirals-bears,cbc977a0-20a7-4a06-bcfb-bc20c5ff9a19_04-18-week1-FAILING_AND_PASSING,1633,43,1,2,4,1683
361674740,apache/nifi,01/09/18 17:55,spirals-bears,cbc977a0-20a7-4a06-bcfb-bc20c5ff9a19_04-18-week1-FAILING_AND_PASSING,1641,37,1,2,4,1685
362512765,INRIA/spoon,01/09/18 17:56,spirals-bears,cbc977a0-20a7-4a06-bcfb-bc20c5ff9a19_04-18-week1-FAILING_AND_PASSING,11,6,17
360626908,INRIA/spoon,01/09/18 17:56,spirals-bears,cbc977a0-20a7-4a06-bcfb-bc20c5ff9a19_04-18-week1-FAILING_AND_PASSING,10,3,13
362510783,EnMasseProject/enmasse,01/09/18 17:57,spirals-bears,cbc977a0-20a7-4a06-bcfb-bc20c5ff9a19_04-18-week1-FAILING_AND_PASSING,34,3,37
363579747,batfish/batfish,01/09/18 17:58,spirals-bears,cbc977a0-20a7-4a06-bcfb-bc20c5ff9a19_04-18-week1-FAILING_AND_PASSING,58,0,58
363579831,batfish/batfish,01/09/18 18:00,spirals-bears,cbc977a0-20a7-4a06-bcfb-bc20c5ff9a19_04-18-week1-FAILING_AND_PASSING,65,4,69
362489527,batfish/batfish,01/09/18 18:01,spirals-bears,cbc977a0-20a7-4a06-bcfb-bc20c5ff9a19_04-18-week1-FAILING_AND_PASSING,55,3,58
362969902,batfish/batfish,01/09/18 18:02,spirals-bears,cbc977a0-20a7-4a06-bcfb-bc20c5ff9a19_04-18-week1-FAILING_AND_PASSING,47,3,50
361391296,apache/nifi,01/09/18 18:03,spirals-bears,cbc977a0-20a7-4a06-bcfb-bc20c5ff9a19_04-18-week1-FAILING_AND_PASSING,1678,37,1,9,3,1728
362969900,batfish/batfish,01/09/18 18:03,spirals-bears,cbc977a0-20a7-4a06-bcfb-bc20c5ff9a19_04-18-week1-FAILING_AND_PASSING,53,0,53
362904759,batfish/batfish,01/09/18 18:04,spirals-bears,cbc977a0-20a7-4a06-bcfb-bc20c5ff9a19_04-18-week1-FAILING_AND_PASSING,50,3,53
362904755,batfish/batfish,01/09/18 18:04,spirals-bears,cbc977a0-20a7-4a06-bcfb-bc20c5ff9a19_04-18-week1-FAILING_AND_PASSING,51,0,51
362864199,batfish/batfish,01/09/18 18:05,spirals-bears,cbc977a0-20a7-4a06-bcfb-bc20c5ff9a19_04-18-week1-FAILING_AND_PASSING,49,0,49
362864210,batfish/batfish,01/09/18 18:05,spirals-bears,cbc977a0-20a7-4a06-bcfb-bc20c5ff9a19_04-18-week1-FAILING_AND_PASSING,55,2,57
362840671,batfish/batfish,01/09/18 18:06,spirals-bears,cbc977a0-20a7-4a06-bcfb-bc20c5ff9a19_04-18-week1-FAILING_AND_PASSING,49,0,49
362840685,batfish/batfish,01/09/18 18:06,spirals-bears,cbc977a0-20a7-4a06-bcfb-bc20c5ff9a19_04-18-week1-FAILING_AND_PASSING,58,2,60
362432004,batfish/batfish,01/09/18 18:07,spirals-bears,cbc977a0-20a7-4a06-bcfb-bc20c5ff9a19_04-18-week1-FAILING_AND_PASSING,54,0,54
362796055,batfish/batfish,01/09/18 18:07,spirals-bears,cbc977a0-20a7-4a06-bcfb-bc20c5ff9a19_04-18-week1-FAILING_AND_PASSING,63,0,63
362305332,batfish/batfish,01/09/18 18:08,spirals-bears,cbc977a0-20a7-4a06-bcfb-bc20c5ff9a19_04-18-week1-FAILING_AND_PASSING,48,0,48
362432010,batfish/batfish,01/09/18 18:08,spirals-bears,cbc977a0-20a7-4a06-bcfb-bc20c5ff9a19_04-18-week1-FAILING_AND_PASSING,57,3,60
362305403,batfish/batfish,01/09/18 18:09,spirals-bears,cbc977a0-20a7-4a06-bcfb-bc20c5ff9a19_04-18-week1-FAILING_AND_PASSING,52,3,55
362312758,batfish/batfish,01/09/18 18:09,spirals-bears,cbc977a0-20a7-4a06-bcfb-bc20c5ff9a19_04-18-week1-FAILING_AND_PASSING,58,0,58
361203756,apache/nifi,01/09/18 18:10,spirals-bears,cbc977a0-20a7-4a06-bcfb-bc20c5ff9a19_04-18-week1-FAILING_AND_PASSING,1691,50,1,4,4,1750
362312771,batfish/batfish,01/09/18 18:10,spirals-bears,cbc977a0-20a7-4a06-bcfb-bc20c5ff9a19_04-18-week1-FAILING_AND_PASSING,50,3,53
361952773,batfish/batfish,01/09/18 18:11,spirals-bears,cbc977a0-20a7-4a06-bcfb-bc20c5ff9a19_04-18-week1-FAILING_AND_PASSING,50,0,50
361830913,batfish/batfish,01/09/18 18:12,spirals-bears,cbc977a0-20a7-4a06-bcfb-bc20c5ff9a19_04-18-week1-FAILING_AND_PASSING,57,0,57
361776917,batfish/batfish,01/09/18 18:12,spirals-bears,cbc977a0-20a7-4a06-bcfb-bc20c5ff9a19_04-18-week1-FAILING_AND_PASSING,51,0,51
361830952,batfish/batfish,01/09/18 18:12,spirals-bears,cbc977a0-20a7-4a06-bcfb-bc20c5ff9a19_04-18-week1-FAILING_AND_PASSING,62,4,66
361404444,batfish/batfish,01/09/18 18:13,spirals-bears,cbc977a0-20a7-4a06-bcfb-bc20c5ff9a19_04-18-week1-FAILING_AND_PASSING,51,0,51
361404451,batfish/batfish,01/09/18 18:13,spirals-bears,cbc977a0-20a7-4a06-bcfb-bc20c5ff9a19_04-18-week1-FAILING_AND_PASSING,57,3,60
361776924,batfish/batfish,01/09/18 18:13,spirals-bears,cbc977a0-20a7-4a06-bcfb-bc20c5ff9a19_04-18-week1-FAILING_AND_PASSING,72,3,75
361990339,lucee/Lucee,01/09/18 18:13,spirals-bears,cbc977a0-20a7-4a06-bcfb-bc20c5ff9a19_04-18-week1-FAILING_AND_PASSING,3,8,20,0,0,0,0,31
362305769,lucee/Lucee,01/09/18 18:13,spirals-bears,cbc977a0-20a7-4a06-bcfb-bc20c5ff9a19_04-18-week1-FAILING_AND_PASSING,3,6,20,0,1,0,0,30
361990173,lucee/Lucee,01/09/18 18:14,spirals-bears,cbc977a0-20a7-4a06-bcfb-bc20c5ff9a19_04-18-week1-FAILING_AND_PASSING,3,8,23,0,0,0,0,34
361956974,apache/incubator-servicecomb-java-chassis,01/09/18 18:14,spirals-bears,cbc977a0-20a7-4a06-bcfb-bc20c5ff9a19_04-18-week1-FAILING_AND_PASSING,9,5,14
361532800,apache/incubator-servicecomb-java-chassis,01/09/18 18:14,spirals-bears,cbc977a0-20a7-4a06-bcfb-bc20c5ff9a19_04-18-week1-FAILING_AND_PASSING,9,3,12
363583468,runelite/runelite,01/09/18 18:14,spirals-bears,cbc977a0-20a7-4a06-bcfb-bc20c5ff9a19_04-18-week1-FAILING_AND_PASSING,11,0,11
363351137,runelite/runelite,01/09/18 18:15,spirals-bears,cbc977a0-20a7-4a06-bcfb-bc20c5ff9a19_04-18-week1-FAILING_AND_PASSING,11,0,11
363506093,runelite/runelite,01/09/18 18:15,spirals-bears,cbc977a0-20a7-4a06-bcfb-bc20c5ff9a19_04-18-week1-FAILING_AND_PASSING,11,13,24
363361056,runelite/runelite,01/09/18 18:15,spirals-bears,cbc977a0-20a7-4a06-bcfb-bc20c5ff9a19_04-18-week1-FAILING_AND_PASSING,10,0,10
363106553,runelite/runelite,01/09/18 18:15,spirals-bears,cbc977a0-20a7-4a06-bcfb-bc20c5ff9a19_04-18-week1-FAILING_AND_PASSING,10,0,10
362915554,runelite/runelite,01/09/18 18:16,spirals-bears,cbc977a0-20a7-4a06-bcfb-bc20c5ff9a19_04-18-week1-FAILING_AND_PASSING,10,0,10
363127663,runelite/runelite,01/09/18 18:16,spirals-bears,cbc977a0-20a7-4a06-bcfb-bc20c5ff9a19_04-18-week1-FAILING_AND_PASSING,11,14,25
362882908,runelite/runelite,01/09/18 18:16,spirals-bears,cbc977a0-20a7-4a06-bcfb-bc20c5ff9a19_04-18-week1-FAILING_AND_PASSING,11,0,11
362528875,runelite/runelite,01/09/18 18:16,spirals-bears,cbc977a0-20a7-4a06-bcfb-bc20c5ff9a19_04-18-week1-FAILING_AND_PASSING,13,0,13
362516449,runelite/runelite,01/09/18 18:16,spirals-bears,cbc977a0-20a7-4a06-bcfb-bc20c5ff9a19_04-18-week1-FAILING_AND_PASSING,11,0,11
361848378,runelite/runelite,01/09/18 18:17,spirals-bears,cbc977a0-20a7-4a06-bcfb-bc20c5ff9a19_04-18-week1-FAILING_AND_PASSING,10,0,10
361959800,runelite/runelite,01/09/18 18:18,spirals-bears,cbc977a0-20a7-4a06-bcfb-bc20c5ff9a19_04-18-week1-FAILING_AND_PASSING,10,14,24
360996219,apache/nifi,01/09/18 18:18,spirals-bears,cbc977a0-20a7-4a06-bcfb-bc20c5ff9a19_04-18-week1-FAILING_AND_PASSING,1325,40,1,8,3,1377
361944219,runelite/runelite,01/09/18 18:18,spirals-bears,cbc977a0-20a7-4a06-bcfb-bc20c5ff9a19_04-18-week1-FAILING_AND_PASSING,12,13,25
361806006,runelite/runelite,01/09/18 18:19,spirals-bears,cbc977a0-20a7-4a06-bcfb-bc20c5ff9a19_04-18-week1-FAILING_AND_PASSING,10,3,13
362334093,runelite/runelite,01/09/18 18:19,spirals-bears,cbc977a0-20a7-4a06-bcfb-bc20c5ff9a19_04-18-week1-FAILING_AND_PASSING,137,11,0,15,0,163
361659415,runelite/runelite,01/09/18 18:19,spirals-bears,cbc977a0-20a7-4a06-bcfb-bc20c5ff9a19_04-18-week1-FAILING_AND_PASSING,11,14,25
361048704,runelite/runelite,01/09/18 18:19,spirals-bears,cbc977a0-20a7-4a06-bcfb-bc20c5ff9a19_04-18-week1-FAILING_AND_PASSING,10,0,10
361288374,runelite/runelite,01/09/18 18:19,spirals-bears,cbc977a0-20a7-4a06-bcfb-bc20c5ff9a19_04-18-week1-FAILING_AND_PASSING,11,0,11
361177861,runelite/runelite,01/09/18 18:20,spirals-bears,cbc977a0-20a7-4a06-bcfb-bc20c5ff9a19_04-18-week1-FAILING_AND_PASSING,11,14,25
361264208,runelite/runelite,01/09/18 18:20,spirals-bears,cbc977a0-20a7-4a06-bcfb-bc20c5ff9a19_04-18-week1-FAILING_AND_PASSING,10,15,25
361154281,runelite/runelite,01/09/18 18:20,spirals-bears,cbc977a0-20a7-4a06-bcfb-bc20c5ff9a19_04-18-week1-FAILING_AND_PASSING,11,0,11
361048624,runelite/runelite,01/09/18 18:20,spirals-bears,cbc977a0-20a7-4a06-bcfb-bc20c5ff9a19_04-18-week1-FAILING_AND_PASSING,12,0,12
361018373,runelite/runelite,01/09/18 18:20,spirals-bears,cbc977a0-20a7-4a06-bcfb-bc20c5ff9a19_04-18-week1-FAILING_AND_PASSING,13,0,13
361126588,runelite/runelite,01/09/18 18:20,spirals-bears,cbc977a0-20a7-4a06-bcfb-bc20c5ff9a19_04-18-week1-FAILING_AND_PASSING,12,17,29
361001371,runelite/runelite,01/09/18 18:20,spirals-bears,cbc977a0-20a7-4a06-bcfb-bc20c5ff9a19_04-18-week1-FAILING_AND_PASSING,11,0,11
361012737,runelite/runelite,01/09/18 18:21,spirals-bears,cbc977a0-20a7-4a06-bcfb-bc20c5ff9a19_04-18-week1-FAILING_AND_PASSING,11,13,24
360940271,runelite/runelite,01/09/18 18:21,spirals-bears,cbc977a0-20a7-4a06-bcfb-bc20c5ff9a19_04-18-week1-FAILING_AND_PASSING,12,0,12
360808251,runelite/runelite,01/09/18 18:21,spirals-bears,cbc977a0-20a7-4a06-bcfb-bc20c5ff9a19_04-18-week1-FAILING_AND_PASSING,10,0,10
354367919,apache/calcite,01/09/18 18:21,spirals-bears,cbc977a0-20a7-4a06-bcfb-bc20c5ff9a19_04-18-week1-FAILING_AND_PASSING,20,3,23
360908346,runelite/runelite,01/09/18 18:23,spirals-bears,cbc977a0-20a7-4a06-bcfb-bc20c5ff9a19_04-18-week1-FAILING_AND_PASSING,89,12,0,14,0,115
360102342,apache/storm,01/09/18 18:23,spirals-bears,cbc977a0-20a7-4a06-bcfb-bc20c5ff9a19_04-18-week1-FAILING_AND_PASSING,39,3,42
361250879,apache/storm,01/09/18 18:24,spirals-bears,cbc977a0-20a7-4a06-bcfb-bc20c5ff9a19_04-18-week1-FAILING_AND_PASSING,45,2,47
361521671,apache/incubator-servicecomb-java-chassis,01/09/18 18:25,spirals-bears,cbc977a0-20a7-4a06-bcfb-bc20c5ff9a19_04-18-week1-FAILING_AND_PASSING,392,239,9,1,6,6,0,653
362907869,CorfuDB/CorfuDB,01/09/18 18:26,spirals-bears,cbc977a0-20a7-4a06-bcfb-bc20c5ff9a19_04-18-week1-FAILING_AND_PASSING,288,0,288
360776978,apache/storm,01/09/18 18:27,spirals-bears,cbc977a0-20a7-4a06-bcfb-bc20c5ff9a19_04-18-week1-FAILING_AND_PASSING,42,5,47
361286330,apache/calcite,01/09/18 18:31,spirals-bears,cbc977a0-20a7-4a06-bcfb-bc20c5ff9a19_04-18-week1-FAILING_AND_PASSING,392,130,21,0,1,1,0,545
363124953,apache/activemq-artemis,01/09/18 18:32,spirals-bears,cbc977a0-20a7-4a06-bcfb-bc20c5ff9a19_04-18-week1-FAILING_AND_PASSING,28,45,73
362622522,apache/activemq-artemis,01/09/18 18:34,spirals-bears,cbc977a0-20a7-4a06-bcfb-bc20c5ff9a19_04-18-week1-FAILING_AND_PASSING,25,50,75
361988151,apache/activemq-artemis,01/09/18 18:34,spirals-bears,cbc977a0-20a7-4a06-bcfb-bc20c5ff9a19_04-18-week1-FAILING_AND_PASSING,30,8,38
362424640,apache/activemq-artemis,01/09/18 18:36,spirals-bears,cbc977a0-20a7-4a06-bcfb-bc20c5ff9a19_04-18-week1-FAILING_AND_PASSING,27,44,71
362414731,apache/activemq-artemis,01/09/18 18:37,spirals-bears,cbc977a0-20a7-4a06-bcfb-bc20c5ff9a19_04-18-week1-FAILING_AND_PASSING,27,45,72
362298417,apache/activemq-artemis,01/09/18 18:39,spirals-bears,cbc977a0-20a7-4a06-bcfb-bc20c5ff9a19_04-18-week1-FAILING_AND_PASSING,29,56,85
361628452,apache/activemq-artemis,01/09/18 18:40,spirals-bears,cbc977a0-20a7-4a06-bcfb-bc20c5ff9a19_04-18-week1-FAILING_AND_PASSING,27,6,33
363230636,apache/activemq-artemis,01/09/18 18:40,spirals-bears,cbc977a0-20a7-4a06-bcfb-bc20c5ff9a19_04-18-week1-FAILING_AND_PASSING,316,450,28,0,2,1,0,797
361382807,apache/activemq-artemis,01/09/18 18:40,spirals-bears,cbc977a0-20a7-4a06-bcfb-bc20c5ff9a19_04-18-week1-FAILING_AND_PASSING,29,4,33
362414415,linkedin/pinot,01/09/18 18:41,spirals-bears,cbc977a0-20a7-4a06-bcfb-bc20c5ff9a19_04-18-week1-FAILING_AND_PASSING,37,4,41
361824718,linkedin/pinot,01/09/18 18:41,spirals-bears,cbc977a0-20a7-4a06-bcfb-bc20c5ff9a19_04-18-week1-FAILING_AND_PASSING,36,3,39
361382798,linkedin/pinot,01/09/18 18:42,spirals-bears,cbc977a0-20a7-4a06-bcfb-bc20c5ff9a19_04-18-week1-FAILING_AND_PASSING,39,4,43
362816438,Azure/azure-libraries-for-java,01/09/18 18:43,spirals-bears,cbc977a0-20a7-4a06-bcfb-bc20c5ff9a19_04-18-week1-FAILING_AND_PASSING,64,4,68
360088157,apache/storm,01/09/18 18:48,spirals-bears,cbc977a0-20a7-4a06-bcfb-bc20c5ff9a19_04-18-week1-FAILING_AND_PASSING,16,0,7,0,2,10,0,34,543,6,58,697,46,0,1419
360417598,apache/storm,01/09/18 18:53,spirals-bears,cbc977a0-20a7-4a06-bcfb-bc20c5ff9a19_04-18-week1-FAILING_AND_PASSING,604,695,22,36,0,1,2,14,0,309,1,0,1684
363218469,HubSpot/Singularity,01/09/18 18:54,spirals-bears,cbc977a0-20a7-4a06-bcfb-bc20c5ff9a19_04-18-week1-FAILING_AND_PASSING,299,17,0,3,1,320
362783329,HubSpot/Singularity,01/09/18 18:56,spirals-bears,cbc977a0-20a7-4a06-bcfb-bc20c5ff9a19_04-18-week1-FAILING_AND_PASSING,168,17,0,0,1,186
362611705,HubSpot/Singularity,01/09/18 19:00,spirals-bears,cbc977a0-20a7-4a06-bcfb-bc20c5ff9a19_04-18-week1-FAILING_AND_PASSING,164,19,0,0,2,185
362611721,HubSpot/Singularity,01/09/18 19:04,spirals-bears,cbc977a0-20a7-4a06-bcfb-bc20c5ff9a19_04-18-week1-FAILING_AND_PASSING,251,16,0,2,1,270
363220917,HubSpot/Singularity,01/09/18 19:06,spirals-bears,cbc977a0-20a7-4a06-bcfb-bc20c5ff9a19_04-18-week1-FAILING_AND_PASSING,9,0,0,8,1,16,0,358,339,0,318,363,18,0,1430
363214976,HubSpot/Singularity,01/09/18 19:06,spirals-bears,cbc977a0-20a7-4a06-bcfb-bc20c5ff9a19_04-18-week1-FAILING_AND_PASSING,12,0,0,4,1,7,0,369,330,1,309,357,18,0,1408
362611845,HubSpot/Singularity,01/09/18 19:08,spirals-bears,cbc977a0-20a7-4a06-bcfb-bc20c5ff9a19_04-18-week1-FAILING_AND_PASSING,140,19,0,0,2,161
362678941,HubSpot/Singularity,01/09/18 19:22,spirals-bears,cbc977a0-20a7-4a06-bcfb-bc20c5ff9a19_04-18-week1-FAILING_AND_PASSING,18,0,0,52,1,21,1,442,360,4,363,396,18,5,1681
362205470,HubSpot/Singularity,01/09/18 19:38,spirals-bears,cbc977a0-20a7-4a06-bcfb-bc20c5ff9a19_04-18-week1-FAILING_AND_PASSING,23,0,0,27,1,135,2,366,377,25,406,401,19,69,1851
361752099,HubSpot/Singularity,01/09/18 19:38,spirals-bears,cbc977a0-20a7-4a06-bcfb-bc20c5ff9a19_04-18-week1-FAILING_AND_PASSING,23,0,3,18,1,199,9,385,377,53,352,404,17,70,1911
360322219,HubSpot/Singularity,01/09/18 19:39,spirals-bears,cbc977a0-20a7-4a06-bcfb-bc20c5ff9a19_04-18-week1-FAILING_AND_PASSING,14,0,0,4,1,122,3,409,369,2,492,422,26,17,1881
361172457,HubSpot/Singularity,01/09/18 19:47,spirals-bears,cbc977a0-20a7-4a06-bcfb-bc20c5ff9a19_04-18-week1-FAILING_AND_PASSING,20,0,6,0,4,45,0,252,297,14,356,408,21,7,1430
361370481,magefree/mage,01/09/18 19:56,spirals-bears,cbc977a0-20a7-4a06-bcfb-bc20c5ff9a19_04-18-week1-FAILING_AND_PASSING,8,0,12,0,1,39,0,146,35,1,199,357,166,2,966
363446229,magefree/mage,01/09/18 19:56,spirals-bears,cbc977a0-20a7-4a06-bcfb-bc20c5ff9a19_04-18-week1-FAILING_AND_PASSING,9,0,13,0,2,46,0,174,28,1,228,362,177,1,1041
361676565,magefree/mage,01/09/18 19:56,spirals-bears,cbc977a0-20a7-4a06-bcfb-bc20c5ff9a19_04-18-week1-FAILING_AND_PASSING,8,0,13,0,1,47,0,179,33,1,225,355,173,1,1036
361368774,magefree/mage,01/09/18 20:04,spirals-bears,cbc977a0-20a7-4a06-bcfb-bc20c5ff9a19_04-18-week1-FAILING_AND_PASSING,8,0,12,1,1,27,0,179,37,1,206,342,168,1,983
361548102,molgenis/molgenis,01/09/18 20:05,spirals-bears,cbc977a0-20a7-4a06-bcfb-bc20c5ff9a19_04-18-week1-FAILING_AND_PASSING,45,11,56
356487173,algolia/algoliasearch-client-java-2,01/09/18 20:08,spirals-bears,cbc977a0-20a7-4a06-bcfb-bc20c5ff9a19_04-18-week1-FAILING_AND_PASSING,9,0,0,0,0,0,0,27,35,0,25,51,4,0,151
360337059,algolia/algoliasearch-client-java-2,01/09/18 20:08,spirals-bears,cbc977a0-20a7-4a06-bcfb-bc20c5ff9a19_04-18-week1-FAILING_AND_PASSING,4,1,5
360337040,algolia/algoliasearch-client-java-2,01/09/18 20:08,spirals-bears,cbc977a0-20a7-4a06-bcfb-bc20c5ff9a19_04-18-week1-FAILING_AND_PASSING,4,0,4
362688225,visallo/vertexium,01/09/18 20:11,spirals-bears,cbc977a0-20a7-4a06-bcfb-bc20c5ff9a19_04-18-week1-FAILING_AND_PASSING,16,164,7,0,0,0,0,187
362604175,visallo/vertexium,01/09/18 20:12,spirals-bears,cbc977a0-20a7-4a06-bcfb-bc20c5ff9a19_04-18-week1-FAILING_AND_PASSING,7,3,10
362349225,visallo/vertexium,01/09/18 20:12,spirals-bears,cbc977a0-20a7-4a06-bcfb-bc20c5ff9a19_04-18-week1-FAILING_AND_PASSING,8,2,10
362305915,visallo/vertexium,01/09/18 20:13,spirals-bears,cbc977a0-20a7-4a06-bcfb-bc20c5ff9a19_04-18-week1-FAILING_AND_PASSING,7,2,9
359109685,magefree/mage,01/09/18 20:13,spirals-bears,cbc977a0-20a7-4a06-bcfb-bc20c5ff9a19_04-18-week1-FAILING_AND_PASSING,11,0,16,0,0,28,0,161,40,6,199,359,178,1,999
360840878,magefree/mage,01/09/18 20:13,spirals-bears,cbc977a0-20a7-4a06-bcfb-bc20c5ff9a19_04-18-week1-FAILING_AND_PASSING,10,0,16,0,0,28,0,155,27,1,173,341,272,1,1024
362612086,apache/incubator-dubbo,01/09/18 20:13,spirals-bears,cbc977a0-20a7-4a06-bcfb-bc20c5ff9a19_04-18-week1-FAILING_AND_PASSING,9,0,9
362973289,apache/incubator-dubbo,01/09/18 20:14,spirals-bears,cbc977a0-20a7-4a06-bcfb-bc20c5ff9a19_04-18-week1-FAILING_AND_PASSING,9,0,9
363184311,ga4gh/dockstore,01/09/18 20:14,spirals-bears,cbc977a0-20a7-4a06-bcfb-bc20c5ff9a19_04-18-week1-FAILING_AND_PASSING,11,2,13
363183239,ga4gh/dockstore,01/09/18 20:14,spirals-bears,cbc977a0-20a7-4a06-bcfb-bc20c5ff9a19_04-18-week1-FAILING_AND_PASSING,9,0,9
361659660,ga4gh/dockstore,01/09/18 20:15,spirals-bears,cbc977a0-20a7-4a06-bcfb-bc20c5ff9a19_04-18-week1-FAILING_AND_PASSING,9,2,11
361255550,ga4gh/dockstore,01/09/18 20:15,spirals-bears,cbc977a0-20a7-4a06-bcfb-bc20c5ff9a19_04-18-week1-FAILING_AND_PASSING,9,0,9
361316816,ga4gh/dockstore,01/09/18 20:15,spirals-bears,cbc977a0-20a7-4a06-bcfb-bc20c5ff9a19_04-18-week1-FAILING_AND_PASSING,9,2,11
359163549,visallo/vertexium,01/09/18 20:16,spirals-bears,cbc977a0-20a7-4a06-bcfb-bc20c5ff9a19_04-18-week1-FAILING_AND_PASSING,12,150,7,0,0,0,0,169
361316624,ga4gh/dockstore,01/09/18 20:16,spirals-bears,cbc977a0-20a7-4a06-bcfb-bc20c5ff9a19_04-18-week1-FAILING_AND_PASSING,11,0,11
360978814,atomix/atomix,01/09/18 20:22,spirals-bears,cbc977a0-20a7-4a06-bcfb-bc20c5ff9a19_04-18-week1-FAILING_AND_PASSING,245,95,11,0,0,0,0,351
361964447,apache/incubator-dubbo,01/09/18 20:27,spirals-bears,cbc977a0-20a7-4a06-bcfb-bc20c5ff9a19_04-18-week1-FAILING_AND_PASSING,203,557,8,0,6,2,0,776
361486237,airlift/airlift,01/09/18 20:27,spirals-bears,cbc977a0-20a7-4a06-bcfb-bc20c5ff9a19_04-18-week1-FAILING_AND_PASSING,12,3,15
363358471,openzipkin/zipkin,01/09/18 20:28,spirals-bears,cbc977a0-20a7-4a06-bcfb-bc20c5ff9a19_04-18-week1-FAILING_AND_PASSING,25,2,27
360413155,pgjdbc/pgjdbc,01/09/18 20:28,spirals-bears,cbc977a0-20a7-4a06-bcfb-bc20c5ff9a19_04-18-week1-FAILING_AND_PASSING,8,3,11
363031845,geoserver/geoserver,01/09/18 20:32,spirals-bears,cbc977a0-20a7-4a06-bcfb-bc20c5ff9a19_04-18-week1-FAILING_AND_PASSING,155,55,0,5,1,216
357641732,atomix/atomix,01/09/18 20:33,spirals-bears,cbc977a0-20a7-4a06-bcfb-bc20c5ff9a19_04-18-week1-FAILING_AND_PASSING,9,1,0,0,6,0,0,2,0,232,0,73,0,256,97,11,2,0,689
362685093,geoserver/geoserver,01/09/18 20:35,spirals-bears,cbc977a0-20a7-4a06-bcfb-bc20c5ff9a19_04-18-week1-FAILING_AND_PASSING,123,59,0,6,1,189
362047714,geoserver/geoserver,01/09/18 20:39,spirals-bears,cbc977a0-20a7-4a06-bcfb-bc20c5ff9a19_04-18-week1-FAILING_AND_PASSING,140,60,0,7,2,209
362006047,molgenis/molgenis,01/09/18 20:39,spirals-bears,cbc977a0-20a7-4a06-bcfb-bc20c5ff9a19_04-18-week1-FAILING_AND_PASSING,9,72,0,9,13,1,1,64,0,1002,0,425,5,76,717,46,113,1,2554
361734106,geoserver/geoserver,01/09/18 20:42,spirals-bears,cbc977a0-20a7-4a06-bcfb-bc20c5ff9a19_04-18-week1-FAILING_AND_PASSING,128,53,0,5,1,187
362581199,aicis/fresco,01/09/18 21:02,spirals-bears,cbc977a0-20a7-4a06-bcfb-bc20c5ff9a19_04-18-week1-FAILING_AND_PASSING,1246,97,10,0,2,1,0,1356
359862797,geoserver/geoserver,01/09/18 21:03,spirals-bears,cbc977a0-20a7-4a06-bcfb-bc20c5ff9a19_04-18-week1-FAILING_AND_PASSING,16,0,4,0,0,27,0,469,33,1,518,631,57,0,1756
363129291,swagger-api/swagger-codegen,01/09/18 21:04,spirals-bears,cbc977a0-20a7-4a06-bcfb-bc20c5ff9a19_04-18-week1-FAILING_AND_PASSING,33,0,33
362050781,aicis/fresco,01/09/18 21:04,spirals-bears,cbc977a0-20a7-4a06-bcfb-bc20c5ff9a19_04-18-week1-FAILING_AND_PASSING,1188,95,9,0,0,0,0,1292
362556309,swagger-api/swagger-codegen,01/09/18 21:05,spirals-bears,cbc977a0-20a7-4a06-bcfb-bc20c5ff9a19_04-18-week1-FAILING_AND_PASSING,35,0,35
361693364,swagger-api/swagger-codegen,01/09/18 21:05,spirals-bears,cbc977a0-20a7-4a06-bcfb-bc20c5ff9a19_04-18-week1-FAILING_AND_PASSING,33,5,38
361675708,rabbitmq/rabbitmq-perf-test,01/09/18 21:07,spirals-bears,cbc977a0-20a7-4a06-bcfb-bc20c5ff9a19_04-18-week1-FAILING_AND_PASSING,51,23,3,0,0,0,0,77
363322032,spring-cloud/spring-cloud-gcp,01/09/18 21:07,spirals-bears,cbc977a0-20a7-4a06-bcfb-bc20c5ff9a19_04-18-week1-FAILING_AND_PASSING,4,2,6
363151469,spring-cloud/spring-cloud-gcp,01/09/18 21:07,spirals-bears,cbc977a0-20a7-4a06-bcfb-bc20c5ff9a19_04-18-week1-FAILING_AND_PASSING,4,3,7
362703761,swagger-api/swagger-codegen,01/09/18 21:09,spirals-bears,cbc977a0-20a7-4a06-bcfb-bc20c5ff9a19_04-18-week1-FAILING_AND_PASSING,51,218,33,0,16,1,0,319
362693009,spring-cloud/spring-cloud-gcp,01/09/18 21:10,spirals-bears,cbc977a0-20a7-4a06-bcfb-bc20c5ff9a19_04-18-week1-FAILING_AND_PASSING,4,2,6
361407050,spring-cloud/spring-cloud-gcp,01/09/18 21:10,spirals-bears,cbc977a0-20a7-4a06-bcfb-bc20c5ff9a19_04-18-week1-FAILING_AND_PASSING,4,2,6
362762948,spring-cloud/spring-cloud-gcp,01/09/18 21:20,spirals-bears,cbc977a0-20a7-4a06-bcfb-bc20c5ff9a19_04-18-week1-FAILING_AND_PASSING,86,418,5,104,0,105,0,718
360434612,spring-cloud/spring-cloud-gcp,01/09/18 21:20,spirals-bears,cbc977a0-20a7-4a06-bcfb-bc20c5ff9a19_04-18-week1-FAILING_AND_PASSING,5,2,7
361209855,spring-cloud/spring-cloud-gcp,01/09/18 21:22,spirals-bears,cbc977a0-20a7-4a06-bcfb-bc20c5ff9a19_04-18-week1-FAILING_AND_PASSING,68,421,4,115,0,116,0,724
361355673,RipMeApp/ripme,01/09/18 21:22,spirals-bears,cbc977a0-20a7-4a06-bcfb-bc20c5ff9a19_04-18-week1-FAILING_AND_PASSING,136,4,0,0,0,140
362683093,datastax/java-driver,01/09/18 21:23,spirals-bears,cbc977a0-20a7-4a06-bcfb-bc20c5ff9a19_04-18-week1-FAILING_AND_PASSING,16,3,19
362326704,datastax/java-driver,01/09/18 21:23,spirals-bears,cbc977a0-20a7-4a06-bcfb-bc20c5ff9a19_04-18-week1-FAILING_AND_PASSING,24,3,27
360490557,datastax/java-driver,01/09/18 21:24,spirals-bears,cbc977a0-20a7-4a06-bcfb-bc20c5ff9a19_04-18-week1-FAILING_AND_PASSING,17,0,17
361735265,datastax/java-driver,01/09/18 21:24,spirals-bears,cbc977a0-20a7-4a06-bcfb-bc20c5ff9a19_04-18-week1-FAILING_AND_PASSING,17,3,20
361291602,datastax/java-driver,01/09/18 21:25,spirals-bears,cbc977a0-20a7-4a06-bcfb-bc20c5ff9a19_04-18-week1-FAILING_AND_PASSING,17,0,17
361217121,datastax/java-driver,01/09/18 21:25,spirals-bears,cbc977a0-20a7-4a06-bcfb-bc20c5ff9a19_04-18-week1-FAILING_AND_PASSING,15,3,18
360878614,SzFMV2018-Tavasz/AutomatedCar,01/09/18 21:27,spirals-bears,cbc977a0-20a7-4a06-bcfb-bc20c5ff9a19_04-18-week1-FAILING_AND_PASSING,9,0,0,0,0,0,0,10,8,0,11,20,9,0,67
361647765,apache/jackrabbit-oak,01/09/18 21:32,spirals-bears,cbc977a0-20a7-4a06-bcfb-bc20c5ff9a19_04-18-week1-FAILING_AND_PASSING,8,0,2,0,2,11,0,1784,374,0,1864,466,36,1,4548
357681862,RipMeApp/ripme,01/09/18 21:32,spirals-bears,cbc977a0-20a7-4a06-bcfb-bc20c5ff9a19_04-18-week1-FAILING_AND_PASSING,7,0,0,0,0,0,0,236,10,0,281,22,6,0,562
363495078,jcabi/jcabi-github,01/09/18 21:32,spirals-bears,cbc977a0-20a7-4a06-bcfb-bc20c5ff9a19_04-18-week1-FAILING_AND_PASSING,42,260,21,0,0,0,0,323
362601872,dhis2/dhis2-core,01/09/18 21:33,spirals-bears,cbc977a0-20a7-4a06-bcfb-bc20c5ff9a19_04-18-week1-FAILING_AND_PASSING,27,3,30
361689377,aicis/fresco,01/09/18 21:33,spirals-bears,cbc977a0-20a7-4a06-bcfb-bc20c5ff9a19_04-18-week1-FAILING_AND_PASSING,9,6,0,0,7,0,0,4,0,1296,0,36,0,364,91,9,8,0,1830
362607700,dhis2/dhis2-core,01/09/18 21:35,spirals-bears,cbc977a0-20a7-4a06-bcfb-bc20c5ff9a19_04-18-week1-FAILING_AND_PASSING,99,22,0,1,0,122
360772719,FrankSauve/345BudgetApp,01/09/18 21:35,spirals-bears,cbc977a0-20a7-4a06-bcfb-bc20c5ff9a19_04-18-week1-FAILING_AND_PASSING,3,0,3
361005316,2018swecapstone/h2ms,01/09/18 21:35,spirals-bears,cbc977a0-20a7-4a06-bcfb-bc20c5ff9a19_04-18-week1-FAILING_AND_PASSING,53,66,3,0,3,1,0,126
362206555,Spirals-Team/repairnator,01/09/18 21:36,spirals-bears,cbc977a0-20a7-4a06-bcfb-bc20c5ff9a19_04-18-week1-FAILING_AND_PASSING,18,0,18
361926644,jacoco/jacoco,01/09/18 21:36,spirals-bears,cbc977a0-20a7-4a06-bcfb-bc20c5ff9a19_04-18-week1-FAILING_AND_PASSING,6,2,8
361926623,jacoco/jacoco,01/09/18 21:36,spirals-bears,cbc977a0-20a7-4a06-bcfb-bc20c5ff9a19_04-18-week1-FAILING_AND_PASSING,6,0,6
361879230,jacoco/jacoco,01/09/18 21:37,spirals-bears,cbc977a0-20a7-4a06-bcfb-bc20c5ff9a19_04-18-week1-FAILING_AND_PASSING,7,2,9
361878957,jacoco/jacoco,01/09/18 21:37,spirals-bears,cbc977a0-20a7-4a06-bcfb-bc20c5ff9a19_04-18-week1-FAILING_AND_PASSING,7,0,7
361579381,jacoco/jacoco,01/09/18 21:37,spirals-bears,cbc977a0-20a7-4a06-bcfb-bc20c5ff9a19_04-18-week1-FAILING_AND_PASSING,5,2,7
361579337,jacoco/jacoco,01/09/18 21:37,spirals-bears,cbc977a0-20a7-4a06-bcfb-bc20c5ff9a19_04-18-week1-FAILING_AND_PASSING,6,0,6
362171858,jcabi/jcabi-github,01/09/18 21:38,spirals-bears,cbc977a0-20a7-4a06-bcfb-bc20c5ff9a19_04-18-week1-FAILING_AND_PASSING,42,286,20,0,0,0,0,348
360795020,jnidzwetzki/bboxdb,01/09/18 21:38,spirals-bears,cbc977a0-20a7-4a06-bcfb-bc20c5ff9a19_04-18-week1-FAILING_AND_PASSING,5,0,0,0,0,1,0,34,15,0,36,72,11,0,174
361513844,MariaDB/mariadb-connector-j,01/09/18 22:34,spirals-bears,cbc977a0-20a7-4a06-bcfb-bc20c5ff9a19_04-18-week1-FAILING_AND_PASSING,11,0,0,0,0,1,0,1815,31,0,1818,64,8,0,3748
