365490264,apache/flink,03/09/18 00:22,spirals-bears,0c1dbb4d-1cbc-485c-8949-10b1e9ab500a_04-18-week2-PASSING_AND_PASSING,66,8,74
365621213,apache/flink,03/09/18 00:27,spirals-bears,0c1dbb4d-1cbc-485c-8949-10b1e9ab500a_04-18-week2-PASSING_AND_PASSING,67,0,1,1,265,2,336
364522436,apache/flink,03/09/18 01:07,spirals-bears,0c1dbb4d-1cbc-485c-8949-10b1e9ab500a_04-18-week2-PASSING_AND_PASSING,20,0,1,57,2,229,0,10,1,666,2,62,69,1638,2757
364522261,apache/flink,03/09/18 01:07,spirals-bears,0c1dbb4d-1cbc-485c-8949-10b1e9ab500a_04-18-week2-PASSING_AND_PASSING,18,0,2,74,1,179,1,6,5,619,1,83,84,1603,2676
261262689,apache/flink,03/09/18 01:09,spirals-bears,0c1dbb4d-1cbc-485c-8949-10b1e9ab500a_04-18-week2-PASSING_AND_PASSING,66,0,2,5,8,81
364021259,apache/flink,03/09/18 01:09,spirals-bears,0c1dbb4d-1cbc-485c-8949-10b1e9ab500a_04-18-week2-PASSING_AND_PASSING,69,0,1,5,7,82
365801346,prestodb/presto,03/09/18 01:10,spirals-bears,0c1dbb4d-1cbc-485c-8949-10b1e9ab500a_04-18-week2-PASSING_AND_PASSING,46,4,50
366060494,prestodb/presto,03/09/18 01:10,spirals-bears,0c1dbb4d-1cbc-485c-8949-10b1e9ab500a_04-18-week2-PASSING_AND_PASSING,46,6,52
365853940,apache/flink,03/09/18 01:11,spirals-bears,0c1dbb4d-1cbc-485c-8949-10b1e9ab500a_04-18-week2-PASSING_AND_PASSING,24,0,2,62,0,2,224,0,56,4,2,791,1,63,111,1646,2988
363394633,prestodb/presto,03/09/18 01:12,spirals-bears,0c1dbb4d-1cbc-485c-8949-10b1e9ab500a_04-18-week2-PASSING_AND_PASSING,47,9,56
363080370,prestodb/presto,03/09/18 01:12,spirals-bears,0c1dbb4d-1cbc-485c-8949-10b1e9ab500a_04-18-week2-PASSING_AND_PASSING,47,9,56
365298740,prestodb/presto,03/09/18 01:13,spirals-bears,0c1dbb4d-1cbc-485c-8949-10b1e9ab500a_04-18-week2-PASSING_AND_PASSING,45,0,1,1,68,1,116
363107539,apache/flink,03/09/18 01:15,spirals-bears,0c1dbb4d-1cbc-485c-8949-10b1e9ab500a_04-18-week2-PASSING_AND_PASSING,15,0,2,107,0,2,150,0,48,5,2,781,1,59,83,1625,2880
364452873,prestodb/presto,03/09/18 01:16,spirals-bears,0c1dbb4d-1cbc-485c-8949-10b1e9ab500a_04-18-week2-PASSING_AND_PASSING,43,9,52
364950620,prestodb/presto,03/09/18 01:17,spirals-bears,0c1dbb4d-1cbc-485c-8949-10b1e9ab500a_04-18-week2-PASSING_AND_PASSING,46,5,51
364454381,prestodb/presto,03/09/18 01:18,spirals-bears,0c1dbb4d-1cbc-485c-8949-10b1e9ab500a_04-18-week2-PASSING_AND_PASSING,44,5,49
364739655,prestodb/presto,03/09/18 01:19,spirals-bears,0c1dbb4d-1cbc-485c-8949-10b1e9ab500a_04-18-week2-PASSING_AND_PASSING,46,6,52
365298018,prestodb/presto,03/09/18 01:44,spirals-bears,0c1dbb4d-1cbc-485c-8949-10b1e9ab500a_04-18-week2-PASSING_AND_PASSING,42,0,901,1,0,961,1,1906
365045467,prestodb/presto,03/09/18 01:44,spirals-bears,0c1dbb4d-1cbc-485c-8949-10b1e9ab500a_04-18-week2-PASSING_AND_PASSING,50,0,878,1,2,974,1,1906
364922015,prestodb/presto,03/09/18 01:45,spirals-bears,0c1dbb4d-1cbc-485c-8949-10b1e9ab500a_04-18-week2-PASSING_AND_PASSING,45,0,825,1,1,994,1,1867
364358652,prestodb/presto,03/09/18 01:45,spirals-bears,0c1dbb4d-1cbc-485c-8949-10b1e9ab500a_04-18-week2-PASSING_AND_PASSING,46,4,50
364423750,prestodb/presto,03/09/18 01:45,spirals-bears,0c1dbb4d-1cbc-485c-8949-10b1e9ab500a_04-18-week2-PASSING_AND_PASSING,60,5,65
364390400,prestodb/presto,03/09/18 01:46,spirals-bears,0c1dbb4d-1cbc-485c-8949-10b1e9ab500a_04-18-week2-PASSING_AND_PASSING,41,4,45
364354772,prestodb/presto,03/09/18 01:46,spirals-bears,0c1dbb4d-1cbc-485c-8949-10b1e9ab500a_04-18-week2-PASSING_AND_PASSING,42,4,46
362838552,prestodb/presto,03/09/18 01:47,spirals-bears,0c1dbb4d-1cbc-485c-8949-10b1e9ab500a_04-18-week2-PASSING_AND_PASSING,44,3,47
364353720,prestodb/presto,03/09/18 01:49,spirals-bears,0c1dbb4d-1cbc-485c-8949-10b1e9ab500a_04-18-week2-PASSING_AND_PASSING,44,0,1,0,195,1,241
364317843,prestodb/presto,03/09/18 01:49,spirals-bears,0c1dbb4d-1cbc-485c-8949-10b1e9ab500a_04-18-week2-PASSING_AND_PASSING,51,0,1,1,118,1,172
365899787,apache/incubator-druid,03/09/18 01:50,spirals-bears,0c1dbb4d-1cbc-485c-8949-10b1e9ab500a_04-18-week2-PASSING_AND_PASSING,37,4,41
364523986,prestodb/presto,03/09/18 01:51,spirals-bears,0c1dbb4d-1cbc-485c-8949-10b1e9ab500a_04-18-week2-PASSING_AND_PASSING,51,0,797,1,1,1033,3,1886
364308297,apache/incubator-druid,03/09/18 01:52,spirals-bears,0c1dbb4d-1cbc-485c-8949-10b1e9ab500a_04-18-week2-PASSING_AND_PASSING,37,4,41
338672537,apache/incubator-druid,03/09/18 01:53,spirals-bears,0c1dbb4d-1cbc-485c-8949-10b1e9ab500a_04-18-week2-PASSING_AND_PASSING,38,0,1,7,128,10,184
365882499,apache/incubator-druid,03/09/18 01:54,spirals-bears,0c1dbb4d-1cbc-485c-8949-10b1e9ab500a_04-18-week2-PASSING_AND_PASSING,44,0,2,6,133,15,200
365388708,apache/incubator-druid,03/09/18 01:54,spirals-bears,0c1dbb4d-1cbc-485c-8949-10b1e9ab500a_04-18-week2-PASSING_AND_PASSING,37,11,48
364890604,apache/incubator-druid,03/09/18 01:55,spirals-bears,0c1dbb4d-1cbc-485c-8949-10b1e9ab500a_04-18-week2-PASSING_AND_PASSING,41,12,53
365267018,apache/incubator-druid,03/09/18 01:59,spirals-bears,0c1dbb4d-1cbc-485c-8949-10b1e9ab500a_04-18-week2-PASSING_AND_PASSING,36,0,1,6,269,15,327
364735374,apache/incubator-druid,03/09/18 02:04,spirals-bears,0c1dbb4d-1cbc-485c-8949-10b1e9ab500a_04-18-week2-PASSING_AND_PASSING,37,0,1,0,208,8,254
364280863,prestodb/presto,03/09/18 02:16,spirals-bears,0c1dbb4d-1cbc-485c-8949-10b1e9ab500a_04-18-week2-PASSING_AND_PASSING,43,0,778,1,2,877,1,1702
365764597,apache/incubator-druid,03/09/18 02:28,spirals-bears,0c1dbb4d-1cbc-485c-8949-10b1e9ab500a_04-18-week2-PASSING_AND_PASSING,38,0,1119,1,0,956,2,2116
365702526,apache/incubator-druid,03/09/18 02:32,spirals-bears,0c1dbb4d-1cbc-485c-8949-10b1e9ab500a_04-18-week2-PASSING_AND_PASSING,37,0,1218,1,0,937,3,2196
364712119,apache/incubator-druid,03/09/18 02:32,spirals-bears,0c1dbb4d-1cbc-485c-8949-10b1e9ab500a_04-18-week2-PASSING_AND_PASSING,35,0,1133,1,0,535,2,1706
363787274,apache/incubator-druid,03/09/18 02:34,spirals-bears,0c1dbb4d-1cbc-485c-8949-10b1e9ab500a_04-18-week2-PASSING_AND_PASSING,48,12,60
364437796,apache/incubator-druid,03/09/18 03:01,spirals-bears,0c1dbb4d-1cbc-485c-8949-10b1e9ab500a_04-18-week2-PASSING_AND_PASSING,40,0,1090,1,0,517,3,1651
364712016,apache/incubator-druid,03/09/18 03:02,spirals-bears,0c1dbb4d-1cbc-485c-8949-10b1e9ab500a_04-18-week2-PASSING_AND_PASSING,37,0,1133,2,0,539,2,1713
363937094,apache/incubator-druid,03/09/18 03:05,spirals-bears,0c1dbb4d-1cbc-485c-8949-10b1e9ab500a_04-18-week2-PASSING_AND_PASSING,60,0,1,5,6,72
361900988,apache/incubator-druid,03/09/18 03:07,spirals-bears,0c1dbb4d-1cbc-485c-8949-10b1e9ab500a_04-18-week2-PASSING_AND_PASSING,39,0,1,6,131,14,191
365004476,thelastpickle/cassandra-reaper,03/09/18 03:07,spirals-bears,0c1dbb4d-1cbc-485c-8949-10b1e9ab500a_04-18-week2-PASSING_AND_PASSING,8,0,8
365004502,thelastpickle/cassandra-reaper,03/09/18 03:08,spirals-bears,0c1dbb4d-1cbc-485c-8949-10b1e9ab500a_04-18-week2-PASSING_AND_PASSING,7,2,9
365484062,thelastpickle/cassandra-reaper,03/09/18 03:10,spirals-bears,0c1dbb4d-1cbc-485c-8949-10b1e9ab500a_04-18-week2-PASSING_AND_PASSING,10,5,0,0,9,46,0,0,8,0,44,0,0,0,45,0,8,6,6,71,258
364595071,thelastpickle/cassandra-reaper,03/09/18 03:11,spirals-bears,0c1dbb4d-1cbc-485c-8949-10b1e9ab500a_04-18-week2-PASSING_AND_PASSING,7,0,0,0,47,0,54
355933044,thelastpickle/cassandra-reaper,03/09/18 03:13,spirals-bears,0c1dbb4d-1cbc-485c-8949-10b1e9ab500a_04-18-week2-PASSING_AND_PASSING,24,21,45
364710673,thelastpickle/cassandra-reaper,03/09/18 03:13,spirals-bears,0c1dbb4d-1cbc-485c-8949-10b1e9ab500a_04-18-week2-PASSING_AND_PASSING,9,20,0,0,7,44,0,0,5,0,58,0,0,0,57,0,7,24,6,70,307
357362910,thelastpickle/cassandra-reaper,03/09/18 03:13,spirals-bears,0c1dbb4d-1cbc-485c-8949-10b1e9ab500a_04-18-week2-PASSING_AND_PASSING,8,3,11
357362847,thelastpickle/cassandra-reaper,03/09/18 03:13,spirals-bears,0c1dbb4d-1cbc-485c-8949-10b1e9ab500a_04-18-week2-PASSING_AND_PASSING,7,0,7
363635682,JMRI/JMRI,03/09/18 03:22,spirals-bears,0c1dbb4d-1cbc-485c-8949-10b1e9ab500a_04-18-week2-PASSING_AND_PASSING,359,0,0,12,96,64,531
363537848,apache/nifi,03/09/18 03:24,spirals-bears,0c1dbb4d-1cbc-485c-8949-10b1e9ab500a_04-18-week2-PASSING_AND_PASSING,38,1,3,7,8,57
364387515,apache/incubator-druid,03/09/18 03:36,spirals-bears,0c1dbb4d-1cbc-485c-8949-10b1e9ab500a_04-18-week2-PASSING_AND_PASSING,9,0,0,2009,8,1,46,0,150,1,4,412,0,37,17,988,3682
360660551,apache/nifi,03/09/18 03:38,spirals-bears,0c1dbb4d-1cbc-485c-8949-10b1e9ab500a_04-18-week2-PASSING_AND_PASSING,62,1,3,6,9,81
364451991,JMRI/JMRI,03/09/18 03:40,spirals-bears,0c1dbb4d-1cbc-485c-8949-10b1e9ab500a_04-18-week2-PASSING_AND_PASSING,314,0,1186,0,5,107,4,1616
364177295,apache/nifi,03/09/18 03:41,spirals-bears,0c1dbb4d-1cbc-485c-8949-10b1e9ab500a_04-18-week2-PASSING_AND_PASSING,37,5,42
363846584,apache/nifi,03/09/18 03:42,spirals-bears,0c1dbb4d-1cbc-485c-8949-10b1e9ab500a_04-18-week2-PASSING_AND_PASSING,34,1,3,5,7,50
364126967,apache/nifi,03/09/18 03:45,spirals-bears,0c1dbb4d-1cbc-485c-8949-10b1e9ab500a_04-18-week2-PASSING_AND_PASSING,35,1,3,1,126,1,167
365216780,apache/nifi,03/09/18 03:49,spirals-bears,0c1dbb4d-1cbc-485c-8949-10b1e9ab500a_04-18-week2-PASSING_AND_PASSING,35,1,4,1,1443,2,1486
361690363,apache/nifi,03/09/18 03:49,spirals-bears,0c1dbb4d-1cbc-485c-8949-10b1e9ab500a_04-18-week2-PASSING_AND_PASSING,35,1,3,8,175,9,231
364427926,apache/incubator-druid,03/09/18 03:50,spirals-bears,0c1dbb4d-1cbc-485c-8949-10b1e9ab500a_04-18-week2-PASSING_AND_PASSING,9,0,1,1942,0,1,57,0,1493,1,3,417,0,47,19,1639,5629
365740066,INRIA/spoon,03/09/18 03:51,spirals-bears,0c1dbb4d-1cbc-485c-8949-10b1e9ab500a_04-18-week2-PASSING_AND_PASSING,10,0,0,0,47,1,58
365683364,INRIA/spoon,03/09/18 03:52,spirals-bears,0c1dbb4d-1cbc-485c-8949-10b1e9ab500a_04-18-week2-PASSING_AND_PASSING,10,0,0,0,48,0,58
364794763,apache/nifi,03/09/18 04:05,spirals-bears,0c1dbb4d-1cbc-485c-8949-10b1e9ab500a_04-18-week2-PASSING_AND_PASSING,39,1,4,1,1512,1,1558
366096610,EnMasseProject/enmasse,03/09/18 04:05,spirals-bears,0c1dbb4d-1cbc-485c-8949-10b1e9ab500a_04-18-week2-PASSING_AND_PASSING,28,0,28
365575850,EnMasseProject/enmasse,03/09/18 04:06,spirals-bears,0c1dbb4d-1cbc-485c-8949-10b1e9ab500a_04-18-week2-PASSING_AND_PASSING,27,3,30
364092376,EnMasseProject/enmasse,03/09/18 04:07,spirals-bears,0c1dbb4d-1cbc-485c-8949-10b1e9ab500a_04-18-week2-PASSING_AND_PASSING,26,0,26
363067725,EnMasseProject/enmasse,03/09/18 04:08,spirals-bears,0c1dbb4d-1cbc-485c-8949-10b1e9ab500a_04-18-week2-PASSING_AND_PASSING,27,0,1,1,55,1,85
364024436,EnMasseProject/enmasse,03/09/18 04:09,spirals-bears,0c1dbb4d-1cbc-485c-8949-10b1e9ab500a_04-18-week2-PASSING_AND_PASSING,26,0,26
364019722,EnMasseProject/enmasse,03/09/18 04:10,spirals-bears,0c1dbb4d-1cbc-485c-8949-10b1e9ab500a_04-18-week2-PASSING_AND_PASSING,60,3,63
364019698,EnMasseProject/enmasse,03/09/18 04:11,spirals-bears,0c1dbb4d-1cbc-485c-8949-10b1e9ab500a_04-18-week2-PASSING_AND_PASSING,25,0,25
363364708,apache/nifi,03/09/18 04:11,spirals-bears,0c1dbb4d-1cbc-485c-8949-10b1e9ab500a_04-18-week2-PASSING_AND_PASSING,36,1,3,1,1274,2,1317
365683776,INRIA/spoon,03/09/18 04:11,spirals-bears,0c1dbb4d-1cbc-485c-8949-10b1e9ab500a_04-18-week2-PASSING_AND_PASSING,8,0,0,559,0,0,5,0,579,0,0,19,0,10,5,62,1247
363986576,EnMasseProject/enmasse,03/09/18 04:11,spirals-bears,0c1dbb4d-1cbc-485c-8949-10b1e9ab500a_04-18-week2-PASSING_AND_PASSING,25,0,25
362518401,EnMasseProject/enmasse,03/09/18 04:12,spirals-bears,0c1dbb4d-1cbc-485c-8949-10b1e9ab500a_04-18-week2-PASSING_AND_PASSING,27,0,27
365683140,INRIA/spoon,03/09/18 04:12,spirals-bears,0c1dbb4d-1cbc-485c-8949-10b1e9ab500a_04-18-week2-PASSING_AND_PASSING,8,0,0,544,0,0,5,0,551,0,0,18,0,10,7,61,1204
366393065,batfish/batfish,03/09/18 04:12,spirals-bears,0c1dbb4d-1cbc-485c-8949-10b1e9ab500a_04-18-week2-PASSING_AND_PASSING,57,0,57
366393072,batfish/batfish,03/09/18 04:12,spirals-bears,0c1dbb4d-1cbc-485c-8949-10b1e9ab500a_04-18-week2-PASSING_AND_PASSING,54,4,58
366320321,batfish/batfish,03/09/18 04:13,spirals-bears,0c1dbb4d-1cbc-485c-8949-10b1e9ab500a_04-18-week2-PASSING_AND_PASSING,59,0,59
366320519,batfish/batfish,03/09/18 04:14,spirals-bears,0c1dbb4d-1cbc-485c-8949-10b1e9ab500a_04-18-week2-PASSING_AND_PASSING,75,3,78
365813334,batfish/batfish,03/09/18 04:15,spirals-bears,0c1dbb4d-1cbc-485c-8949-10b1e9ab500a_04-18-week2-PASSING_AND_PASSING,74,3,77
365813279,batfish/batfish,03/09/18 04:15,spirals-bears,0c1dbb4d-1cbc-485c-8949-10b1e9ab500a_04-18-week2-PASSING_AND_PASSING,54,0,54
366389491,batfish/batfish,03/09/18 04:16,spirals-bears,0c1dbb4d-1cbc-485c-8949-10b1e9ab500a_04-18-week2-PASSING_AND_PASSING,57,0,7,0,0,155,0,3,222
365812969,batfish/batfish,03/09/18 04:16,spirals-bears,0c1dbb4d-1cbc-485c-8949-10b1e9ab500a_04-18-week2-PASSING_AND_PASSING,51,0,51
365817926,batfish/batfish,03/09/18 04:16,spirals-bears,0c1dbb4d-1cbc-485c-8949-10b1e9ab500a_04-18-week2-PASSING_AND_PASSING,56,0,7,1,1,153,0,1,219
365723365,batfish/batfish,03/09/18 04:17,spirals-bears,0c1dbb4d-1cbc-485c-8949-10b1e9ab500a_04-18-week2-PASSING_AND_PASSING,57,0,57
365723384,batfish/batfish,03/09/18 04:17,spirals-bears,0c1dbb4d-1cbc-485c-8949-10b1e9ab500a_04-18-week2-PASSING_AND_PASSING,56,2,58
365373058,batfish/batfish,03/09/18 04:18,spirals-bears,0c1dbb4d-1cbc-485c-8949-10b1e9ab500a_04-18-week2-PASSING_AND_PASSING,81,0,81
365810622,batfish/batfish,03/09/18 04:19,spirals-bears,0c1dbb4d-1cbc-485c-8949-10b1e9ab500a_04-18-week2-PASSING_AND_PASSING,56,0,8,0,0,153,0,1,218
365302746,batfish/batfish,03/09/18 04:19,spirals-bears,0c1dbb4d-1cbc-485c-8949-10b1e9ab500a_04-18-week2-PASSING_AND_PASSING,55,4,59
365354481,batfish/batfish,03/09/18 04:20,spirals-bears,0c1dbb4d-1cbc-485c-8949-10b1e9ab500a_04-18-week2-PASSING_AND_PASSING,54,0,54
365350191,batfish/batfish,03/09/18 04:20,spirals-bears,0c1dbb4d-1cbc-485c-8949-10b1e9ab500a_04-18-week2-PASSING_AND_PASSING,53,3,56
365338757,batfish/batfish,03/09/18 04:20,spirals-bears,0c1dbb4d-1cbc-485c-8949-10b1e9ab500a_04-18-week2-PASSING_AND_PASSING,51,0,1,0,117,1,170
365360557,batfish/batfish,03/09/18 04:20,spirals-bears,0c1dbb4d-1cbc-485c-8949-10b1e9ab500a_04-18-week2-PASSING_AND_PASSING,51,0,6,0,0,156,0,3,216
365302720,batfish/batfish,03/09/18 04:21,spirals-bears,0c1dbb4d-1cbc-485c-8949-10b1e9ab500a_04-18-week2-PASSING_AND_PASSING,59,0,59
365350187,batfish/batfish,03/09/18 04:21,spirals-bears,0c1dbb4d-1cbc-485c-8949-10b1e9ab500a_04-18-week2-PASSING_AND_PASSING,50,0,50
365254902,batfish/batfish,03/09/18 04:21,spirals-bears,0c1dbb4d-1cbc-485c-8949-10b1e9ab500a_04-18-week2-PASSING_AND_PASSING,55,3,58
365254891,batfish/batfish,03/09/18 04:21,spirals-bears,0c1dbb4d-1cbc-485c-8949-10b1e9ab500a_04-18-week2-PASSING_AND_PASSING,52,0,52
365298109,batfish/batfish,03/09/18 04:22,spirals-bears,0c1dbb4d-1cbc-485c-8949-10b1e9ab500a_04-18-week2-PASSING_AND_PASSING,55,0,55
364930990,batfish/batfish,03/09/18 04:22,spirals-bears,0c1dbb4d-1cbc-485c-8949-10b1e9ab500a_04-18-week2-PASSING_AND_PASSING,55,0,55
365301803,batfish/batfish,03/09/18 04:23,spirals-bears,0c1dbb4d-1cbc-485c-8949-10b1e9ab500a_04-18-week2-PASSING_AND_PASSING,53,0,2,0,47,1,103
364932809,batfish/batfish,03/09/18 04:23,spirals-bears,0c1dbb4d-1cbc-485c-8949-10b1e9ab500a_04-18-week2-PASSING_AND_PASSING,82,3,85
364924636,batfish/batfish,03/09/18 04:23,spirals-bears,0c1dbb4d-1cbc-485c-8949-10b1e9ab500a_04-18-week2-PASSING_AND_PASSING,62,3,65
364763413,batfish/batfish,03/09/18 04:24,spirals-bears,0c1dbb4d-1cbc-485c-8949-10b1e9ab500a_04-18-week2-PASSING_AND_PASSING,51,0,2,0,47,1,101
363585998,batfish/batfish,03/09/18 04:24,spirals-bears,0c1dbb4d-1cbc-485c-8949-10b1e9ab500a_04-18-week2-PASSING_AND_PASSING,56,3,59
364462754,batfish/batfish,03/09/18 04:24,spirals-bears,0c1dbb4d-1cbc-485c-8949-10b1e9ab500a_04-18-week2-PASSING_AND_PASSING,55,0,55
364462864,batfish/batfish,03/09/18 04:25,spirals-bears,0c1dbb4d-1cbc-485c-8949-10b1e9ab500a_04-18-week2-PASSING_AND_PASSING,54,3,57
364393049,batfish/batfish,03/09/18 04:25,spirals-bears,0c1dbb4d-1cbc-485c-8949-10b1e9ab500a_04-18-week2-PASSING_AND_PASSING,50,0,50
364393151,batfish/batfish,03/09/18 04:26,spirals-bears,0c1dbb4d-1cbc-485c-8949-10b1e9ab500a_04-18-week2-PASSING_AND_PASSING,50,2,52
364761256,batfish/batfish,03/09/18 04:26,spirals-bears,0c1dbb4d-1cbc-485c-8949-10b1e9ab500a_04-18-week2-PASSING_AND_PASSING,49,0,7,1,0,150,0,3,210
364359263,batfish/batfish,03/09/18 04:28,spirals-bears,0c1dbb4d-1cbc-485c-8949-10b1e9ab500a_04-18-week2-PASSING_AND_PASSING,54,0,9,0,0,160,0,2,225
364276057,batfish/batfish,03/09/18 04:28,spirals-bears,0c1dbb4d-1cbc-485c-8949-10b1e9ab500a_04-18-week2-PASSING_AND_PASSING,60,0,1,0,52,2,115
364002190,batfish/batfish,03/09/18 04:29,spirals-bears,0c1dbb4d-1cbc-485c-8949-10b1e9ab500a_04-18-week2-PASSING_AND_PASSING,51,2,53
364226557,batfish/batfish,03/09/18 04:29,spirals-bears,0c1dbb4d-1cbc-485c-8949-10b1e9ab500a_04-18-week2-PASSING_AND_PASSING,51,0,1,0,114,1,167
364357879,batfish/batfish,03/09/18 04:29,spirals-bears,0c1dbb4d-1cbc-485c-8949-10b1e9ab500a_04-18-week2-PASSING_AND_PASSING,59,0,8,1,0,158,0,2,228
364002175,batfish/batfish,03/09/18 04:29,spirals-bears,0c1dbb4d-1cbc-485c-8949-10b1e9ab500a_04-18-week2-PASSING_AND_PASSING,50,0,50
364265528,batfish/batfish,03/09/18 04:30,spirals-bears,0c1dbb4d-1cbc-485c-8949-10b1e9ab500a_04-18-week2-PASSING_AND_PASSING,50,2,52
363954147,batfish/batfish,03/09/18 04:30,spirals-bears,0c1dbb4d-1cbc-485c-8949-10b1e9ab500a_04-18-week2-PASSING_AND_PASSING,54,0,54
363956417,batfish/batfish,03/09/18 04:31,spirals-bears,0c1dbb4d-1cbc-485c-8949-10b1e9ab500a_04-18-week2-PASSING_AND_PASSING,53,3,56
364265516,batfish/batfish,03/09/18 04:31,spirals-bears,0c1dbb4d-1cbc-485c-8949-10b1e9ab500a_04-18-week2-PASSING_AND_PASSING,68,0,68
363412197,batfish/batfish,03/09/18 04:31,spirals-bears,0c1dbb4d-1cbc-485c-8949-10b1e9ab500a_04-18-week2-PASSING_AND_PASSING,54,4,58
363654318,batfish/batfish,03/09/18 04:33,spirals-bears,0c1dbb4d-1cbc-485c-8949-10b1e9ab500a_04-18-week2-PASSING_AND_PASSING,54,0,2,0,52,2,110
365002092,matsim-org/matsim,03/09/18 04:33,spirals-bears,0c1dbb4d-1cbc-485c-8949-10b1e9ab500a_04-18-week2-PASSING_AND_PASSING,160,0,160
365629156,matsim-org/matsim,03/09/18 04:45,spirals-bears,0c1dbb4d-1cbc-485c-8949-10b1e9ab500a_04-18-week2-PASSING_AND_PASSING,175,0,0,8,615,5,803
365344446,matsim-org/matsim,03/09/18 04:46,spirals-bears,0c1dbb4d-1cbc-485c-8949-10b1e9ab500a_04-18-week2-PASSING_AND_PASSING,183,0,1,1,582,2,769
365499582,matsim-org/matsim,03/09/18 04:46,spirals-bears,0c1dbb4d-1cbc-485c-8949-10b1e9ab500a_04-18-week2-PASSING_AND_PASSING,147,0,1,1,572,1,722
365628486,matsim-org/matsim,03/09/18 05:00,spirals-bears,0c1dbb4d-1cbc-485c-8949-10b1e9ab500a_04-18-week2-PASSING_AND_PASSING,159,0,0,1,1599,1,1760
365114082,matsim-org/matsim,03/09/18 05:14,spirals-bears,0c1dbb4d-1cbc-485c-8949-10b1e9ab500a_04-18-week2-PASSING_AND_PASSING,147,0,0,2,1560,2,1711
365146256,matsim-org/matsim,03/09/18 05:18,spirals-bears,0c1dbb4d-1cbc-485c-8949-10b1e9ab500a_04-18-week2-PASSING_AND_PASSING,172,0,666,0,1,1056,1,1,1897
365285700,matsim-org/matsim,03/09/18 05:18,spirals-bears,0c1dbb4d-1cbc-485c-8949-10b1e9ab500a_04-18-week2-PASSING_AND_PASSING,168,0,668,1,1,1059,1,1,1899
363444016,matsim-org/matsim,03/09/18 05:20,spirals-bears,0c1dbb4d-1cbc-485c-8949-10b1e9ab500a_04-18-week2-PASSING_AND_PASSING,151,0,151
362029230,apache/incubator-servicecomb-java-chassis,03/09/18 05:22,spirals-bears,0c1dbb4d-1cbc-485c-8949-10b1e9ab500a_04-18-week2-PASSING_AND_PASSING,9,1,6,5,29,5,55
365953425,apache/incubator-servicecomb-java-chassis,03/09/18 05:22,spirals-bears,0c1dbb4d-1cbc-485c-8949-10b1e9ab500a_04-18-week2-PASSING_AND_PASSING,8,3,11
365927601,apache/incubator-servicecomb-java-chassis,03/09/18 05:22,spirals-bears,0c1dbb4d-1cbc-485c-8949-10b1e9ab500a_04-18-week2-PASSING_AND_PASSING,9,3,12
364662285,apache/incubator-servicecomb-java-chassis,03/09/18 05:23,spirals-bears,0c1dbb4d-1cbc-485c-8949-10b1e9ab500a_04-18-week2-PASSING_AND_PASSING,10,3,13
365597224,apache/incubator-servicecomb-java-chassis,03/09/18 05:23,spirals-bears,0c1dbb4d-1cbc-485c-8949-10b1e9ab500a_04-18-week2-PASSING_AND_PASSING,10,3,13
365897572,apache/incubator-servicecomb-java-chassis,03/09/18 05:24,spirals-bears,0c1dbb4d-1cbc-485c-8949-10b1e9ab500a_04-18-week2-PASSING_AND_PASSING,10,1,5,0,29,1,46
364492282,apache/incubator-servicecomb-java-chassis,03/09/18 05:24,spirals-bears,0c1dbb4d-1cbc-485c-8949-10b1e9ab500a_04-18-week2-PASSING_AND_PASSING,9,3,12
364476881,matsim-org/matsim,03/09/18 05:28,spirals-bears,0c1dbb4d-1cbc-485c-8949-10b1e9ab500a_04-18-week2-PASSING_AND_PASSING,165,0,1,1,440,1,608
364962261,matsim-org/matsim,03/09/18 05:29,spirals-bears,0c1dbb4d-1cbc-485c-8949-10b1e9ab500a_04-18-week2-PASSING_AND_PASSING,146,0,1,1,1573,2,1723
363716069,apache/incubator-servicecomb-java-chassis,03/09/18 05:31,spirals-bears,0c1dbb4d-1cbc-485c-8949-10b1e9ab500a_04-18-week2-PASSING_AND_PASSING,9,1,5,0,53,1,69
363492468,apache/incubator-servicecomb-java-chassis,03/09/18 05:31,spirals-bears,0c1dbb4d-1cbc-485c-8949-10b1e9ab500a_04-18-week2-PASSING_AND_PASSING,9,3,12
363691058,apache/incubator-servicecomb-java-chassis,03/09/18 05:32,spirals-bears,0c1dbb4d-1cbc-485c-8949-10b1e9ab500a_04-18-week2-PASSING_AND_PASSING,8,2,5,6,5,26
363673798,apache/incubator-servicecomb-java-chassis,03/09/18 05:32,spirals-bears,0c1dbb4d-1cbc-485c-8949-10b1e9ab500a_04-18-week2-PASSING_AND_PASSING,8,3,11
361928010,apache/incubator-servicecomb-java-chassis,03/09/18 05:32,spirals-bears,0c1dbb4d-1cbc-485c-8949-10b1e9ab500a_04-18-week2-PASSING_AND_PASSING,9,3,12
363607812,runelite/runelite,03/09/18 05:33,spirals-bears,0c1dbb4d-1cbc-485c-8949-10b1e9ab500a_04-18-week2-PASSING_AND_PASSING,11,0,11
363908464,runelite/runelite,03/09/18 05:33,spirals-bears,0c1dbb4d-1cbc-485c-8949-10b1e9ab500a_04-18-week2-PASSING_AND_PASSING,10,0,10
366144210,runelite/runelite,03/09/18 05:33,spirals-bears,0c1dbb4d-1cbc-485c-8949-10b1e9ab500a_04-18-week2-PASSING_AND_PASSING,10,0,10
365102448,runelite/runelite,03/09/18 05:34,spirals-bears,0c1dbb4d-1cbc-485c-8949-10b1e9ab500a_04-18-week2-PASSING_AND_PASSING,11,0,11
363899590,runelite/runelite,03/09/18 05:34,spirals-bears,0c1dbb4d-1cbc-485c-8949-10b1e9ab500a_04-18-week2-PASSING_AND_PASSING,10,0,10
365512880,runelite/runelite,03/09/18 05:34,spirals-bears,0c1dbb4d-1cbc-485c-8949-10b1e9ab500a_04-18-week2-PASSING_AND_PASSING,11,1,12
363825196,runelite/runelite,03/09/18 05:35,spirals-bears,0c1dbb4d-1cbc-485c-8949-10b1e9ab500a_04-18-week2-PASSING_AND_PASSING,11,0,11
365064028,apache/incubator-servicecomb-java-chassis,03/09/18 05:35,spirals-bears,0c1dbb4d-1cbc-485c-8949-10b1e9ab500a_04-18-week2-PASSING_AND_PASSING,11,1,385,5,1,199,1,1,604
365408045,runelite/runelite,03/09/18 05:35,spirals-bears,0c1dbb4d-1cbc-485c-8949-10b1e9ab500a_04-18-week2-PASSING_AND_PASSING,10,0,10
364423512,runelite/runelite,03/09/18 05:35,spirals-bears,0c1dbb4d-1cbc-485c-8949-10b1e9ab500a_04-18-week2-PASSING_AND_PASSING,12,0,12
364423274,runelite/runelite,03/09/18 05:35,spirals-bears,0c1dbb4d-1cbc-485c-8949-10b1e9ab500a_04-18-week2-PASSING_AND_PASSING,12,0,12
360424937,runelite/runelite,03/09/18 05:36,spirals-bears,0c1dbb4d-1cbc-485c-8949-10b1e9ab500a_04-18-week2-PASSING_AND_PASSING,11,15,26
363565475,runelite/runelite,03/09/18 05:36,spirals-bears,0c1dbb4d-1cbc-485c-8949-10b1e9ab500a_04-18-week2-PASSING_AND_PASSING,10,0,10
364419847,runelite/runelite,03/09/18 05:36,spirals-bears,0c1dbb4d-1cbc-485c-8949-10b1e9ab500a_04-18-week2-PASSING_AND_PASSING,11,0,11
364422728,runelite/runelite,03/09/18 05:36,spirals-bears,0c1dbb4d-1cbc-485c-8949-10b1e9ab500a_04-18-week2-PASSING_AND_PASSING,10,0,10
364062561,runelite/runelite,03/09/18 05:36,spirals-bears,0c1dbb4d-1cbc-485c-8949-10b1e9ab500a_04-18-week2-PASSING_AND_PASSING,10,0,10
364075133,runelite/runelite,03/09/18 05:37,spirals-bears,0c1dbb4d-1cbc-485c-8949-10b1e9ab500a_04-18-week2-PASSING_AND_PASSING,10,0,0,4,15,29
363932548,runelite/runelite,03/09/18 05:37,spirals-bears,0c1dbb4d-1cbc-485c-8949-10b1e9ab500a_04-18-week2-PASSING_AND_PASSING,10,14,24
363481243,runelite/runelite,03/09/18 05:37,spirals-bears,0c1dbb4d-1cbc-485c-8949-10b1e9ab500a_04-18-week2-PASSING_AND_PASSING,10,0,10
361465601,runelite/runelite,03/09/18 05:37,spirals-bears,0c1dbb4d-1cbc-485c-8949-10b1e9ab500a_04-18-week2-PASSING_AND_PASSING,10,0,10
363930041,runelite/runelite,03/09/18 05:37,spirals-bears,0c1dbb4d-1cbc-485c-8949-10b1e9ab500a_04-18-week2-PASSING_AND_PASSING,10,13,23
363669263,runelite/runelite,03/09/18 05:38,spirals-bears,0c1dbb4d-1cbc-485c-8949-10b1e9ab500a_04-18-week2-PASSING_AND_PASSING,10,13,23
361197398,runelite/runelite,03/09/18 05:38,spirals-bears,0c1dbb4d-1cbc-485c-8949-10b1e9ab500a_04-18-week2-PASSING_AND_PASSING,11,0,11
365093889,matsim-org/matsim,03/09/18 05:38,spirals-bears,0c1dbb4d-1cbc-485c-8949-10b1e9ab500a_04-18-week2-PASSING_AND_PASSING,142,0,0,1,1302,1,1446
363836359,runelite/runelite,03/09/18 05:38,spirals-bears,0c1dbb4d-1cbc-485c-8949-10b1e9ab500a_04-18-week2-PASSING_AND_PASSING,12,3,15
363648774,runelite/runelite,03/09/18 05:38,spirals-bears,0c1dbb4d-1cbc-485c-8949-10b1e9ab500a_04-18-week2-PASSING_AND_PASSING,15,4,19
363832964,runelite/runelite,03/09/18 05:39,spirals-bears,0c1dbb4d-1cbc-485c-8949-10b1e9ab500a_04-18-week2-PASSING_AND_PASSING,12,0,12
363824973,runelite/runelite,03/09/18 05:39,spirals-bears,0c1dbb4d-1cbc-485c-8949-10b1e9ab500a_04-18-week2-PASSING_AND_PASSING,11,0,11
363830581,runelite/runelite,03/09/18 05:39,spirals-bears,0c1dbb4d-1cbc-485c-8949-10b1e9ab500a_04-18-week2-PASSING_AND_PASSING,12,0,12
363655105,runelite/runelite,03/09/18 05:39,spirals-bears,0c1dbb4d-1cbc-485c-8949-10b1e9ab500a_04-18-week2-PASSING_AND_PASSING,11,0,0,4,15,30
360061726,CorfuDB/CorfuDB,03/09/18 05:43,spirals-bears,0c1dbb4d-1cbc-485c-8949-10b1e9ab500a_04-18-week2-PASSING_AND_PASSING,251,3,254
363807386,apache/incubator-servicecomb-java-chassis,03/09/18 05:43,spirals-bears,0c1dbb4d-1cbc-485c-8949-10b1e9ab500a_04-18-week2-PASSING_AND_PASSING,8,2,1,0,6,107,0,5,4,2,365,0,0,0,167,0,8,3,2,201,881
360061736,CorfuDB/CorfuDB,03/09/18 05:43,spirals-bears,0c1dbb4d-1cbc-485c-8949-10b1e9ab500a_04-18-week2-PASSING_AND_PASSING,272,0,272
364877271,CorfuDB/CorfuDB,03/09/18 05:44,spirals-bears,0c1dbb4d-1cbc-485c-8949-10b1e9ab500a_04-18-week2-PASSING_AND_PASSING,248,0,0,0,0,248
366246352,apache/storm,03/09/18 05:44,spirals-bears,0c1dbb4d-1cbc-485c-8949-10b1e9ab500a_04-18-week2-PASSING_AND_PASSING,55,3,58
366220231,apache/storm,03/09/18 05:45,spirals-bears,0c1dbb4d-1cbc-485c-8949-10b1e9ab500a_04-18-week2-PASSING_AND_PASSING,35,0,2,0,51,1,89
364510852,apache/storm,03/09/18 05:46,spirals-bears,0c1dbb4d-1cbc-485c-8949-10b1e9ab500a_04-18-week2-PASSING_AND_PASSING,35,0,2,0,49,2,88
363014954,apache/storm,03/09/18 05:47,spirals-bears,0c1dbb4d-1cbc-485c-8949-10b1e9ab500a_04-18-week2-PASSING_AND_PASSING,37,0,1,1,60,1,100
364400845,CorfuDB/CorfuDB,03/09/18 05:47,spirals-bears,0c1dbb4d-1cbc-485c-8949-10b1e9ab500a_04-18-week2-PASSING_AND_PASSING,254,0,254
364400961,CorfuDB/CorfuDB,03/09/18 05:48,spirals-bears,0c1dbb4d-1cbc-485c-8949-10b1e9ab500a_04-18-week2-PASSING_AND_PASSING,261,3,264
365584816,apache/activemq-artemis,03/09/18 05:48,spirals-bears,0c1dbb4d-1cbc-485c-8949-10b1e9ab500a_04-18-week2-PASSING_AND_PASSING,27,0,1,5,5,38
364977084,apache/activemq-artemis,03/09/18 05:48,spirals-bears,0c1dbb4d-1cbc-485c-8949-10b1e9ab500a_04-18-week2-PASSING_AND_PASSING,27,4,31
362328495,apache/storm,03/09/18 05:48,spirals-bears,0c1dbb4d-1cbc-485c-8949-10b1e9ab500a_04-18-week2-PASSING_AND_PASSING,40,0,1,4,66,14,125
363665636,apache/activemq-artemis,03/09/18 05:49,spirals-bears,0c1dbb4d-1cbc-485c-8949-10b1e9ab500a_04-18-week2-PASSING_AND_PASSING,26,6,32
365747867,linkedin/pinot,03/09/18 05:49,spirals-bears,0c1dbb4d-1cbc-485c-8949-10b1e9ab500a_04-18-week2-PASSING_AND_PASSING,42,4,46
366305869,linkedin/pinot,03/09/18 05:49,spirals-bears,0c1dbb4d-1cbc-485c-8949-10b1e9ab500a_04-18-week2-PASSING_AND_PASSING,38,4,42
366293458,linkedin/pinot,03/09/18 05:50,spirals-bears,0c1dbb4d-1cbc-485c-8949-10b1e9ab500a_04-18-week2-PASSING_AND_PASSING,35,4,39
365309111,linkedin/pinot,03/09/18 05:50,spirals-bears,0c1dbb4d-1cbc-485c-8949-10b1e9ab500a_04-18-week2-PASSING_AND_PASSING,36,3,39
364891140,linkedin/pinot,03/09/18 05:50,spirals-bears,0c1dbb4d-1cbc-485c-8949-10b1e9ab500a_04-18-week2-PASSING_AND_PASSING,36,4,40
364896829,linkedin/pinot,03/09/18 05:51,spirals-bears,0c1dbb4d-1cbc-485c-8949-10b1e9ab500a_04-18-week2-PASSING_AND_PASSING,34,3,37
364736854,linkedin/pinot,03/09/18 05:51,spirals-bears,0c1dbb4d-1cbc-485c-8949-10b1e9ab500a_04-18-week2-PASSING_AND_PASSING,33,5,38
365257403,linkedin/pinot,03/09/18 05:52,spirals-bears,0c1dbb4d-1cbc-485c-8949-10b1e9ab500a_04-18-week2-PASSING_AND_PASSING,33,4,37
364720962,apache/activemq-artemis,03/09/18 06:01,spirals-bears,0c1dbb4d-1cbc-485c-8949-10b1e9ab500a_04-18-week2-PASSING_AND_PASSING,28,0,282,3,1,465,1,1,781
364893484,linkedin/pinot,03/09/18 06:02,spirals-bears,0c1dbb4d-1cbc-485c-8949-10b1e9ab500a_04-18-week2-PASSING_AND_PASSING,46,5,51
364881602,linkedin/pinot,03/09/18 06:03,spirals-bears,0c1dbb4d-1cbc-485c-8949-10b1e9ab500a_04-18-week2-PASSING_AND_PASSING,38,4,42
364827314,linkedin/pinot,03/09/18 06:04,spirals-bears,0c1dbb4d-1cbc-485c-8949-10b1e9ab500a_04-18-week2-PASSING_AND_PASSING,34,3,37
364383186,linkedin/pinot,03/09/18 06:04,spirals-bears,0c1dbb4d-1cbc-485c-8949-10b1e9ab500a_04-18-week2-PASSING_AND_PASSING,34,4,38
364359363,linkedin/pinot,03/09/18 06:05,spirals-bears,0c1dbb4d-1cbc-485c-8949-10b1e9ab500a_04-18-week2-PASSING_AND_PASSING,35,4,39
363216487,linkedin/pinot,03/09/18 06:06,spirals-bears,0c1dbb4d-1cbc-485c-8949-10b1e9ab500a_04-18-week2-PASSING_AND_PASSING,34,4,38
364298182,linkedin/pinot,03/09/18 08:07,spirals-bears,0c1dbb4d-1cbc-485c-8949-10b1e9ab500a_04-18-week2-PASSING_AND_PASSING,34,0,2,1,7212,1,7250
363369908,linkedin/pinot,03/09/18 08:08,spirals-bears,0c1dbb4d-1cbc-485c-8949-10b1e9ab500a_04-18-week2-PASSING_AND_PASSING,40,0,0,5,10,55
365877247,linkedin/pinot,03/09/18 08:08,spirals-bears,0c1dbb4d-1cbc-485c-8949-10b1e9ab500a_04-18-week2-PASSING_AND_PASSING,33,0,0,1,8279,2,8315
365235197,linkedin/pinot,03/09/18 08:09,spirals-bears,0c1dbb4d-1cbc-485c-8949-10b1e9ab500a_04-18-week2-PASSING_AND_PASSING,37,0,0,1,8271,1,8310
365372792,Azure/azure-libraries-for-java,03/09/18 08:10,spirals-bears,0c1dbb4d-1cbc-485c-8949-10b1e9ab500a_04-18-week2-PASSING_AND_PASSING,69,4,73
365341269,Azure/azure-libraries-for-java,03/09/18 08:11,spirals-bears,0c1dbb4d-1cbc-485c-8949-10b1e9ab500a_04-18-week2-PASSING_AND_PASSING,77,3,80
365771674,Azure/azure-libraries-for-java,03/09/18 08:11,spirals-bears,0c1dbb4d-1cbc-485c-8949-10b1e9ab500a_04-18-week2-PASSING_AND_PASSING,71,0,1,2,80,6,160
364690236,Azure/azure-libraries-for-java,03/09/18 08:12,spirals-bears,0c1dbb4d-1cbc-485c-8949-10b1e9ab500a_04-18-week2-PASSING_AND_PASSING,70,5,75
364384228,Azure/azure-libraries-for-java,03/09/18 08:12,spirals-bears,0c1dbb4d-1cbc-485c-8949-10b1e9ab500a_04-18-week2-PASSING_AND_PASSING,64,0,1,1,71,5,142
364204760,raphw/byte-buddy,03/09/18 08:17,spirals-bears,0c1dbb4d-1cbc-485c-8949-10b1e9ab500a_04-18-week2-PASSING_AND_PASSING,252,6,258
366288214,raphw/byte-buddy,03/09/18 08:17,spirals-bears,0c1dbb4d-1cbc-485c-8949-10b1e9ab500a_04-18-week2-PASSING_AND_PASSING,244,0,1,0,51,0,296
365567072,graphhopper/graphhopper,03/09/18 08:18,spirals-bears,0c1dbb4d-1cbc-485c-8949-10b1e9ab500a_04-18-week2-PASSING_AND_PASSING,19,0,19
365112043,graphhopper/graphhopper,03/09/18 08:19,spirals-bears,0c1dbb4d-1cbc-485c-8949-10b1e9ab500a_04-18-week2-PASSING_AND_PASSING,15,0,0,0,22,1,38
365012940,graphhopper/graphhopper,03/09/18 08:19,spirals-bears,0c1dbb4d-1cbc-485c-8949-10b1e9ab500a_04-18-week2-PASSING_AND_PASSING,16,0,0,0,0,16
364356456,Azure/azure-libraries-for-java,03/09/18 08:19,spirals-bears,0c1dbb4d-1cbc-485c-8949-10b1e9ab500a_04-18-week2-PASSING_AND_PASSING,10,0,0,86,0,1,16,0,87,0,0,86,0,60,18,98,462
363834756,graphhopper/graphhopper,03/09/18 08:20,spirals-bears,0c1dbb4d-1cbc-485c-8949-10b1e9ab500a_04-18-week2-PASSING_AND_PASSING,17,0,0,0,25,0,42
363538769,graphhopper/graphhopper,03/09/18 08:21,spirals-bears,0c1dbb4d-1cbc-485c-8949-10b1e9ab500a_04-18-week2-PASSING_AND_PASSING,18,0,0,0,46,0,64
364045579,graphhopper/graphhopper,03/09/18 08:23,spirals-bears,0c1dbb4d-1cbc-485c-8949-10b1e9ab500a_04-18-week2-PASSING_AND_PASSING,17,0,73,0,0,113,0,0,203
361323553,HubSpot/Singularity,03/09/18 08:26,spirals-bears,0c1dbb4d-1cbc-485c-8949-10b1e9ab500a_04-18-week2-PASSING_AND_PASSING,17,0,1,5,133,3,159
363589915,raphw/byte-buddy,03/09/18 08:28,spirals-bears,0c1dbb4d-1cbc-485c-8949-10b1e9ab500a_04-18-week2-PASSING_AND_PASSING,12,16,0,0,22,57,0,0,11,0,84,0,0,0,53,0,247,12,12,108,634
365626972,HubSpot/Singularity,03/09/18 08:45,spirals-bears,0c1dbb4d-1cbc-485c-8949-10b1e9ab500a_04-18-week2-PASSING_AND_PASSING,10,0,0,310,0,1,4,0,329,0,0,347,0,17,11,360,1389
362612621,HubSpot/Singularity,03/09/18 08:48,spirals-bears,0c1dbb4d-1cbc-485c-8949-10b1e9ab500a_04-18-week2-PASSING_AND_PASSING,20,0,2,0,175,0,197
365597256,HubSpot/Singularity,03/09/18 08:50,spirals-bears,0c1dbb4d-1cbc-485c-8949-10b1e9ab500a_04-18-week2-PASSING_AND_PASSING,10,0,0,315,0,1,5,0,340,0,0,345,0,18,9,387,1430
365595518,HubSpot/Singularity,03/09/18 08:51,spirals-bears,0c1dbb4d-1cbc-485c-8949-10b1e9ab500a_04-18-week2-PASSING_AND_PASSING,10,0,0,297,0,1,4,0,298,0,0,365,0,18,5,400,1398
364185698,HubSpot/Singularity,03/09/18 08:51,spirals-bears,0c1dbb4d-1cbc-485c-8949-10b1e9ab500a_04-18-week2-PASSING_AND_PASSING,17,0,1,0,143,0,161
364048191,magefree/mage,03/09/18 08:54,spirals-bears,0c1dbb4d-1cbc-485c-8949-10b1e9ab500a_04-18-week2-PASSING_AND_PASSING,165,0,165
365097966,visallo/vertexium,03/09/18 08:55,spirals-bears,0c1dbb4d-1cbc-485c-8949-10b1e9ab500a_04-18-week2-PASSING_AND_PASSING,8,0,13,0,0,174,0,0,195
363101540,visallo/vertexium,03/09/18 08:56,spirals-bears,0c1dbb4d-1cbc-485c-8949-10b1e9ab500a_04-18-week2-PASSING_AND_PASSING,8,0,0,0,89,0,97
362688292,visallo/vertexium,03/09/18 08:57,spirals-bears,0c1dbb4d-1cbc-485c-8949-10b1e9ab500a_04-18-week2-PASSING_AND_PASSING,8,0,0,0,86,0,94
364685614,magefree/mage,03/09/18 09:06,spirals-bears,0c1dbb4d-1cbc-485c-8949-10b1e9ab500a_04-18-week2-PASSING_AND_PASSING,11,0,0,167,0,1,39,0,149,1,1,33,1,182,33,351,969
364109734,apache/incubator-dubbo,03/09/18 09:08,spirals-bears,0c1dbb4d-1cbc-485c-8949-10b1e9ab500a_04-18-week2-PASSING_AND_PASSING,8,0,1,0,44,1,54
364893115,linkedin/pinot,03/09/18 09:09,spirals-bears,0c1dbb4d-1cbc-485c-8949-10b1e9ab500a_04-18-week2-PASSING_AND_PASSING,36,0,3411,0,1,8359,2,3,11812
364215487,languagetool-org/languagetool,03/09/18 09:17,spirals-bears,0c1dbb4d-1cbc-485c-8949-10b1e9ab500a_04-18-week2-PASSING_AND_PASSING,288,0,819,1,1,124,0,1,1234
355702558,apache/incubator-dubbo,03/09/18 09:22,spirals-bears,0c1dbb4d-1cbc-485c-8949-10b1e9ab500a_04-18-week2-PASSING_AND_PASSING,8,0,199,9,6,603,0,10,835
363652585,apache/incubator-dubbo,03/09/18 09:23,spirals-bears,0c1dbb4d-1cbc-485c-8949-10b1e9ab500a_04-18-week2-PASSING_AND_PASSING,12,0,199,4,0,599,0,1,815
363474378,languagetool-org/languagetool,03/09/18 09:25,spirals-bears,0c1dbb4d-1cbc-485c-8949-10b1e9ab500a_04-18-week2-PASSING_AND_PASSING,8,40,0,0,27,202,0,0,35,0,819,0,0,0,66,0,287,36,37,126,1683
363488529,apache/incubator-dubbo,03/09/18 09:31,spirals-bears,0c1dbb4d-1cbc-485c-8949-10b1e9ab500a_04-18-week2-PASSING_AND_PASSING,8,0,195,1,0,600,0,1,805
364651369,ga4gh/dockstore,03/09/18 09:35,spirals-bears,0c1dbb4d-1cbc-485c-8949-10b1e9ab500a_04-18-week2-PASSING_AND_PASSING,9,0,0,0,766,0,775
362806263,ga4gh/dockstore,03/09/18 09:35,spirals-bears,0c1dbb4d-1cbc-485c-8949-10b1e9ab500a_04-18-week2-PASSING_AND_PASSING,9,0,0,0,736,0,745
365648817,apache/jackrabbit-oak,03/09/18 10:41,spirals-bears,0c1dbb4d-1cbc-485c-8949-10b1e9ab500a_04-18-week2-PASSING_AND_PASSING,9,0,0,1789,3,2,15,0,1748,1,1,418,0,37,25,495,4543
365100539,apache/jackrabbit-oak,03/09/18 10:46,spirals-bears,0c1dbb4d-1cbc-485c-8949-10b1e9ab500a_04-18-week2-PASSING_AND_PASSING,16,0,0,1720,1,2,12,0,1773,1,1,429,0,39,18,464,4476
364988118,apache/jackrabbit-oak,03/09/18 10:50,spirals-bears,0c1dbb4d-1cbc-485c-8949-10b1e9ab500a_04-18-week2-PASSING_AND_PASSING,18,0,0,1785,6,2,43,0,1730,1,2,396,0,38,21,452,4494
364677713,apache/jackrabbit-oak,03/09/18 10:52,spirals-bears,0c1dbb4d-1cbc-485c-8949-10b1e9ab500a_04-18-week2-PASSING_AND_PASSING,14,0,3,1777,5,2,55,0,1803,0,4,387,0,39,18,453,4560
354195101,aliyun/fc-java-sdk,03/09/18 10:52,spirals-bears,0c1dbb4d-1cbc-485c-8949-10b1e9ab500a_04-18-week2-PASSING_AND_PASSING,2,0,0,0,18,0,20
354247675,dropwizard/metrics,03/09/18 10:55,spirals-bears,0c1dbb4d-1cbc-485c-8949-10b1e9ab500a_04-18-week2-PASSING_AND_PASSING,6,3,59,4,0,112,0,0,184
365843348,Hycom-PIP/pip2018,03/09/18 10:56,spirals-bears,0c1dbb4d-1cbc-485c-8949-10b1e9ab500a_04-18-week2-PASSING_AND_PASSING,2,0,2
365353514,Hycom-PIP/pip2018,03/09/18 10:56,spirals-bears,0c1dbb4d-1cbc-485c-8949-10b1e9ab500a_04-18-week2-PASSING_AND_PASSING,2,0,2
365616306,Hycom-PIP/pip2018,03/09/18 10:56,spirals-bears,0c1dbb4d-1cbc-485c-8949-10b1e9ab500a_04-18-week2-PASSING_AND_PASSING,2,0,2
364593518,Hycom-PIP/pip2018,03/09/18 10:56,spirals-bears,0c1dbb4d-1cbc-485c-8949-10b1e9ab500a_04-18-week2-PASSING_AND_PASSING,2,0,2
364310516,Hycom-PIP/pip2018,03/09/18 10:56,spirals-bears,0c1dbb4d-1cbc-485c-8949-10b1e9ab500a_04-18-week2-PASSING_AND_PASSING,2,0,2
364575291,Hycom-PIP/pip2018,03/09/18 10:56,spirals-bears,0c1dbb4d-1cbc-485c-8949-10b1e9ab500a_04-18-week2-PASSING_AND_PASSING,2,0,3,0,5
364535214,Hycom-PIP/pip2018,03/09/18 10:57,spirals-bears,0c1dbb4d-1cbc-485c-8949-10b1e9ab500a_04-18-week2-PASSING_AND_PASSING,2,0,2
364537644,Hycom-PIP/pip2018,03/09/18 10:57,spirals-bears,0c1dbb4d-1cbc-485c-8949-10b1e9ab500a_04-18-week2-PASSING_AND_PASSING,2,0,8,2,0,27,0,0,39
364524539,Hycom-PIP/pip2018,03/09/18 10:58,spirals-bears,0c1dbb4d-1cbc-485c-8949-10b1e9ab500a_04-18-week2-PASSING_AND_PASSING,2,0,3,0,5
361936556,airlift/airlift,03/09/18 11:01,spirals-bears,0c1dbb4d-1cbc-485c-8949-10b1e9ab500a_04-18-week2-PASSING_AND_PASSING,12,0,0,0,211,0,223
362961668,airlift/airlift,03/09/18 11:02,spirals-bears,0c1dbb4d-1cbc-485c-8949-10b1e9ab500a_04-18-week2-PASSING_AND_PASSING,12,3,15
365848796,resteasy/Resteasy,03/09/18 11:02,spirals-bears,0c1dbb4d-1cbc-485c-8949-10b1e9ab500a_04-18-week2-PASSING_AND_PASSING,19,2,1,22
365836820,resteasy/Resteasy,03/09/18 11:03,spirals-bears,0c1dbb4d-1cbc-485c-8949-10b1e9ab500a_04-18-week2-PASSING_AND_PASSING,18,2,1,21
365516224,resteasy/Resteasy,03/09/18 11:03,spirals-bears,0c1dbb4d-1cbc-485c-8949-10b1e9ab500a_04-18-week2-PASSING_AND_PASSING,17,2,7,26
363128773,resteasy/Resteasy,03/09/18 11:04,spirals-bears,0c1dbb4d-1cbc-485c-8949-10b1e9ab500a_04-18-week2-PASSING_AND_PASSING,18,2,1,21
364838538,resteasy/Resteasy,03/09/18 11:05,spirals-bears,0c1dbb4d-1cbc-485c-8949-10b1e9ab500a_04-18-week2-PASSING_AND_PASSING,18,2,8,28
363094142,resteasy/Resteasy,03/09/18 11:05,spirals-bears,0c1dbb4d-1cbc-485c-8949-10b1e9ab500a_04-18-week2-PASSING_AND_PASSING,18,2,1,21
363626790,resteasy/Resteasy,03/09/18 11:06,spirals-bears,0c1dbb4d-1cbc-485c-8949-10b1e9ab500a_04-18-week2-PASSING_AND_PASSING,19,6,25
362763302,resteasy/Resteasy,03/09/18 11:06,spirals-bears,0c1dbb4d-1cbc-485c-8949-10b1e9ab500a_04-18-week2-PASSING_AND_PASSING,18,6,24
364156334,geoserver/geoserver,03/09/18 11:36,spirals-bears,0c1dbb4d-1cbc-485c-8949-10b1e9ab500a_04-18-week2-PASSING_AND_PASSING,17,0,0,522,0,1,26,0,482,1,0,43,1,54,36,605,1788
364567659,apache/jackrabbit-oak,03/09/18 11:58,spirals-bears,0c1dbb4d-1cbc-485c-8949-10b1e9ab500a_04-18-week2-PASSING_AND_PASSING,16,0,0,1817,3,3,14,0,1767,1,1,400,0,36,18,484,4560
364057080,apache/jackrabbit-oak,03/09/18 12:03,spirals-bears,0c1dbb4d-1cbc-485c-8949-10b1e9ab500a_04-18-week2-PASSING_AND_PASSING,14,0,0,1841,0,2,14,0,1811,1,1,409,0,35,20,473,4621
363173763,apache/jackrabbit-oak,03/09/18 12:05,spirals-bears,0c1dbb4d-1cbc-485c-8949-10b1e9ab500a_04-18-week2-PASSING_AND_PASSING,8,0,0,1787,0,2,17,0,1767,1,1,368,0,36,21,469,4477
362824914,aicis/fresco,03/09/18 12:06,spirals-bears,0c1dbb4d-1cbc-485c-8949-10b1e9ab500a_04-18-week2-PASSING_AND_PASSING,8,0,0,0,24,0,32
363149578,geoserver/geoserver,03/09/18 12:07,spirals-bears,0c1dbb4d-1cbc-485c-8949-10b1e9ab500a_04-18-week2-PASSING_AND_PASSING,15,0,0,495,0,0,27,0,489,1,0,45,1,56,34,634,1797
362824928,aicis/fresco,03/09/18 12:07,spirals-bears,0c1dbb4d-1cbc-485c-8949-10b1e9ab500a_04-18-week2-PASSING_AND_PASSING,9,0,0,5,31,4,49
364508125,swagger-api/swagger-codegen,03/09/18 12:09,spirals-bears,0c1dbb4d-1cbc-485c-8949-10b1e9ab500a_04-18-week2-PASSING_AND_PASSING,35,0,1,8,71,9,124
365482574,swagger-api/swagger-codegen,03/09/18 12:11,spirals-bears,0c1dbb4d-1cbc-485c-8949-10b1e9ab500a_04-18-week2-PASSING_AND_PASSING,36,0,1,2,71,1,111
362563103,swagger-api/swagger-codegen,03/09/18 12:12,spirals-bears,0c1dbb4d-1cbc-485c-8949-10b1e9ab500a_04-18-week2-PASSING_AND_PASSING,33,0,33
362569707,swagger-api/swagger-codegen,03/09/18 12:14,spirals-bears,0c1dbb4d-1cbc-485c-8949-10b1e9ab500a_04-18-week2-PASSING_AND_PASSING,33,0,0,6,77,6,122
364811109,swagger-api/swagger-codegen,03/09/18 12:15,spirals-bears,0c1dbb4d-1cbc-485c-8949-10b1e9ab500a_04-18-week2-PASSING_AND_PASSING,31,0,31
364892960,swagger-api/swagger-codegen,03/09/18 12:17,spirals-bears,0c1dbb4d-1cbc-485c-8949-10b1e9ab500a_04-18-week2-PASSING_AND_PASSING,33,0,0,2,76,1,112
364197906,aicis/fresco,03/09/18 12:21,spirals-bears,0c1dbb4d-1cbc-485c-8949-10b1e9ab500a_04-18-week2-PASSING_AND_PASSING,9,0,1275,1,5,98,0,5,1393
364149464,swagger-api/swagger-codegen,03/09/18 12:26,spirals-bears,0c1dbb4d-1cbc-485c-8949-10b1e9ab500a_04-18-week2-PASSING_AND_PASSING,7,15,0,0,10,44,0,1,13,0,53,0,1,0,75,0,33,14,14,239,519
364666059,swagger-api/swagger-codegen,03/09/18 12:27,spirals-bears,0c1dbb4d-1cbc-485c-8949-10b1e9ab500a_04-18-week2-PASSING_AND_PASSING,34,0,57,0,7,251,0,5,354
363695011,aicis/fresco,03/09/18 12:27,spirals-bears,0c1dbb4d-1cbc-485c-8949-10b1e9ab500a_04-18-week2-PASSING_AND_PASSING,9,0,1331,0,5,97,0,3,1445
364519895,swagger-api/swagger-codegen,03/09/18 12:30,spirals-bears,0c1dbb4d-1cbc-485c-8949-10b1e9ab500a_04-18-week2-PASSING_AND_PASSING,36,0,0,7,84,6,133
363994940,aicis/fresco,03/09/18 12:30,spirals-bears,0c1dbb4d-1cbc-485c-8949-10b1e9ab500a_04-18-week2-PASSING_AND_PASSING,9,0,1262,1,0,107,0,0,1379
364665533,swagger-api/swagger-codegen,03/09/18 12:32,spirals-bears,0c1dbb4d-1cbc-485c-8949-10b1e9ab500a_04-18-week2-PASSING_AND_PASSING,34,0,59,1,1,269,0,1,365
364516857,swagger-api/swagger-codegen,03/09/18 12:33,spirals-bears,0c1dbb4d-1cbc-485c-8949-10b1e9ab500a_04-18-week2-PASSING_AND_PASSING,34,0,58,0,7,231,0,6,336
364490391,swagger-api/swagger-codegen,03/09/18 12:36,spirals-bears,0c1dbb4d-1cbc-485c-8949-10b1e9ab500a_04-18-week2-PASSING_AND_PASSING,35,0,61,0,9,229,0,8,342
363154719,swagger-api/swagger-codegen,03/09/18 12:37,spirals-bears,0c1dbb4d-1cbc-485c-8949-10b1e9ab500a_04-18-week2-PASSING_AND_PASSING,36,0,36
361649869,swagger-api/swagger-codegen,03/09/18 12:38,spirals-bears,0c1dbb4d-1cbc-485c-8949-10b1e9ab500a_04-18-week2-PASSING_AND_PASSING,34,0,34
362092540,swagger-api/swagger-codegen,03/09/18 12:38,spirals-bears,0c1dbb4d-1cbc-485c-8949-10b1e9ab500a_04-18-week2-PASSING_AND_PASSING,34,0,61,2,8,229,0,7,341
364516444,swagger-api/swagger-codegen,03/09/18 12:39,spirals-bears,0c1dbb4d-1cbc-485c-8949-10b1e9ab500a_04-18-week2-PASSING_AND_PASSING,7,17,0,4,10,44,0,0,16,0,57,0,8,0,71,4,35,15,17,214,519
358712830,swagger-api/swagger-codegen,03/09/18 12:39,spirals-bears,0c1dbb4d-1cbc-485c-8949-10b1e9ab500a_04-18-week2-PASSING_AND_PASSING,40,0,29,1,8,238,0,10,326
365911612,spring-cloud/spring-cloud-gcp,03/09/18 12:39,spirals-bears,0c1dbb4d-1cbc-485c-8949-10b1e9ab500a_04-18-week2-PASSING_AND_PASSING,4,2,6
365358537,spring-cloud/spring-cloud-gcp,03/09/18 12:39,spirals-bears,0c1dbb4d-1cbc-485c-8949-10b1e9ab500a_04-18-week2-PASSING_AND_PASSING,4,2,6
365297237,spring-cloud/spring-cloud-gcp,03/09/18 12:40,spirals-bears,0c1dbb4d-1cbc-485c-8949-10b1e9ab500a_04-18-week2-PASSING_AND_PASSING,4,2,6
365297083,spring-cloud/spring-cloud-gcp,03/09/18 12:40,spirals-bears,0c1dbb4d-1cbc-485c-8949-10b1e9ab500a_04-18-week2-PASSING_AND_PASSING,4,3,7
354704549,Blazebit/blaze-persistence,03/09/18 12:40,spirals-bears,0c1dbb4d-1cbc-485c-8949-10b1e9ab500a_04-18-week2-PASSING_AND_PASSING,12,1,3,1,44,1,62
365292304,spring-cloud/spring-cloud-gcp,03/09/18 12:44,spirals-bears,0c1dbb4d-1cbc-485c-8949-10b1e9ab500a_04-18-week2-PASSING_AND_PASSING,4,5,9,0,244,0,262
362158049,swagger-api/swagger-codegen,03/09/18 12:44,spirals-bears,0c1dbb4d-1cbc-485c-8949-10b1e9ab500a_04-18-week2-PASSING_AND_PASSING,38,0,60,0,8,273,0,11,390
365276244,spring-cloud/spring-cloud-gcp,03/09/18 12:45,spirals-bears,0c1dbb4d-1cbc-485c-8949-10b1e9ab500a_04-18-week2-PASSING_AND_PASSING,4,4,8
365355761,spring-cloud/spring-cloud-gcp,03/09/18 12:49,spirals-bears,0c1dbb4d-1cbc-485c-8949-10b1e9ab500a_04-18-week2-PASSING_AND_PASSING,5,5,71,10,0,469,0,0,560
365269897,spring-cloud/spring-cloud-gcp,03/09/18 12:49,spirals-bears,0c1dbb4d-1cbc-485c-8949-10b1e9ab500a_04-18-week2-PASSING_AND_PASSING,7,5,10,0,248,0,270
365250404,spring-cloud/spring-cloud-gcp,03/09/18 12:49,spirals-bears,0c1dbb4d-1cbc-485c-8949-10b1e9ab500a_04-18-week2-PASSING_AND_PASSING,5,5,10,0,247,0,267
365230915,spring-cloud/spring-cloud-gcp,03/09/18 12:49,spirals-bears,0c1dbb4d-1cbc-485c-8949-10b1e9ab500a_04-18-week2-PASSING_AND_PASSING,4,2,6
364697235,spring-cloud/spring-cloud-gcp,03/09/18 12:49,spirals-bears,0c1dbb4d-1cbc-485c-8949-10b1e9ab500a_04-18-week2-PASSING_AND_PASSING,4,2,6
364737456,spring-cloud/spring-cloud-gcp,03/09/18 12:50,spirals-bears,0c1dbb4d-1cbc-485c-8949-10b1e9ab500a_04-18-week2-PASSING_AND_PASSING,6,2,8
365230013,spring-cloud/spring-cloud-gcp,03/09/18 12:50,spirals-bears,0c1dbb4d-1cbc-485c-8949-10b1e9ab500a_04-18-week2-PASSING_AND_PASSING,5,2,7
365229232,spring-cloud/spring-cloud-gcp,03/09/18 12:50,spirals-bears,0c1dbb4d-1cbc-485c-8949-10b1e9ab500a_04-18-week2-PASSING_AND_PASSING,6,2,8
365228847,spring-cloud/spring-cloud-gcp,03/09/18 12:50,spirals-bears,0c1dbb4d-1cbc-485c-8949-10b1e9ab500a_04-18-week2-PASSING_AND_PASSING,4,2,6
365227293,spring-cloud/spring-cloud-gcp,03/09/18 12:50,spirals-bears,0c1dbb4d-1cbc-485c-8949-10b1e9ab500a_04-18-week2-PASSING_AND_PASSING,5,3,8
365176882,spring-cloud/spring-cloud-gcp,03/09/18 12:50,spirals-bears,0c1dbb4d-1cbc-485c-8949-10b1e9ab500a_04-18-week2-PASSING_AND_PASSING,5,2,7
365173090,spring-cloud/spring-cloud-gcp,03/09/18 12:50,spirals-bears,0c1dbb4d-1cbc-485c-8949-10b1e9ab500a_04-18-week2-PASSING_AND_PASSING,5,2,7
365165774,spring-cloud/spring-cloud-gcp,03/09/18 12:50,spirals-bears,0c1dbb4d-1cbc-485c-8949-10b1e9ab500a_04-18-week2-PASSING_AND_PASSING,4,2,6
365159748,spring-cloud/spring-cloud-gcp,03/09/18 12:51,spirals-bears,0c1dbb4d-1cbc-485c-8949-10b1e9ab500a_04-18-week2-PASSING_AND_PASSING,5,2,7
364858122,spring-cloud/spring-cloud-gcp,03/09/18 12:51,spirals-bears,0c1dbb4d-1cbc-485c-8949-10b1e9ab500a_04-18-week2-PASSING_AND_PASSING,4,2,6
365341004,spring-cloud/spring-cloud-gcp,03/09/18 12:52,spirals-bears,0c1dbb4d-1cbc-485c-8949-10b1e9ab500a_04-18-week2-PASSING_AND_PASSING,27,1,5,0,11,34,0,10,1,1,65,0,0,0,82,0,5,1,4,462,709
364260969,spring-cloud/spring-cloud-gcp,03/09/18 12:52,spirals-bears,0c1dbb4d-1cbc-485c-8949-10b1e9ab500a_04-18-week2-PASSING_AND_PASSING,5,2,7
364352813,spring-cloud/spring-cloud-gcp,03/09/18 12:52,spirals-bears,0c1dbb4d-1cbc-485c-8949-10b1e9ab500a_04-18-week2-PASSING_AND_PASSING,4,2,6
365153138,spring-cloud/spring-cloud-gcp,03/09/18 12:55,spirals-bears,0c1dbb4d-1cbc-485c-8949-10b1e9ab500a_04-18-week2-PASSING_AND_PASSING,4,5,11,0,254,0,274
364822899,spring-cloud/spring-cloud-gcp,03/09/18 12:56,spirals-bears,0c1dbb4d-1cbc-485c-8949-10b1e9ab500a_04-18-week2-PASSING_AND_PASSING,4,5,9,0,303,0,321
364680846,spring-cloud/spring-cloud-gcp,03/09/18 12:56,spirals-bears,0c1dbb4d-1cbc-485c-8949-10b1e9ab500a_04-18-week2-PASSING_AND_PASSING,4,5,9,0,301,0,319
362828095,spring-cloud/spring-cloud-gcp,03/09/18 12:56,spirals-bears,0c1dbb4d-1cbc-485c-8949-10b1e9ab500a_04-18-week2-PASSING_AND_PASSING,4,2,6
363150693,spring-cloud/spring-cloud-gcp,03/09/18 12:57,spirals-bears,0c1dbb4d-1cbc-485c-8949-10b1e9ab500a_04-18-week2-PASSING_AND_PASSING,4,3,7
364294487,spring-cloud/spring-cloud-gcp,03/09/18 12:57,spirals-bears,0c1dbb4d-1cbc-485c-8949-10b1e9ab500a_04-18-week2-PASSING_AND_PASSING,4,5,10,0,248,0,267
363990150,apache/incubator-servicecomb-saga,03/09/18 12:58,spirals-bears,0c1dbb4d-1cbc-485c-8949-10b1e9ab500a_04-18-week2-PASSING_AND_PASSING,5,0,2,0,50,0,57
366295359,datastax/java-driver,03/09/18 12:58,spirals-bears,0c1dbb4d-1cbc-485c-8949-10b1e9ab500a_04-18-week2-PASSING_AND_PASSING,16,0,0,0,0,16
366305499,datastax/java-driver,03/09/18 12:58,spirals-bears,0c1dbb4d-1cbc-485c-8949-10b1e9ab500a_04-18-week2-PASSING_AND_PASSING,16,0,0,0,70,0,86
360448479,datastax/java-driver,03/09/18 12:59,spirals-bears,0c1dbb4d-1cbc-485c-8949-10b1e9ab500a_04-18-week2-PASSING_AND_PASSING,17,0,17
365809377,datastax/java-driver,03/09/18 13:01,spirals-bears,0c1dbb4d-1cbc-485c-8949-10b1e9ab500a_04-18-week2-PASSING_AND_PASSING,16,0,0,0,98,0,114
365800423,datastax/java-driver,03/09/18 13:01,spirals-bears,0c1dbb4d-1cbc-485c-8949-10b1e9ab500a_04-18-week2-PASSING_AND_PASSING,16,0,0,0,99,1,116
365353772,datastax/java-driver,03/09/18 13:01,spirals-bears,0c1dbb4d-1cbc-485c-8949-10b1e9ab500a_04-18-week2-PASSING_AND_PASSING,18,0,18
365213089,datastax/java-driver,03/09/18 13:02,spirals-bears,0c1dbb4d-1cbc-485c-8949-10b1e9ab500a_04-18-week2-PASSING_AND_PASSING,24,0,24
365213107,datastax/java-driver,03/09/18 13:02,spirals-bears,0c1dbb4d-1cbc-485c-8949-10b1e9ab500a_04-18-week2-PASSING_AND_PASSING,18,3,21
365205225,datastax/java-driver,03/09/18 13:03,spirals-bears,0c1dbb4d-1cbc-485c-8949-10b1e9ab500a_04-18-week2-PASSING_AND_PASSING,18,0,18
364211200,spring-cloud/spring-cloud-gcp,03/09/18 13:03,spirals-bears,0c1dbb4d-1cbc-485c-8949-10b1e9ab500a_04-18-week2-PASSING_AND_PASSING,4,109,102,0,235,0,450
365194982,datastax/java-driver,03/09/18 13:03,spirals-bears,0c1dbb4d-1cbc-485c-8949-10b1e9ab500a_04-18-week2-PASSING_AND_PASSING,17,0,17
364716176,datastax/java-driver,03/09/18 13:03,spirals-bears,0c1dbb4d-1cbc-485c-8949-10b1e9ab500a_04-18-week2-PASSING_AND_PASSING,16,0,16
360444695,datastax/java-driver,03/09/18 13:04,spirals-bears,0c1dbb4d-1cbc-485c-8949-10b1e9ab500a_04-18-week2-PASSING_AND_PASSING,15,0,15
360444859,datastax/java-driver,03/09/18 13:04,spirals-bears,0c1dbb4d-1cbc-485c-8949-10b1e9ab500a_04-18-week2-PASSING_AND_PASSING,17,3,20
366459043,alipay/sofa-rpc-boot-projects,03/09/18 13:04,spirals-bears,0c1dbb4d-1cbc-485c-8949-10b1e9ab500a_04-18-week2-PASSING_AND_PASSING,2,2,4
363130659,spring-cloud/spring-cloud-gcp,03/09/18 13:04,spirals-bears,0c1dbb4d-1cbc-485c-8949-10b1e9ab500a_04-18-week2-PASSING_AND_PASSING,4,111,100,0,226,0,441
366459030,alipay/sofa-rpc-boot-projects,03/09/18 13:04,spirals-bears,0c1dbb4d-1cbc-485c-8949-10b1e9ab500a_04-18-week2-PASSING_AND_PASSING,2,0,2
357543335,datastax/java-driver,03/09/18 13:04,spirals-bears,0c1dbb4d-1cbc-485c-8949-10b1e9ab500a_04-18-week2-PASSING_AND_PASSING,17,0,71,0,0,108,0,0,196
366388319,alipay/sofa-rpc-boot-projects,03/09/18 13:04,spirals-bears,0c1dbb4d-1cbc-485c-8949-10b1e9ab500a_04-18-week2-PASSING_AND_PASSING,3,0,3
366385702,alipay/sofa-rpc-boot-projects,03/09/18 13:04,spirals-bears,0c1dbb4d-1cbc-485c-8949-10b1e9ab500a_04-18-week2-PASSING_AND_PASSING,3,0,3
366422030,alipay/sofa-rpc-boot-projects,03/09/18 13:04,spirals-bears,0c1dbb4d-1cbc-485c-8949-10b1e9ab500a_04-18-week2-PASSING_AND_PASSING,2,0,1,0,35,0,38
366046139,alipay/sofa-rpc-boot-projects,03/09/18 13:04,spirals-bears,0c1dbb4d-1cbc-485c-8949-10b1e9ab500a_04-18-week2-PASSING_AND_PASSING,3,0,3
366012704,alipay/sofa-rpc-boot-projects,03/09/18 13:05,spirals-bears,0c1dbb4d-1cbc-485c-8949-10b1e9ab500a_04-18-week2-PASSING_AND_PASSING,4,0,4
366404174,alipay/sofa-rpc-boot-projects,03/09/18 13:05,spirals-bears,0c1dbb4d-1cbc-485c-8949-10b1e9ab500a_04-18-week2-PASSING_AND_PASSING,2,0,1,0,46,0,49
366087331,SzFMV2018-Tavasz/AutomatedCar,03/09/18 13:05,spirals-bears,0c1dbb4d-1cbc-485c-8949-10b1e9ab500a_04-18-week2-PASSING_AND_PASSING,10,0,0,0,20,0,30
366087334,SzFMV2018-Tavasz/AutomatedCar,03/09/18 13:05,spirals-bears,0c1dbb4d-1cbc-485c-8949-10b1e9ab500a_04-18-week2-PASSING_AND_PASSING,10,0,0,4,20,2,36
364266490,SzFMV2018-Tavasz/AutomatedCar,03/09/18 13:05,spirals-bears,0c1dbb4d-1cbc-485c-8949-10b1e9ab500a_04-18-week2-PASSING_AND_PASSING,10,0,0,0,19,0,29
364266495,SzFMV2018-Tavasz/AutomatedCar,03/09/18 13:06,spirals-bears,0c1dbb4d-1cbc-485c-8949-10b1e9ab500a_04-18-week2-PASSING_AND_PASSING,10,0,0,4,19,2,35
361884077,SzFMV2018-Tavasz/AutomatedCar,03/09/18 13:06,spirals-bears,0c1dbb4d-1cbc-485c-8949-10b1e9ab500a_04-18-week2-PASSING_AND_PASSING,11,0,0,0,19,0,30
364551611,SzFMV2018-Tavasz/AutomatedCar,03/09/18 13:06,spirals-bears,0c1dbb4d-1cbc-485c-8949-10b1e9ab500a_04-18-week2-PASSING_AND_PASSING,10,0,0,0,20,0,30
364550818,SzFMV2018-Tavasz/AutomatedCar,03/09/18 13:06,spirals-bears,0c1dbb4d-1cbc-485c-8949-10b1e9ab500a_04-18-week2-PASSING_AND_PASSING,9,0,0,4,20,4,37
356797318,SzFMV2018-Tavasz/AutomatedCar,03/09/18 13:06,spirals-bears,0c1dbb4d-1cbc-485c-8949-10b1e9ab500a_04-18-week2-PASSING_AND_PASSING,9,0,0,0,20,0,29
364602163,SzFMV2018-Tavasz/AutomatedCar,03/09/18 13:06,spirals-bears,0c1dbb4d-1cbc-485c-8949-10b1e9ab500a_04-18-week2-PASSING_AND_PASSING,10,0,0,0,20,0,30
364602177,SzFMV2018-Tavasz/AutomatedCar,03/09/18 13:07,spirals-bears,0c1dbb4d-1cbc-485c-8949-10b1e9ab500a_04-18-week2-PASSING_AND_PASSING,9,0,1,4,20,3,37
364671620,SzFMV2018-Tavasz/AutomatedCar,03/09/18 13:07,spirals-bears,0c1dbb4d-1cbc-485c-8949-10b1e9ab500a_04-18-week2-PASSING_AND_PASSING,10,0,0,4,21,2,37
364500052,SzFMV2018-Tavasz/AutomatedCar,03/09/18 13:07,spirals-bears,0c1dbb4d-1cbc-485c-8949-10b1e9ab500a_04-18-week2-PASSING_AND_PASSING,9,0,0,0,21,0,30
364550602,SzFMV2018-Tavasz/AutomatedCar,03/09/18 13:07,spirals-bears,0c1dbb4d-1cbc-485c-8949-10b1e9ab500a_04-18-week2-PASSING_AND_PASSING,9,0,0,0,19,0,28
361172109,SzFMV2018-Tavasz/AutomatedCar,03/09/18 13:08,spirals-bears,0c1dbb4d-1cbc-485c-8949-10b1e9ab500a_04-18-week2-PASSING_AND_PASSING,10,0,0,0,19,0,29
364462284,SzFMV2018-Tavasz/AutomatedCar,03/09/18 13:08,spirals-bears,0c1dbb4d-1cbc-485c-8949-10b1e9ab500a_04-18-week2-PASSING_AND_PASSING,9,0,14,1,0,22,0,0,46
364490361,SzFMV2018-Tavasz/AutomatedCar,03/09/18 13:08,spirals-bears,0c1dbb4d-1cbc-485c-8949-10b1e9ab500a_04-18-week2-PASSING_AND_PASSING,9,0,13,0,4,22,0,2,50
364063202,SzFMV2018-Tavasz/AutomatedCar,03/09/18 13:08,spirals-bears,0c1dbb4d-1cbc-485c-8949-10b1e9ab500a_04-18-week2-PASSING_AND_PASSING,10,0,15,0,0,21,0,0,46
358733613,SzFMV2018-Tavasz/AutomatedCar,03/09/18 13:08,spirals-bears,0c1dbb4d-1cbc-485c-8949-10b1e9ab500a_04-18-week2-PASSING_AND_PASSING,10,0,0,0,19,0,29
364284855,SzFMV2018-Tavasz/AutomatedCar,03/09/18 13:09,spirals-bears,0c1dbb4d-1cbc-485c-8949-10b1e9ab500a_04-18-week2-PASSING_AND_PASSING,10,0,0,0,18,0,28
364061555,SzFMV2018-Tavasz/AutomatedCar,03/09/18 13:09,spirals-bears,0c1dbb4d-1cbc-485c-8949-10b1e9ab500a_04-18-week2-PASSING_AND_PASSING,10,0,13,0,0,22,0,0,45
364277112,SzFMV2018-Tavasz/AutomatedCar,03/09/18 13:09,spirals-bears,0c1dbb4d-1cbc-485c-8949-10b1e9ab500a_04-18-week2-PASSING_AND_PASSING,11,0,13,0,4,22,0,2,52
364285431,SzFMV2018-Tavasz/AutomatedCar,03/09/18 13:09,spirals-bears,0c1dbb4d-1cbc-485c-8949-10b1e9ab500a_04-18-week2-PASSING_AND_PASSING,9,0,0,4,19,3,35
364245565,SzFMV2018-Tavasz/AutomatedCar,03/09/18 13:09,spirals-bears,0c1dbb4d-1cbc-485c-8949-10b1e9ab500a_04-18-week2-PASSING_AND_PASSING,9,0,0,4,19,3,35
364245560,SzFMV2018-Tavasz/AutomatedCar,03/09/18 13:10,spirals-bears,0c1dbb4d-1cbc-485c-8949-10b1e9ab500a_04-18-week2-PASSING_AND_PASSING,9,0,0,0,20,0,29
360870227,SzFMV2018-Tavasz/AutomatedCar,03/09/18 13:10,spirals-bears,0c1dbb4d-1cbc-485c-8949-10b1e9ab500a_04-18-week2-PASSING_AND_PASSING,9,0,16,0,0,22,0,0,47
363790523,SzFMV2018-Tavasz/AutomatedCar,03/09/18 13:10,spirals-bears,0c1dbb4d-1cbc-485c-8949-10b1e9ab500a_04-18-week2-PASSING_AND_PASSING,9,0,14,0,4,24,0,2,53
363789195,SzFMV2018-Tavasz/AutomatedCar,03/09/18 13:10,spirals-bears,0c1dbb4d-1cbc-485c-8949-10b1e9ab500a_04-18-week2-PASSING_AND_PASSING,10,0,0,0,21,0,31
361781645,SzFMV2018-Tavasz/AutomatedCar,03/09/18 13:10,spirals-bears,0c1dbb4d-1cbc-485c-8949-10b1e9ab500a_04-18-week2-PASSING_AND_PASSING,9,0,0,0,22,0,31
363789442,SzFMV2018-Tavasz/AutomatedCar,03/09/18 13:10,spirals-bears,0c1dbb4d-1cbc-485c-8949-10b1e9ab500a_04-18-week2-PASSING_AND_PASSING,12,0,15,0,0,22,0,0,49
363640729,SzFMV2018-Tavasz/AutomatedCar,03/09/18 13:11,spirals-bears,0c1dbb4d-1cbc-485c-8949-10b1e9ab500a_04-18-week2-PASSING_AND_PASSING,10,0,0,0,18,0,28
366183248,Activiti/activiti-cloud-service-common,03/09/18 13:11,spirals-bears,0c1dbb4d-1cbc-485c-8949-10b1e9ab500a_04-18-week2-PASSING_AND_PASSING,2,3,4,0,36,0,45
366183286,Activiti/activiti-cloud-service-common,03/09/18 13:11,spirals-bears,0c1dbb4d-1cbc-485c-8949-10b1e9ab500a_04-18-week2-PASSING_AND_PASSING,2,2,3,4,37,2,50
366122110,Activiti/activiti-cloud-service-common,03/09/18 13:12,spirals-bears,0c1dbb4d-1cbc-485c-8949-10b1e9ab500a_04-18-week2-PASSING_AND_PASSING,2,3,4,4,37,1,51
366122018,Activiti/activiti-cloud-service-common,03/09/18 13:12,spirals-bears,0c1dbb4d-1cbc-485c-8949-10b1e9ab500a_04-18-week2-PASSING_AND_PASSING,2,3,4,0,36,0,45
358460262,Activiti/activiti-cloud-service-common,03/09/18 13:12,spirals-bears,0c1dbb4d-1cbc-485c-8949-10b1e9ab500a_04-18-week2-PASSING_AND_PASSING,2,2,4,0,36,0,44
366495997,cpesch/RouteConverter,03/09/18 13:13,spirals-bears,0c1dbb4d-1cbc-485c-8949-10b1e9ab500a_04-18-week2-PASSING_AND_PASSING,22,0,0,0,38,0,60
364492028,dhis2/dhis2-core,03/09/18 13:15,spirals-bears,0c1dbb4d-1cbc-485c-8949-10b1e9ab500a_04-18-week2-PASSING_AND_PASSING,23,0,1,7,100,6,137
365036725,dhis2/dhis2-core,03/09/18 13:15,spirals-bears,0c1dbb4d-1cbc-485c-8949-10b1e9ab500a_04-18-week2-PASSING_AND_PASSING,25,0,0,6,96,12,139
364261144,cpesch/RouteConverter,03/09/18 13:16,spirals-bears,0c1dbb4d-1cbc-485c-8949-10b1e9ab500a_04-18-week2-PASSING_AND_PASSING,21,0,51,1,0,172,0,1,246
366531172,jcabi/jcabi-github,03/09/18 13:17,spirals-bears,0c1dbb4d-1cbc-485c-8949-10b1e9ab500a_04-18-week2-PASSING_AND_PASSING,21,0,45,1,0,349,0,0,416
365024459,dhis2/dhis2-core,03/09/18 13:18,spirals-bears,0c1dbb4d-1cbc-485c-8949-10b1e9ab500a_04-18-week2-PASSING_AND_PASSING,22,0,0,1,102,1,126
364601932,dhis2/dhis2-core,03/09/18 13:18,spirals-bears,0c1dbb4d-1cbc-485c-8949-10b1e9ab500a_04-18-week2-PASSING_AND_PASSING,23,0,0,1,84,2,110
364604593,dhis2/dhis2-core,03/09/18 13:19,spirals-bears,0c1dbb4d-1cbc-485c-8949-10b1e9ab500a_04-18-week2-PASSING_AND_PASSING,39,3,42
365116069,dhis2/dhis2-core,03/09/18 13:20,spirals-bears,0c1dbb4d-1cbc-485c-8949-10b1e9ab500a_04-18-week2-PASSING_AND_PASSING,24,0,0,6,106,6,142
364773780,dhis2/dhis2-core,03/09/18 13:21,spirals-bears,0c1dbb4d-1cbc-485c-8949-10b1e9ab500a_04-18-week2-PASSING_AND_PASSING,23,0,0,1,131,1,156
364481007,dhis2/dhis2-core,03/09/18 13:21,spirals-bears,0c1dbb4d-1cbc-485c-8949-10b1e9ab500a_04-18-week2-PASSING_AND_PASSING,21,3,24
364769420,dhis2/dhis2-core,03/09/18 13:22,spirals-bears,0c1dbb4d-1cbc-485c-8949-10b1e9ab500a_04-18-week2-PASSING_AND_PASSING,23,0,0,0,146,1,170
364523968,dhis2/dhis2-core,03/09/18 13:22,spirals-bears,0c1dbb4d-1cbc-485c-8949-10b1e9ab500a_04-18-week2-PASSING_AND_PASSING,22,0,0,1,113,1,137
364005069,dhis2/dhis2-core,03/09/18 13:24,spirals-bears,0c1dbb4d-1cbc-485c-8949-10b1e9ab500a_04-18-week2-PASSING_AND_PASSING,23,0,0,6,101,5,135
364068109,dhis2/dhis2-core,03/09/18 13:24,spirals-bears,0c1dbb4d-1cbc-485c-8949-10b1e9ab500a_04-18-week2-PASSING_AND_PASSING,23,0,0,1,86,3,113
364064526,dhis2/dhis2-core,03/09/18 13:25,spirals-bears,0c1dbb4d-1cbc-485c-8949-10b1e9ab500a_04-18-week2-PASSING_AND_PASSING,23,0,1,1,105,2,132
365246679,dhis2/dhis2-core,03/09/18 13:26,spirals-bears,0c1dbb4d-1cbc-485c-8949-10b1e9ab500a_04-18-week2-PASSING_AND_PASSING,12,7,0,0,11,15,0,0,7,0,389,0,0,0,15,0,22,6,6,180,670
364064264,dhis2/dhis2-core,03/09/18 13:27,spirals-bears,0c1dbb4d-1cbc-485c-8949-10b1e9ab500a_04-18-week2-PASSING_AND_PASSING,23,0,0,1,103,1,128
362512038,dhis2/dhis2-core,03/09/18 13:27,spirals-bears,0c1dbb4d-1cbc-485c-8949-10b1e9ab500a_04-18-week2-PASSING_AND_PASSING,23,3,26
363453456,dhis2/dhis2-core,03/09/18 13:27,spirals-bears,0c1dbb4d-1cbc-485c-8949-10b1e9ab500a_04-18-week2-PASSING_AND_PASSING,24,0,0,1,104,1,130
362454943,dhis2/dhis2-core,03/09/18 13:29,spirals-bears,0c1dbb4d-1cbc-485c-8949-10b1e9ab500a_04-18-week2-PASSING_AND_PASSING,23,0,0,7,100,9,139
362984240,debezium/debezium,03/09/18 13:30,spirals-bears,0c1dbb4d-1cbc-485c-8949-10b1e9ab500a_04-18-week2-PASSING_AND_PASSING,8,0,0,3,5,16
365940156,debezium/debezium,03/09/18 13:30,spirals-bears,0c1dbb4d-1cbc-485c-8949-10b1e9ab500a_04-18-week2-PASSING_AND_PASSING,6,0,0,4,4,14
363191917,debezium/debezium,03/09/18 13:31,spirals-bears,0c1dbb4d-1cbc-485c-8949-10b1e9ab500a_04-18-week2-PASSING_AND_PASSING,7,0,52,1,0,132,0,0,192
365078426,debezium/debezium,03/09/18 13:31,spirals-bears,0c1dbb4d-1cbc-485c-8949-10b1e9ab500a_04-18-week2-PASSING_AND_PASSING,6,0,54,1,5,132,0,4,202
356767152,MyCoRe-Org/mycore,03/09/18 13:32,spirals-bears,0c1dbb4d-1cbc-485c-8949-10b1e9ab500a_04-18-week2-PASSING_AND_PASSING,49,0,49
356767168,MyCoRe-Org/mycore,03/09/18 13:32,spirals-bears,0c1dbb4d-1cbc-485c-8949-10b1e9ab500a_04-18-week2-PASSING_AND_PASSING,46,3,49
362590435,debezium/debezium,03/09/18 13:32,spirals-bears,0c1dbb4d-1cbc-485c-8949-10b1e9ab500a_04-18-week2-PASSING_AND_PASSING,6,0,1,5,101,8,121
351348267,MyCoRe-Org/mycore,03/09/18 13:33,spirals-bears,0c1dbb4d-1cbc-485c-8949-10b1e9ab500a_04-18-week2-PASSING_AND_PASSING,50,0,50
351348480,MyCoRe-Org/mycore,03/09/18 13:33,spirals-bears,0c1dbb4d-1cbc-485c-8949-10b1e9ab500a_04-18-week2-PASSING_AND_PASSING,57,2,59
330728874,MyCoRe-Org/mycore,03/09/18 13:33,spirals-bears,0c1dbb4d-1cbc-485c-8949-10b1e9ab500a_04-18-week2-PASSING_AND_PASSING,49,0,49
361632752,MyCoRe-Org/mycore,03/09/18 13:34,spirals-bears,0c1dbb4d-1cbc-485c-8949-10b1e9ab500a_04-18-week2-PASSING_AND_PASSING,85,2,87
360275053,2018swecapstone/h2ms,03/09/18 13:35,spirals-bears,0c1dbb4d-1cbc-485c-8949-10b1e9ab500a_04-18-week2-PASSING_AND_PASSING,4,0,1,0,62,0,67
365891172,2018swecapstone/h2ms,03/09/18 13:35,spirals-bears,0c1dbb4d-1cbc-485c-8949-10b1e9ab500a_04-18-week2-PASSING_AND_PASSING,3,0,1,4,5,13
363044731,dhis2/dhis2-core,03/09/18 13:35,spirals-bears,0c1dbb4d-1cbc-485c-8949-10b1e9ab500a_04-18-week2-PASSING_AND_PASSING,11,0,0,213,0,0,9,0,200,0,0,14,0,24,10,174,655
365890851,2018swecapstone/h2ms,03/09/18 13:38,spirals-bears,0c1dbb4d-1cbc-485c-8949-10b1e9ab500a_04-18-week2-PASSING_AND_PASSING,4,0,105,1,0,74,0,0,184
362708839,MyCoRe-Org/mycore,03/09/18 13:38,spirals-bears,0c1dbb4d-1cbc-485c-8949-10b1e9ab500a_04-18-week2-PASSING_AND_PASSING,51,27,43,1,193,0,315
365877927,2018swecapstone/h2ms,03/09/18 13:40,spirals-bears,0c1dbb4d-1cbc-485c-8949-10b1e9ab500a_04-18-week2-PASSING_AND_PASSING,13,0,0,0,4,106,0,2,1,0,101,0,0,0,13,0,3,1,1,69,314
365777549,2018swecapstone/h2ms,03/09/18 13:40,spirals-bears,0c1dbb4d-1cbc-485c-8949-10b1e9ab500a_04-18-week2-PASSING_AND_PASSING,13,0,0,2,5,105,0,2,1,0,100,0,4,0,13,2,4,0,0,69,320
365872725,2018swecapstone/h2ms,03/09/18 13:43,spirals-bears,0c1dbb4d-1cbc-485c-8949-10b1e9ab500a_04-18-week2-PASSING_AND_PASSING,13,0,0,0,4,97,0,2,1,0,98,0,0,0,13,0,3,0,0,66,297
365732107,2018swecapstone/h2ms,03/09/18 13:44,spirals-bears,0c1dbb4d-1cbc-485c-8949-10b1e9ab500a_04-18-week2-PASSING_AND_PASSING,4,0,95,1,4,69,0,3,176
365383650,2018swecapstone/h2ms,03/09/18 13:44,spirals-bears,0c1dbb4d-1cbc-485c-8949-10b1e9ab500a_04-18-week2-PASSING_AND_PASSING,4,0,103,1,4,68,0,2,182
365876936,2018swecapstone/h2ms,03/09/18 13:44,spirals-bears,0c1dbb4d-1cbc-485c-8949-10b1e9ab500a_04-18-week2-PASSING_AND_PASSING,13,0,0,2,5,104,0,1,0,0,104,0,5,0,13,2,3,0,0,65,317
365448870,2018swecapstone/h2ms,03/09/18 13:45,spirals-bears,0c1dbb4d-1cbc-485c-8949-10b1e9ab500a_04-18-week2-PASSING_AND_PASSING,3,0,1,0,62,0,66
365402411,2018swecapstone/h2ms,03/09/18 13:46,spirals-bears,0c1dbb4d-1cbc-485c-8949-10b1e9ab500a_04-18-week2-PASSING_AND_PASSING,3,0,89,1,4,71,0,3,171
364871463,2018swecapstone/h2ms,03/09/18 13:46,spirals-bears,0c1dbb4d-1cbc-485c-8949-10b1e9ab500a_04-18-week2-PASSING_AND_PASSING,3,0,2,5,60,2,72
365351526,2018swecapstone/h2ms,03/09/18 13:47,spirals-bears,0c1dbb4d-1cbc-485c-8949-10b1e9ab500a_04-18-week2-PASSING_AND_PASSING,5,0,89,2,4,67,0,3,170
365455382,2018swecapstone/h2ms,03/09/18 13:47,spirals-bears,0c1dbb4d-1cbc-485c-8949-10b1e9ab500a_04-18-week2-PASSING_AND_PASSING,3,0,88,2,0,70,0,0,163
364793316,2018swecapstone/h2ms,03/09/18 13:48,spirals-bears,0c1dbb4d-1cbc-485c-8949-10b1e9ab500a_04-18-week2-PASSING_AND_PASSING,4,0,2,0,63,0,69
364859500,2018swecapstone/h2ms,03/09/18 13:50,spirals-bears,0c1dbb4d-1cbc-485c-8949-10b1e9ab500a_04-18-week2-PASSING_AND_PASSING,3,0,87,2,5,69,0,4,170
363627522,2018swecapstone/h2ms,03/09/18 13:51,spirals-bears,0c1dbb4d-1cbc-485c-8949-10b1e9ab500a_04-18-week2-PASSING_AND_PASSING,14,0,0,0,4,81,0,2,0,0,80,0,0,0,12,0,3,2,0,68,266
363611199,2018swecapstone/h2ms,03/09/18 13:51,spirals-bears,0c1dbb4d-1cbc-485c-8949-10b1e9ab500a_04-18-week2-PASSING_AND_PASSING,12,1,0,2,4,81,0,1,0,0,79,0,5,0,12,2,3,0,1,68,271
365501028,alipay/sofa-rpc,03/09/18 13:52,spirals-bears,0c1dbb4d-1cbc-485c-8949-10b1e9ab500a_04-18-week2-PASSING_AND_PASSING,3,0,3
363210218,2018swecapstone/h2ms,03/09/18 13:52,spirals-bears,0c1dbb4d-1cbc-485c-8949-10b1e9ab500a_04-18-week2-PASSING_AND_PASSING,13,1,0,0,4,73,0,1,0,0,75,0,0,0,11,0,5,0,0,64,247
365250509,alipay/sofa-rpc,03/09/18 13:53,spirals-bears,0c1dbb4d-1cbc-485c-8949-10b1e9ab500a_04-18-week2-PASSING_AND_PASSING,4,6,7,0,40,0,57
365919073,alipay/sofa-rpc,03/09/18 13:54,spirals-bears,0c1dbb4d-1cbc-485c-8949-10b1e9ab500a_04-18-week2-PASSING_AND_PASSING,4,5,0,17,0,7,1,6,15,0,0,22,0,5,0,47,129
364757074,alipay/sofa-rpc,03/09/18 13:54,spirals-bears,0c1dbb4d-1cbc-485c-8949-10b1e9ab500a_04-18-week2-PASSING_AND_PASSING,4,6,7,0,0,17
364753637,alipay/sofa-rpc,03/09/18 13:54,spirals-bears,0c1dbb4d-1cbc-485c-8949-10b1e9ab500a_04-18-week2-PASSING_AND_PASSING,4,0,4
364667515,alipay/sofa-rpc,03/09/18 13:54,spirals-bears,0c1dbb4d-1cbc-485c-8949-10b1e9ab500a_04-18-week2-PASSING_AND_PASSING,5,0,5
289958093,fabric8io/fabric8-maven-plugin,03/09/18 13:55,spirals-bears,0c1dbb4d-1cbc-485c-8949-10b1e9ab500a_04-18-week2-PASSING_AND_PASSING,29,4,33
362314571,fabric8io/fabric8-maven-plugin,03/09/18 13:55,spirals-bears,0c1dbb4d-1cbc-485c-8949-10b1e9ab500a_04-18-week2-PASSING_AND_PASSING,29,4,33
362440955,2018swecapstone/h2ms,03/09/18 13:55,spirals-bears,0c1dbb4d-1cbc-485c-8949-10b1e9ab500a_04-18-week2-PASSING_AND_PASSING,13,0,0,2,8,86,0,2,0,0,84,0,4,0,12,2,3,0,0,67,283
357320065,fabric8io/fabric8-maven-plugin,03/09/18 13:55,spirals-bears,0c1dbb4d-1cbc-485c-8949-10b1e9ab500a_04-18-week2-PASSING_AND_PASSING,30,6,36
366135485,fabric8io/fabric8-maven-plugin,03/09/18 13:56,spirals-bears,0c1dbb4d-1cbc-485c-8949-10b1e9ab500a_04-18-week2-PASSING_AND_PASSING,30,0,3,4,6,43
357264848,fabric8io/fabric8-maven-plugin,03/09/18 13:56,spirals-bears,0c1dbb4d-1cbc-485c-8949-10b1e9ab500a_04-18-week2-PASSING_AND_PASSING,41,10,51
365423421,alipay/sofa-rpc,03/09/18 13:56,spirals-bears,0c1dbb4d-1cbc-485c-8949-10b1e9ab500a_04-18-week2-PASSING_AND_PASSING,4,6,0,15,0,7,3,5,14,0,0,86,0,3,4,114,261
365515217,fabric8io/fabric8-maven-plugin,03/09/18 13:56,spirals-bears,0c1dbb4d-1cbc-485c-8949-10b1e9ab500a_04-18-week2-PASSING_AND_PASSING,32,0,2,4,6,44
365968055,fabric8io/fabric8-maven-plugin,03/09/18 13:56,spirals-bears,0c1dbb4d-1cbc-485c-8949-10b1e9ab500a_04-18-week2-PASSING_AND_PASSING,30,7,37
365931748,fabric8io/fabric8-maven-plugin,03/09/18 13:57,spirals-bears,0c1dbb4d-1cbc-485c-8949-10b1e9ab500a_04-18-week2-PASSING_AND_PASSING,28,6,34
365944238,fabric8io/fabric8-maven-plugin,03/09/18 13:57,spirals-bears,0c1dbb4d-1cbc-485c-8949-10b1e9ab500a_04-18-week2-PASSING_AND_PASSING,28,7,35
365778229,fabric8io/fabric8-maven-plugin,03/09/18 13:57,spirals-bears,0c1dbb4d-1cbc-485c-8949-10b1e9ab500a_04-18-week2-PASSING_AND_PASSING,28,7,35
366002226,fabric8io/fabric8-maven-plugin,03/09/18 13:57,spirals-bears,0c1dbb4d-1cbc-485c-8949-10b1e9ab500a_04-18-week2-PASSING_AND_PASSING,31,0,2,4,7,44
365627974,fabric8io/fabric8-maven-plugin,03/09/18 13:58,spirals-bears,0c1dbb4d-1cbc-485c-8949-10b1e9ab500a_04-18-week2-PASSING_AND_PASSING,30,6,36
365760731,fabric8io/fabric8-maven-plugin,03/09/18 13:58,spirals-bears,0c1dbb4d-1cbc-485c-8949-10b1e9ab500a_04-18-week2-PASSING_AND_PASSING,31,6,37
365264056,fabric8io/fabric8-maven-plugin,03/09/18 13:58,spirals-bears,0c1dbb4d-1cbc-485c-8949-10b1e9ab500a_04-18-week2-PASSING_AND_PASSING,32,6,38
365235548,fabric8io/fabric8-maven-plugin,03/09/18 13:58,spirals-bears,0c1dbb4d-1cbc-485c-8949-10b1e9ab500a_04-18-week2-PASSING_AND_PASSING,32,6,38
365103382,Activiti/Activiti,03/09/18 13:59,spirals-bears,0c1dbb4d-1cbc-485c-8949-10b1e9ab500a_04-18-week2-PASSING_AND_PASSING,35,0,35
365104655,Activiti/Activiti,03/09/18 13:59,spirals-bears,0c1dbb4d-1cbc-485c-8949-10b1e9ab500a_04-18-week2-PASSING_AND_PASSING,33,4,37
365957092,jdbi/jdbi,03/09/18 14:14,spirals-bears,0c1dbb4d-1cbc-485c-8949-10b1e9ab500a_04-18-week2-PASSING_AND_PASSING,12,0,0,31,0,1,1,0,27,0,0,254,0,9,2,539,876
366289648,jdbi/jdbi,03/09/18 14:14,spirals-bears,0c1dbb4d-1cbc-485c-8949-10b1e9ab500a_04-18-week2-PASSING_AND_PASSING,9,0,3,34,0,1,2,0,29,4,0,258,2,9,1,538,890
366340006,jdbi/jdbi,03/09/18 14:14,spirals-bears,0c1dbb4d-1cbc-485c-8949-10b1e9ab500a_04-18-week2-PASSING_AND_PASSING,7,0,2,31,0,1,1,0,30,5,0,252,2,8,2,584,925
366324395,jdbi/jdbi,03/09/18 14:14,spirals-bears,0c1dbb4d-1cbc-485c-8949-10b1e9ab500a_04-18-week2-PASSING_AND_PASSING,7,0,2,34,0,1,1,0,29,4,0,255,2,10,1,599,945
365154029,jdbi/jdbi,03/09/18 14:16,spirals-bears,0c1dbb4d-1cbc-485c-8949-10b1e9ab500a_04-18-week2-PASSING_AND_PASSING,9,0,1,0,122,0,132
365674940,jdbi/jdbi,03/09/18 14:16,spirals-bears,0c1dbb4d-1cbc-485c-8949-10b1e9ab500a_04-18-week2-PASSING_AND_PASSING,10,0,1,4,138,4,157
364571840,B3Partners/brmo,03/09/18 14:18,spirals-bears,0c1dbb4d-1cbc-485c-8949-10b1e9ab500a_04-18-week2-PASSING_AND_PASSING,87,0,3,0,1,91
364571852,B3Partners/brmo,03/09/18 14:18,spirals-bears,0c1dbb4d-1cbc-485c-8949-10b1e9ab500a_04-18-week2-PASSING_AND_PASSING,83,0,3,6,7,99
364507185,B3Partners/brmo,03/09/18 14:20,spirals-bears,0c1dbb4d-1cbc-485c-8949-10b1e9ab500a_04-18-week2-PASSING_AND_PASSING,80,4,84
364507105,B3Partners/brmo,03/09/18 14:20,spirals-bears,0c1dbb4d-1cbc-485c-8949-10b1e9ab500a_04-18-week2-PASSING_AND_PASSING,83,0,83
364476931,B3Partners/brmo,03/09/18 14:21,spirals-bears,0c1dbb4d-1cbc-485c-8949-10b1e9ab500a_04-18-week2-PASSING_AND_PASSING,75,0,75
364476914,B3Partners/brmo,03/09/18 14:21,spirals-bears,0c1dbb4d-1cbc-485c-8949-10b1e9ab500a_04-18-week2-PASSING_AND_PASSING,85,3,88
364272581,B3Partners/brmo,03/09/18 14:23,spirals-bears,0c1dbb4d-1cbc-485c-8949-10b1e9ab500a_04-18-week2-PASSING_AND_PASSING,89,4,93
364272537,B3Partners/brmo,03/09/18 14:23,spirals-bears,0c1dbb4d-1cbc-485c-8949-10b1e9ab500a_04-18-week2-PASSING_AND_PASSING,95,0,95
364193541,B3Partners/brmo,03/09/18 14:25,spirals-bears,0c1dbb4d-1cbc-485c-8949-10b1e9ab500a_04-18-week2-PASSING_AND_PASSING,80,4,84
364193526,B3Partners/brmo,03/09/18 14:25,spirals-bears,0c1dbb4d-1cbc-485c-8949-10b1e9ab500a_04-18-week2-PASSING_AND_PASSING,92,0,92
364094540,B3Partners/brmo,03/09/18 14:26,spirals-bears,0c1dbb4d-1cbc-485c-8949-10b1e9ab500a_04-18-week2-PASSING_AND_PASSING,86,3,89
364090538,B3Partners/brmo,03/09/18 14:27,spirals-bears,0c1dbb4d-1cbc-485c-8949-10b1e9ab500a_04-18-week2-PASSING_AND_PASSING,116,0,116
361455947,jdbi/jdbi,03/09/18 14:27,spirals-bears,0c1dbb4d-1cbc-485c-8949-10b1e9ab500a_04-18-week2-PASSING_AND_PASSING,10,0,0,29,0,1,2,0,24,0,0,208,0,9,3,473,759
364604694,jdbi/jdbi,03/09/18 14:27,spirals-bears,0c1dbb4d-1cbc-485c-8949-10b1e9ab500a_04-18-week2-PASSING_AND_PASSING,8,0,4,25,0,1,3,0,25,5,0,207,3,8,3,468,760
365493371,Spirals-Team/repairnator,03/09/18 14:27,spirals-bears,0c1dbb4d-1cbc-485c-8949-10b1e9ab500a_04-18-week2-PASSING_AND_PASSING,18,3,21
365493954,Spirals-Team/repairnator,03/09/18 14:28,spirals-bears,0c1dbb4d-1cbc-485c-8949-10b1e9ab500a_04-18-week2-PASSING_AND_PASSING,19,0,19
365493956,Spirals-Team/repairnator,03/09/18 14:28,spirals-bears,0c1dbb4d-1cbc-485c-8949-10b1e9ab500a_04-18-week2-PASSING_AND_PASSING,20,3,23
362634844,Spirals-Team/repairnator,03/09/18 14:28,spirals-bears,0c1dbb4d-1cbc-485c-8949-10b1e9ab500a_04-18-week2-PASSING_AND_PASSING,18,0,18
363995448,B3Partners/brmo,03/09/18 14:28,spirals-bears,0c1dbb4d-1cbc-485c-8949-10b1e9ab500a_04-18-week2-PASSING_AND_PASSING,91,0,91
362635031,Spirals-Team/repairnator,03/09/18 14:28,spirals-bears,0c1dbb4d-1cbc-485c-8949-10b1e9ab500a_04-18-week2-PASSING_AND_PASSING,18,3,21
365210013,Spirals-Team/repairnator,03/09/18 14:28,spirals-bears,0c1dbb4d-1cbc-485c-8949-10b1e9ab500a_04-18-week2-PASSING_AND_PASSING,23,3,26
360680423,jnidzwetzki/bboxdb,03/09/18 14:29,spirals-bears,0c1dbb4d-1cbc-485c-8949-10b1e9ab500a_04-18-week2-PASSING_AND_PASSING,14,0,0,0,34,0,48
365037935,jnidzwetzki/bboxdb,03/09/18 14:29,spirals-bears,0c1dbb4d-1cbc-485c-8949-10b1e9ab500a_04-18-week2-PASSING_AND_PASSING,9,0,0,0,32,0,41
365035556,jnidzwetzki/bboxdb,03/09/18 14:29,spirals-bears,0c1dbb4d-1cbc-485c-8949-10b1e9ab500a_04-18-week2-PASSING_AND_PASSING,8,0,0,0,32,0,40
365010533,jnidzwetzki/bboxdb,03/09/18 14:30,spirals-bears,0c1dbb4d-1cbc-485c-8949-10b1e9ab500a_04-18-week2-PASSING_AND_PASSING,9,0,0,0,31,0,40
365001094,jnidzwetzki/bboxdb,03/09/18 14:31,spirals-bears,0c1dbb4d-1cbc-485c-8949-10b1e9ab500a_04-18-week2-PASSING_AND_PASSING,7,0,0,0,31,0,38
365021680,jnidzwetzki/bboxdb,03/09/18 14:32,spirals-bears,0c1dbb4d-1cbc-485c-8949-10b1e9ab500a_04-18-week2-PASSING_AND_PASSING,6,0,0,37,0,0,1,0,35,0,0,14,0,8,0,54,155
365031009,jnidzwetzki/bboxdb,03/09/18 14:32,spirals-bears,0c1dbb4d-1cbc-485c-8949-10b1e9ab500a_04-18-week2-PASSING_AND_PASSING,6,0,0,37,0,0,1,0,34,0,0,18,0,9,1,80,186
365002260,jnidzwetzki/bboxdb,03/09/18 14:32,spirals-bears,0c1dbb4d-1cbc-485c-8949-10b1e9ab500a_04-18-week2-PASSING_AND_PASSING,6,0,0,37,0,0,1,0,35,0,0,16,0,8,1,77,181
364984278,jnidzwetzki/bboxdb,03/09/18 14:34,spirals-bears,0c1dbb4d-1cbc-485c-8949-10b1e9ab500a_04-18-week2-PASSING_AND_PASSING,4,0,0,36,0,0,1,0,32,0,0,15,0,8,0,76,172
364951577,jnidzwetzki/bboxdb,03/09/18 14:35,spirals-bears,0c1dbb4d-1cbc-485c-8949-10b1e9ab500a_04-18-week2-PASSING_AND_PASSING,6,0,0,35,0,0,1,0,34,0,0,18,0,8,1,76,179
364972360,jnidzwetzki/bboxdb,03/09/18 14:35,spirals-bears,0c1dbb4d-1cbc-485c-8949-10b1e9ab500a_04-18-week2-PASSING_AND_PASSING,6,0,0,36,0,0,2,0,34,0,0,18,0,8,1,79,184
364949266,jnidzwetzki/bboxdb,03/09/18 14:35,spirals-bears,0c1dbb4d-1cbc-485c-8949-10b1e9ab500a_04-18-week2-PASSING_AND_PASSING,5,0,0,36,0,0,1,0,35,0,0,16,0,9,0,78,180
364025824,jnidzwetzki/bboxdb,03/09/18 14:36,spirals-bears,0c1dbb4d-1cbc-485c-8949-10b1e9ab500a_04-18-week2-PASSING_AND_PASSING,8,0,0,0,32,0,40
363860293,jnidzwetzki/bboxdb,03/09/18 14:36,spirals-bears,0c1dbb4d-1cbc-485c-8949-10b1e9ab500a_04-18-week2-PASSING_AND_PASSING,9,0,0,0,30,0,39
363678379,jnidzwetzki/bboxdb,03/09/18 14:37,spirals-bears,0c1dbb4d-1cbc-485c-8949-10b1e9ab500a_04-18-week2-PASSING_AND_PASSING,11,0,0,0,29,0,40
364524002,jnidzwetzki/bboxdb,03/09/18 14:37,spirals-bears,0c1dbb4d-1cbc-485c-8949-10b1e9ab500a_04-18-week2-PASSING_AND_PASSING,5,0,0,35,0,0,1,0,34,0,0,16,0,8,1,68,168
365959117,jacoco/jacoco,03/09/18 14:37,spirals-bears,0c1dbb4d-1cbc-485c-8949-10b1e9ab500a_04-18-week2-PASSING_AND_PASSING,7,2,9
363676749,jnidzwetzki/bboxdb,03/09/18 14:37,spirals-bears,0c1dbb4d-1cbc-485c-8949-10b1e9ab500a_04-18-week2-PASSING_AND_PASSING,8,0,1,0,32,0,41
365958964,jacoco/jacoco,03/09/18 14:37,spirals-bears,0c1dbb4d-1cbc-485c-8949-10b1e9ab500a_04-18-week2-PASSING_AND_PASSING,6,0,6
363674204,jnidzwetzki/bboxdb,03/09/18 14:37,spirals-bears,0c1dbb4d-1cbc-485c-8949-10b1e9ab500a_04-18-week2-PASSING_AND_PASSING,9,0,0,0,31,0,40
364255948,jnidzwetzki/bboxdb,03/09/18 14:38,spirals-bears,0c1dbb4d-1cbc-485c-8949-10b1e9ab500a_04-18-week2-PASSING_AND_PASSING,6,0,0,35,0,0,1,0,33,0,0,14,0,9,1,72,171
