353269823,apache/flink,28/08/18 15:04,spirals-bears,9575d8af-9671-4a9d-853f-fad6e89e933b_03-18-week2-FAILING_AND_PASSING,61,6,67
350452321,apache/flink,28/08/18 15:04,spirals-bears,9575d8af-9671-4a9d-853f-fad6e89e933b_03-18-week2-FAILING_AND_PASSING,63,6,69
353278341,apache/flink,28/08/18 15:06,spirals-bears,9575d8af-9671-4a9d-853f-fad6e89e933b_03-18-week2-FAILING_AND_PASSING,64,6,70
353208597,apache/flink,28/08/18 15:06,spirals-bears,9575d8af-9671-4a9d-853f-fad6e89e933b_03-18-week2-FAILING_AND_PASSING,64,11,75
352579939,apache/flink,28/08/18 15:07,spirals-bears,9575d8af-9671-4a9d-853f-fad6e89e933b_03-18-week2-FAILING_AND_PASSING,60,6,66
352770889,apache/flink,28/08/18 15:07,spirals-bears,9575d8af-9671-4a9d-853f-fad6e89e933b_03-18-week2-FAILING_AND_PASSING,78,6,84
350178832,apache/flink,28/08/18 15:09,spirals-bears,9575d8af-9671-4a9d-853f-fad6e89e933b_03-18-week2-FAILING_AND_PASSING,61,7,68
352675073,apache/flink,28/08/18 15:09,spirals-bears,9575d8af-9671-4a9d-853f-fad6e89e933b_03-18-week2-FAILING_AND_PASSING,79,6,85
351625707,apache/flink,28/08/18 15:10,spirals-bears,9575d8af-9671-4a9d-853f-fad6e89e933b_03-18-week2-FAILING_AND_PASSING,60,6,66
353225063,apache/flink,28/08/18 15:51,spirals-bears,9575d8af-9671-4a9d-853f-fad6e89e933b_03-18-week2-FAILING_AND_PASSING,9,0,2,0,3,126,1,43,899,5,47,1626,68,1,2830
353015634,apache/flink,28/08/18 15:52,spirals-bears,9575d8af-9671-4a9d-853f-fad6e89e933b_03-18-week2-FAILING_AND_PASSING,10,0,12,0,1,143,0,43,960,8,50,1639,77,1,2944
349312194,apache/flink,28/08/18 15:54,spirals-bears,9575d8af-9671-4a9d-853f-fad6e89e933b_03-18-week2-FAILING_AND_PASSING,61,5,66
352233920,apache/flink,28/08/18 15:56,spirals-bears,9575d8af-9671-4a9d-853f-fad6e89e933b_03-18-week2-FAILING_AND_PASSING,12,0,1,1,2,152,0,36,754,4,50,1673,63,5,2753
352215867,apache/flink,28/08/18 15:59,spirals-bears,9575d8af-9671-4a9d-853f-fad6e89e933b_03-18-week2-FAILING_AND_PASSING,12,0,8,1,1,149,2,36,979,22,47,1669,91,5,3022
351997310,apache/flink,28/08/18 16:41,spirals-bears,9575d8af-9671-4a9d-853f-fad6e89e933b_03-18-week2-FAILING_AND_PASSING,14,0,2,0,2,111,0,48,877,4,47,1641,60,1,2807
351467161,prestodb/presto,28/08/18 16:42,spirals-bears,9575d8af-9671-4a9d-853f-fad6e89e933b_03-18-week2-FAILING_AND_PASSING,43,5,48
351253643,apache/flink,28/08/18 16:43,spirals-bears,9575d8af-9671-4a9d-853f-fad6e89e933b_03-18-week2-FAILING_AND_PASSING,10,0,12,1,2,115,0,42,1165,9,53,1620,59,2,3090
353150227,prestodb/presto,28/08/18 16:43,spirals-bears,9575d8af-9671-4a9d-853f-fad6e89e933b_03-18-week2-FAILING_AND_PASSING,43,6,49
351446889,apache/flink,28/08/18 16:43,spirals-bears,9575d8af-9671-4a9d-853f-fad6e89e933b_03-18-week2-FAILING_AND_PASSING,10,0,2,0,1,133,1,38,846,4,58,1657,62,2,2814
352652118,prestodb/presto,28/08/18 16:44,spirals-bears,9575d8af-9671-4a9d-853f-fad6e89e933b_03-18-week2-FAILING_AND_PASSING,44,4,48
346551519,prestodb/presto,28/08/18 16:44,spirals-bears,9575d8af-9671-4a9d-853f-fad6e89e933b_03-18-week2-FAILING_AND_PASSING,44,5,49
352107197,prestodb/presto,28/08/18 16:45,spirals-bears,9575d8af-9671-4a9d-853f-fad6e89e933b_03-18-week2-FAILING_AND_PASSING,48,8,56
351923128,prestodb/presto,28/08/18 16:45,spirals-bears,9575d8af-9671-4a9d-853f-fad6e89e933b_03-18-week2-FAILING_AND_PASSING,43,9,52
350081824,prestodb/presto,28/08/18 16:45,spirals-bears,9575d8af-9671-4a9d-853f-fad6e89e933b_03-18-week2-FAILING_AND_PASSING,49,7,56
351185105,prestodb/presto,28/08/18 16:46,spirals-bears,9575d8af-9671-4a9d-853f-fad6e89e933b_03-18-week2-FAILING_AND_PASSING,44,5,49
351493712,prestodb/presto,28/08/18 16:46,spirals-bears,9575d8af-9671-4a9d-853f-fad6e89e933b_03-18-week2-FAILING_AND_PASSING,59,8,67
351012900,prestodb/presto,28/08/18 16:46,spirals-bears,9575d8af-9671-4a9d-853f-fad6e89e933b_03-18-week2-FAILING_AND_PASSING,46,4,50
350320899,apache/flink,28/08/18 16:47,spirals-bears,9575d8af-9671-4a9d-853f-fad6e89e933b_03-18-week2-FAILING_AND_PASSING,12,0,2,0,1,135,0,50,806,4,49,1695,65,2,2821
351035926,prestodb/presto,28/08/18 16:47,spirals-bears,9575d8af-9671-4a9d-853f-fad6e89e933b_03-18-week2-FAILING_AND_PASSING,44,5,49
353418500,apache/incubator-druid,28/08/18 16:48,spirals-bears,9575d8af-9671-4a9d-853f-fad6e89e933b_03-18-week2-FAILING_AND_PASSING,38,12,50
350263821,prestodb/presto,28/08/18 16:48,spirals-bears,9575d8af-9671-4a9d-853f-fad6e89e933b_03-18-week2-FAILING_AND_PASSING,54,9,63
351035986,prestodb/presto,28/08/18 17:15,spirals-bears,9575d8af-9671-4a9d-853f-fad6e89e933b_03-18-week2-FAILING_AND_PASSING,794,889,48,0,3,2,1736
350257974,prestodb/presto,28/08/18 17:16,spirals-bears,9575d8af-9671-4a9d-853f-fad6e89e933b_03-18-week2-FAILING_AND_PASSING,813,905,44,0,6,1,1769
352190821,apache/incubator-druid,28/08/18 17:23,spirals-bears,9575d8af-9671-4a9d-853f-fad6e89e933b_03-18-week2-FAILING_AND_PASSING,38,4,42
346863754,apache/incubator-druid,28/08/18 17:23,spirals-bears,9575d8af-9671-4a9d-853f-fad6e89e933b_03-18-week2-FAILING_AND_PASSING,42,7,49
352437013,thelastpickle/cassandra-reaper,28/08/18 17:23,spirals-bears,9575d8af-9671-4a9d-853f-fad6e89e933b_03-18-week2-FAILING_AND_PASSING,9,0,9
352438072,thelastpickle/cassandra-reaper,28/08/18 17:24,spirals-bears,9575d8af-9671-4a9d-853f-fad6e89e933b_03-18-week2-FAILING_AND_PASSING,9,3,12
352193416,thelastpickle/cassandra-reaper,28/08/18 17:24,spirals-bears,9575d8af-9671-4a9d-853f-fad6e89e933b_03-18-week2-FAILING_AND_PASSING,10,0,10
352718611,apache/incubator-druid,28/08/18 17:54,spirals-bears,9575d8af-9671-4a9d-853f-fad6e89e933b_03-18-week2-FAILING_AND_PASSING,10,0,2,2,1,61,0,1399,364,2,1125,921,40,14,3941
352943411,JMRI/JMRI,28/08/18 18:01,spirals-bears,9575d8af-9671-4a9d-853f-fad6e89e933b_03-18-week2-FAILING_AND_PASSING,1777,106,308,0,6,0,2,2199
352678826,apache/incubator-druid,28/08/18 18:11,spirals-bears,9575d8af-9671-4a9d-853f-fad6e89e933b_03-18-week2-FAILING_AND_PASSING,17,0,2,5,1,41,0,1560,498,1,1839,901,53,13,4931
351886067,JMRI/JMRI,28/08/18 18:29,spirals-bears,9575d8af-9671-4a9d-853f-fad6e89e933b_03-18-week2-FAILING_AND_PASSING,1662,107,312,0,5,1,12,2099
351239880,JMRI/JMRI,28/08/18 18:38,spirals-bears,9575d8af-9671-4a9d-853f-fad6e89e933b_03-18-week2-FAILING_AND_PASSING,1805,99,262,0,5,0,9,2180
347751944,apache/nifi,28/08/18 18:39,spirals-bears,9575d8af-9671-4a9d-853f-fad6e89e933b_03-18-week2-FAILING_AND_PASSING,1617,48,2,6,4,1677
350884562,apache/incubator-druid,28/08/18 18:39,spirals-bears,9575d8af-9671-4a9d-853f-fad6e89e933b_03-18-week2-FAILING_AND_PASSING,8,0,5,4,1,41,0,1489,325,0,1809,849,45,3,4579
343991948,apache/nifi,28/08/18 18:40,spirals-bears,9575d8af-9671-4a9d-853f-fad6e89e933b_03-18-week2-FAILING_AND_PASSING,37,9,46
350921737,apache/nifi,28/08/18 18:41,spirals-bears,9575d8af-9671-4a9d-853f-fad6e89e933b_03-18-week2-FAILING_AND_PASSING,42,7,49
350421703,apache/nifi,28/08/18 18:42,spirals-bears,9575d8af-9671-4a9d-853f-fad6e89e933b_03-18-week2-FAILING_AND_PASSING,37,6,43
353042895,apache/nifi,28/08/18 18:52,spirals-bears,9575d8af-9671-4a9d-853f-fad6e89e933b_03-18-week2-FAILING_AND_PASSING,1304,62,2,2,3,1373
353456753,INRIA/spoon,28/08/18 18:53,spirals-bears,9575d8af-9671-4a9d-853f-fad6e89e933b_03-18-week2-FAILING_AND_PASSING,11,4,15
352854988,apache/nifi,28/08/18 19:07,spirals-bears,9575d8af-9671-4a9d-853f-fad6e89e933b_03-18-week2-FAILING_AND_PASSING,1712,38,1,1,3,1755
350969263,apache/nifi,28/08/18 19:10,spirals-bears,9575d8af-9671-4a9d-853f-fad6e89e933b_03-18-week2-FAILING_AND_PASSING,1728,54,2,11,4,1799
353499067,EnMasseProject/enmasse,28/08/18 19:10,spirals-bears,9575d8af-9671-4a9d-853f-fad6e89e933b_03-18-week2-FAILING_AND_PASSING,26,0,26
353499109,EnMasseProject/enmasse,28/08/18 19:11,spirals-bears,9575d8af-9671-4a9d-853f-fad6e89e933b_03-18-week2-FAILING_AND_PASSING,28,3,31
352813778,EnMasseProject/enmasse,28/08/18 19:11,spirals-bears,9575d8af-9671-4a9d-853f-fad6e89e933b_03-18-week2-FAILING_AND_PASSING,26,0,26
350708709,apache/nifi,28/08/18 19:12,spirals-bears,9575d8af-9671-4a9d-853f-fad6e89e933b_03-18-week2-FAILING_AND_PASSING,1727,38,2,7,4,1778
353206502,EnMasseProject/enmasse,28/08/18 19:12,spirals-bears,9575d8af-9671-4a9d-853f-fad6e89e933b_03-18-week2-FAILING_AND_PASSING,31,3,34
353206482,EnMasseProject/enmasse,28/08/18 19:12,spirals-bears,9575d8af-9671-4a9d-853f-fad6e89e933b_03-18-week2-FAILING_AND_PASSING,25,0,25
353257660,EnMasseProject/enmasse,28/08/18 19:13,spirals-bears,9575d8af-9671-4a9d-853f-fad6e89e933b_03-18-week2-FAILING_AND_PASSING,26,0,26
352196277,INRIA/spoon,28/08/18 19:13,spirals-bears,9575d8af-9671-4a9d-853f-fad6e89e933b_03-18-week2-FAILING_AND_PASSING,8,0,6,0,0,7,0,517,19,4,544,66,11,0,1182
353257667,EnMasseProject/enmasse,28/08/18 19:13,spirals-bears,9575d8af-9671-4a9d-853f-fad6e89e933b_03-18-week2-FAILING_AND_PASSING,30,3,33
351547248,EnMasseProject/enmasse,28/08/18 19:13,spirals-bears,9575d8af-9671-4a9d-853f-fad6e89e933b_03-18-week2-FAILING_AND_PASSING,29,0,29
351496450,EnMasseProject/enmasse,28/08/18 19:14,spirals-bears,9575d8af-9671-4a9d-853f-fad6e89e933b_03-18-week2-FAILING_AND_PASSING,29,0,29
351496400,EnMasseProject/enmasse,28/08/18 19:14,spirals-bears,9575d8af-9671-4a9d-853f-fad6e89e933b_03-18-week2-FAILING_AND_PASSING,29,2,31
351204677,EnMasseProject/enmasse,28/08/18 19:14,spirals-bears,9575d8af-9671-4a9d-853f-fad6e89e933b_03-18-week2-FAILING_AND_PASSING,34,0,34
351204683,EnMasseProject/enmasse,28/08/18 19:15,spirals-bears,9575d8af-9671-4a9d-853f-fad6e89e933b_03-18-week2-FAILING_AND_PASSING,48,3,51
352691364,batfish/batfish,28/08/18 19:15,spirals-bears,9575d8af-9671-4a9d-853f-fad6e89e933b_03-18-week2-FAILING_AND_PASSING,56,0,56
352583303,batfish/batfish,28/08/18 19:15,spirals-bears,9575d8af-9671-4a9d-853f-fad6e89e933b_03-18-week2-FAILING_AND_PASSING,49,0,49
352440434,batfish/batfish,28/08/18 19:16,spirals-bears,9575d8af-9671-4a9d-853f-fad6e89e933b_03-18-week2-FAILING_AND_PASSING,52,3,55
352440410,batfish/batfish,28/08/18 19:16,spirals-bears,9575d8af-9671-4a9d-853f-fad6e89e933b_03-18-week2-FAILING_AND_PASSING,51,0,51
352487063,batfish/batfish,28/08/18 19:16,spirals-bears,9575d8af-9671-4a9d-853f-fad6e89e933b_03-18-week2-FAILING_AND_PASSING,51,3,54
351653756,batfish/batfish,28/08/18 19:17,spirals-bears,9575d8af-9671-4a9d-853f-fad6e89e933b_03-18-week2-FAILING_AND_PASSING,48,0,48
352486624,batfish/batfish,28/08/18 19:17,spirals-bears,9575d8af-9671-4a9d-853f-fad6e89e933b_03-18-week2-FAILING_AND_PASSING,49,0,49
351135744,batfish/batfish,28/08/18 19:17,spirals-bears,9575d8af-9671-4a9d-853f-fad6e89e933b_03-18-week2-FAILING_AND_PASSING,58,5,63
351135722,batfish/batfish,28/08/18 19:18,spirals-bears,9575d8af-9671-4a9d-853f-fad6e89e933b_03-18-week2-FAILING_AND_PASSING,51,0,51
351073755,batfish/batfish,28/08/18 19:18,spirals-bears,9575d8af-9671-4a9d-853f-fad6e89e933b_03-18-week2-FAILING_AND_PASSING,52,0,52
351073783,batfish/batfish,28/08/18 19:19,spirals-bears,9575d8af-9671-4a9d-853f-fad6e89e933b_03-18-week2-FAILING_AND_PASSING,53,3,56
350699902,batfish/batfish,28/08/18 19:19,spirals-bears,9575d8af-9671-4a9d-853f-fad6e89e933b_03-18-week2-FAILING_AND_PASSING,50,0,50
350699917,batfish/batfish,28/08/18 19:19,spirals-bears,9575d8af-9671-4a9d-853f-fad6e89e933b_03-18-week2-FAILING_AND_PASSING,51,3,54
350573140,batfish/batfish,28/08/18 19:20,spirals-bears,9575d8af-9671-4a9d-853f-fad6e89e933b_03-18-week2-FAILING_AND_PASSING,47,0,47
353455892,matsim-org/matsim,28/08/18 19:22,spirals-bears,9575d8af-9671-4a9d-853f-fad6e89e933b_03-18-week2-FAILING_AND_PASSING,160,0,160
353455707,matsim-org/matsim,28/08/18 19:22,spirals-bears,9575d8af-9671-4a9d-853f-fad6e89e933b_03-18-week2-FAILING_AND_PASSING,183,3,186
350763643,matsim-org/matsim,28/08/18 19:25,spirals-bears,9575d8af-9671-4a9d-853f-fad6e89e933b_03-18-week2-FAILING_AND_PASSING,142,4,146
351307408,lucee/Lucee,28/08/18 19:26,spirals-bears,9575d8af-9671-4a9d-853f-fad6e89e933b_03-18-week2-FAILING_AND_PASSING,3,6,20,0,1,0,0,30
351220257,lucee/Lucee,28/08/18 19:26,spirals-bears,9575d8af-9671-4a9d-853f-fad6e89e933b_03-18-week2-FAILING_AND_PASSING,3,7,20,0,0,1,0,31
351785790,INRIA/spoon,28/08/18 19:26,spirals-bears,9575d8af-9671-4a9d-853f-fad6e89e933b_03-18-week2-FAILING_AND_PASSING,7,0,8,0,0,4,0,521,19,5,508,57,9,0,1138
352258653,apache/incubator-servicecomb-java-chassis,28/08/18 19:36,spirals-bears,9575d8af-9671-4a9d-853f-fad6e89e933b_03-18-week2-FAILING_AND_PASSING,374,197,11,1,1,5,1,590
353436596,runelite/runelite,28/08/18 19:37,spirals-bears,9575d8af-9671-4a9d-853f-fad6e89e933b_03-18-week2-FAILING_AND_PASSING,10,1,11
353352232,runelite/runelite,28/08/18 19:37,spirals-bears,9575d8af-9671-4a9d-853f-fad6e89e933b_03-18-week2-FAILING_AND_PASSING,11,12,23
353209442,runelite/runelite,28/08/18 19:37,spirals-bears,9575d8af-9671-4a9d-853f-fad6e89e933b_03-18-week2-FAILING_AND_PASSING,10,0,10
352976447,runelite/runelite,28/08/18 19:38,spirals-bears,9575d8af-9671-4a9d-853f-fad6e89e933b_03-18-week2-FAILING_AND_PASSING,10,0,10
352892969,runelite/runelite,28/08/18 19:38,spirals-bears,9575d8af-9671-4a9d-853f-fad6e89e933b_03-18-week2-FAILING_AND_PASSING,10,0,10
352850226,runelite/runelite,28/08/18 19:39,spirals-bears,9575d8af-9671-4a9d-853f-fad6e89e933b_03-18-week2-FAILING_AND_PASSING,11,0,11
352798696,runelite/runelite,28/08/18 19:39,spirals-bears,9575d8af-9671-4a9d-853f-fad6e89e933b_03-18-week2-FAILING_AND_PASSING,10,16,26
352509987,runelite/runelite,28/08/18 19:40,spirals-bears,9575d8af-9671-4a9d-853f-fad6e89e933b_03-18-week2-FAILING_AND_PASSING,10,14,24
352107462,runelite/runelite,28/08/18 19:40,spirals-bears,9575d8af-9671-4a9d-853f-fad6e89e933b_03-18-week2-FAILING_AND_PASSING,11,11,22
352059397,runelite/runelite,28/08/18 19:41,spirals-bears,9575d8af-9671-4a9d-853f-fad6e89e933b_03-18-week2-FAILING_AND_PASSING,11,1,12
351838502,runelite/runelite,28/08/18 19:41,spirals-bears,9575d8af-9671-4a9d-853f-fad6e89e933b_03-18-week2-FAILING_AND_PASSING,11,14,25
351796874,runelite/runelite,28/08/18 19:41,spirals-bears,9575d8af-9671-4a9d-853f-fad6e89e933b_03-18-week2-FAILING_AND_PASSING,11,0,11
351816131,runelite/runelite,28/08/18 19:42,spirals-bears,9575d8af-9671-4a9d-853f-fad6e89e933b_03-18-week2-FAILING_AND_PASSING,12,14,26
350797170,apache/incubator-servicecomb-java-chassis,28/08/18 19:42,spirals-bears,9575d8af-9671-4a9d-853f-fad6e89e933b_03-18-week2-FAILING_AND_PASSING,9,3,1,5,6,0,5,4,1,329,0,160,4,206,192,9,3,0,937
351801881,runelite/runelite,28/08/18 19:43,spirals-bears,9575d8af-9671-4a9d-853f-fad6e89e933b_03-18-week2-FAILING_AND_PASSING,13,14,27
351613336,runelite/runelite,28/08/18 19:43,spirals-bears,9575d8af-9671-4a9d-853f-fad6e89e933b_03-18-week2-FAILING_AND_PASSING,12,0,12
351349470,runelite/runelite,28/08/18 19:43,spirals-bears,9575d8af-9671-4a9d-853f-fad6e89e933b_03-18-week2-FAILING_AND_PASSING,11,0,11
350498790,runelite/runelite,28/08/18 19:43,spirals-bears,9575d8af-9671-4a9d-853f-fad6e89e933b_03-18-week2-FAILING_AND_PASSING,12,15,27
351312342,runelite/runelite,28/08/18 19:43,spirals-bears,9575d8af-9671-4a9d-853f-fad6e89e933b_03-18-week2-FAILING_AND_PASSING,11,0,11
351130178,runelite/runelite,28/08/18 19:44,spirals-bears,9575d8af-9671-4a9d-853f-fad6e89e933b_03-18-week2-FAILING_AND_PASSING,11,0,11
351159827,runelite/runelite,28/08/18 19:44,spirals-bears,9575d8af-9671-4a9d-853f-fad6e89e933b_03-18-week2-FAILING_AND_PASSING,11,15,26
350729217,runelite/runelite,28/08/18 19:44,spirals-bears,9575d8af-9671-4a9d-853f-fad6e89e933b_03-18-week2-FAILING_AND_PASSING,10,0,10
350638980,runelite/runelite,28/08/18 19:44,spirals-bears,9575d8af-9671-4a9d-853f-fad6e89e933b_03-18-week2-FAILING_AND_PASSING,11,0,11
352671970,terasolunaorg/tutorial-apps,28/08/18 19:44,spirals-bears,9575d8af-9671-4a9d-853f-fad6e89e933b_03-18-week2-FAILING_AND_PASSING,3,0,3
352234245,CorfuDB/CorfuDB,28/08/18 19:49,spirals-bears,9575d8af-9671-4a9d-853f-fad6e89e933b_03-18-week2-FAILING_AND_PASSING,252,3,255
352233077,CorfuDB/CorfuDB,28/08/18 19:49,spirals-bears,9575d8af-9671-4a9d-853f-fad6e89e933b_03-18-week2-FAILING_AND_PASSING,270,0,270
351689041,matsim-org/matsim,28/08/18 19:49,spirals-bears,9575d8af-9671-4a9d-853f-fad6e89e933b_03-18-week2-FAILING_AND_PASSING,1619,148,0,1,0,1768
349230899,matsim-org/matsim,28/08/18 19:51,spirals-bears,9575d8af-9671-4a9d-853f-fad6e89e933b_03-18-week2-FAILING_AND_PASSING,1607,151,0,1,0,1759
353068048,CorfuDB/CorfuDB,28/08/18 19:54,spirals-bears,9575d8af-9671-4a9d-853f-fad6e89e933b_03-18-week2-FAILING_AND_PASSING,259,0,259
351556987,CorfuDB/CorfuDB,28/08/18 19:56,spirals-bears,9575d8af-9671-4a9d-853f-fad6e89e933b_03-18-week2-FAILING_AND_PASSING,244,5,249
353149392,CorfuDB/CorfuDB,28/08/18 19:56,spirals-bears,9575d8af-9671-4a9d-853f-fad6e89e933b_03-18-week2-FAILING_AND_PASSING,426,3,429
351152455,apache/activemq-artemis,28/08/18 19:58,spirals-bears,9575d8af-9671-4a9d-853f-fad6e89e933b_03-18-week2-FAILING_AND_PASSING,25,45,70
351556472,CorfuDB/CorfuDB,28/08/18 19:58,spirals-bears,9575d8af-9671-4a9d-853f-fad6e89e933b_03-18-week2-FAILING_AND_PASSING,258,0,258
350780600,apache/activemq-artemis,28/08/18 19:58,spirals-bears,9575d8af-9671-4a9d-853f-fad6e89e933b_03-18-week2-FAILING_AND_PASSING,39,4,43
352589450,linkedin/pinot,28/08/18 19:59,spirals-bears,9575d8af-9671-4a9d-853f-fad6e89e933b_03-18-week2-FAILING_AND_PASSING,36,4,40
353199227,Azure/azure-libraries-for-java,28/08/18 20:01,spirals-bears,9575d8af-9671-4a9d-853f-fad6e89e933b_03-18-week2-FAILING_AND_PASSING,67,7,74
352566524,Azure/azure-libraries-for-java,28/08/18 20:02,spirals-bears,9575d8af-9671-4a9d-853f-fad6e89e933b_03-18-week2-FAILING_AND_PASSING,73,3,76
352202044,Azure/azure-libraries-for-java,28/08/18 20:03,spirals-bears,9575d8af-9671-4a9d-853f-fad6e89e933b_03-18-week2-FAILING_AND_PASSING,66,4,70
350365798,apache/activemq-artemis,28/08/18 20:11,spirals-bears,9575d8af-9671-4a9d-853f-fad6e89e933b_03-18-week2-FAILING_AND_PASSING,271,442,28,0,1,1,1,744
351480681,Azure/azure-libraries-for-java,28/08/18 20:12,spirals-bears,9575d8af-9671-4a9d-853f-fad6e89e933b_03-18-week2-FAILING_AND_PASSING,15,0,21,0,1,17,0,90,78,5,92,94,59,0,472
351079996,Azure/azure-libraries-for-java,28/08/18 20:12,spirals-bears,9575d8af-9671-4a9d-853f-fad6e89e933b_03-18-week2-FAILING_AND_PASSING,67,4,71
352208186,lettuce-io/lettuce-core,28/08/18 20:14,spirals-bears,9575d8af-9671-4a9d-853f-fad6e89e933b_03-18-week2-FAILING_AND_PASSING,18,45,8,0,0,1,0,72
350609764,lettuce-io/lettuce-core,28/08/18 20:14,spirals-bears,9575d8af-9671-4a9d-853f-fad6e89e933b_03-18-week2-FAILING_AND_PASSING,10,3,13
352531811,CorfuDB/CorfuDB,28/08/18 20:21,spirals-bears,9575d8af-9671-4a9d-853f-fad6e89e933b_03-18-week2-FAILING_AND_PASSING,12,0,0,0,0,2,0,729,102,0,637,167,249,0,1898
351361037,raphw/byte-buddy,28/08/18 20:21,spirals-bears,9575d8af-9671-4a9d-853f-fad6e89e933b_03-18-week2-FAILING_AND_PASSING,78,117,358,0,0,2,1,556
352900952,magefree/mage,28/08/18 20:26,spirals-bears,9575d8af-9671-4a9d-853f-fad6e89e933b_03-18-week2-FAILING_AND_PASSING,129,178,0,14,1,322
353056965,magefree/mage,28/08/18 20:31,spirals-bears,9575d8af-9671-4a9d-853f-fad6e89e933b_03-18-week2-FAILING_AND_PASSING,8,0,12,0,0,35,0,173,36,2,209,363,165,1,1004
350559155,apache/storm,28/08/18 20:36,spirals-bears,9575d8af-9671-4a9d-853f-fad6e89e933b_03-18-week2-FAILING_AND_PASSING,17,0,7,0,1,8,0,560,511,6,558,661,69,0,2398
352868078,magefree/mage,28/08/18 20:37,spirals-bears,9575d8af-9671-4a9d-853f-fad6e89e933b_03-18-week2-FAILING_AND_PASSING,8,0,13,0,0,27,0,151,25,1,165,346,173,1,910
351272245,molgenis/molgenis,28/08/18 20:38,spirals-bears,9575d8af-9671-4a9d-853f-fad6e89e933b_03-18-week2-FAILING_AND_PASSING,37,10,47
351576955,visallo/vertexium,28/08/18 20:38,spirals-bears,9575d8af-9671-4a9d-853f-fad6e89e933b_03-18-week2-FAILING_AND_PASSING,6,2,8
351654534,magefree/mage,28/08/18 20:39,spirals-bears,9575d8af-9671-4a9d-853f-fad6e89e933b_03-18-week2-FAILING_AND_PASSING,169,4,173
350177636,apache/incubator-dubbo,28/08/18 20:39,spirals-bears,9575d8af-9671-4a9d-853f-fad6e89e933b_03-18-week2-FAILING_AND_PASSING,9,0,9
350849702,apache/incubator-dubbo,28/08/18 20:40,spirals-bears,9575d8af-9671-4a9d-853f-fad6e89e933b_03-18-week2-FAILING_AND_PASSING,8,1,9
350383117,visallo/vertexium,28/08/18 20:41,spirals-bears,9575d8af-9671-4a9d-853f-fad6e89e933b_03-18-week2-FAILING_AND_PASSING,12,161,7,0,0,0,0,180
352634844,magefree/mage,28/08/18 20:43,spirals-bears,9575d8af-9671-4a9d-853f-fad6e89e933b_03-18-week2-FAILING_AND_PASSING,9,0,15,0,1,33,0,179,36,5,191,345,165,1,980
350646972,apache/incubator-dubbo,28/08/18 20:47,spirals-bears,9575d8af-9671-4a9d-853f-fad6e89e933b_03-18-week2-FAILING_AND_PASSING,183,213,10,0,7,1,0,414
352394744,magefree/mage,28/08/18 20:47,spirals-bears,9575d8af-9671-4a9d-853f-fad6e89e933b_03-18-week2-FAILING_AND_PASSING,10,0,13,0,0,29,0,155,31,1,171,348,172,1,931
352397870,ga4gh/dockstore,28/08/18 20:47,spirals-bears,9575d8af-9671-4a9d-853f-fad6e89e933b_03-18-week2-FAILING_AND_PASSING,9,3,12
352357310,ga4gh/dockstore,28/08/18 20:48,spirals-bears,9575d8af-9671-4a9d-853f-fad6e89e933b_03-18-week2-FAILING_AND_PASSING,11,0,11
345100645,apache/incubator-dubbo,28/08/18 20:51,spirals-bears,9575d8af-9671-4a9d-853f-fad6e89e933b_03-18-week2-FAILING_AND_PASSING,7,2,0,4,8,0,1,3,0,177,0,37,4,87,218,8,4,0,560
353528013,atomix/atomix,28/08/18 20:57,spirals-bears,9575d8af-9671-4a9d-853f-fad6e89e933b_03-18-week2-FAILING_AND_PASSING,240,88,11,0,0,0,0,339
351620459,airlift/airlift,28/08/18 20:57,spirals-bears,9575d8af-9671-4a9d-853f-fad6e89e933b_03-18-week2-FAILING_AND_PASSING,13,3,16
351002539,airlift/airlift,28/08/18 20:57,spirals-bears,9575d8af-9671-4a9d-853f-fad6e89e933b_03-18-week2-FAILING_AND_PASSING,13,3,16
350618896,airlift/airlift,28/08/18 20:58,spirals-bears,9575d8af-9671-4a9d-853f-fad6e89e933b_03-18-week2-FAILING_AND_PASSING,14,3,17
351934784,openzipkin/zipkin,28/08/18 20:58,spirals-bears,9575d8af-9671-4a9d-853f-fad6e89e933b_03-18-week2-FAILING_AND_PASSING,22,0,22
351934786,openzipkin/zipkin,28/08/18 20:59,spirals-bears,9575d8af-9671-4a9d-853f-fad6e89e933b_03-18-week2-FAILING_AND_PASSING,26,2,28
353122445,pgjdbc/pgjdbc,28/08/18 21:02,spirals-bears,9575d8af-9671-4a9d-853f-fad6e89e933b_03-18-week2-FAILING_AND_PASSING,9,0,3,2,0,3,0,39,20,3,34,37,9,2,161
351977768,pgjdbc/pgjdbc,28/08/18 21:05,spirals-bears,9575d8af-9671-4a9d-853f-fad6e89e933b_03-18-week2-FAILING_AND_PASSING,9,0,0,2,0,2,0,32,19,0,34,36,9,2,145
351800667,pgjdbc/pgjdbc,28/08/18 21:07,spirals-bears,9575d8af-9671-4a9d-853f-fad6e89e933b_03-18-week2-FAILING_AND_PASSING,9,0,4,2,0,4,0,37,19,3,36,38,8,1,161
352908898,ga4gh/dockstore,28/08/18 21:07,spirals-bears,9575d8af-9671-4a9d-853f-fad6e89e933b_03-18-week2-FAILING_AND_PASSING,1443,8,0,0,1,1452
351498799,pgjdbc/pgjdbc,28/08/18 21:08,spirals-bears,9575d8af-9671-4a9d-853f-fad6e89e933b_03-18-week2-FAILING_AND_PASSING,9,4,13
351644224,pgjdbc/pgjdbc,28/08/18 21:08,spirals-bears,9575d8af-9671-4a9d-853f-fad6e89e933b_03-18-week2-FAILING_AND_PASSING,9,0,9
343053012,pgjdbc/pgjdbc,28/08/18 21:09,spirals-bears,9575d8af-9671-4a9d-853f-fad6e89e933b_03-18-week2-FAILING_AND_PASSING,9,3,12
351915388,pgjdbc/pgjdbc,28/08/18 21:10,spirals-bears,9575d8af-9671-4a9d-853f-fad6e89e933b_03-18-week2-FAILING_AND_PASSING,9,0,0,1,1,3,0,34,19,0,39,44,9,2,161
353527220,soft-serve-java/RestHub,28/08/18 21:13,spirals-bears,9575d8af-9671-4a9d-853f-fad6e89e933b_03-18-week2-FAILING_AND_PASSING,74,46,7,6,0,0,1,1,0,10,0,0,145
352289167,geoserver/geoserver,28/08/18 21:14,spirals-bears,9575d8af-9671-4a9d-853f-fad6e89e933b_03-18-week2-FAILING_AND_PASSING,141,164,0,6,1,312
352917237,aicis/fresco,28/08/18 21:43,spirals-bears,9575d8af-9671-4a9d-853f-fad6e89e933b_03-18-week2-FAILING_AND_PASSING,9,5,0,0,7,0,1,4,0,1273,0,32,0,321,92,9,5,0,1758
352380602,SpoonLabs/nopol,28/08/18 21:43,spirals-bears,9575d8af-9671-4a9d-853f-fad6e89e933b_03-18-week2-FAILING_AND_PASSING,45,0,45
352018433,SpoonLabs/nopol,28/08/18 21:44,spirals-bears,9575d8af-9671-4a9d-853f-fad6e89e933b_03-18-week2-FAILING_AND_PASSING,37,0,37
351931828,SpoonLabs/nopol,28/08/18 21:48,spirals-bears,9575d8af-9671-4a9d-853f-fad6e89e933b_03-18-week2-FAILING_AND_PASSING,8,0,0,0,0,14,0,20,20,0,26,69,78,0,235
351842865,SpoonLabs/nopol,28/08/18 21:49,spirals-bears,9575d8af-9671-4a9d-853f-fad6e89e933b_03-18-week2-FAILING_AND_PASSING,40,0,40
351663660,SpoonLabs/nopol,28/08/18 21:50,spirals-bears,9575d8af-9671-4a9d-853f-fad6e89e933b_03-18-week2-FAILING_AND_PASSING,49,0,49
350843294,SpoonLabs/nopol,28/08/18 21:53,spirals-bears,9575d8af-9671-4a9d-853f-fad6e89e933b_03-18-week2-FAILING_AND_PASSING,9,0,0,0,0,12,0,22,21,0,33,50,40,0,187
353545092,swagger-api/swagger-codegen,28/08/18 21:54,spirals-bears,9575d8af-9671-4a9d-853f-fad6e89e933b_03-18-week2-FAILING_AND_PASSING,34,0,34
353527588,swagger-api/swagger-codegen,28/08/18 21:55,spirals-bears,9575d8af-9671-4a9d-853f-fad6e89e933b_03-18-week2-FAILING_AND_PASSING,33,0,33
351205133,swagger-api/swagger-codegen,28/08/18 21:56,spirals-bears,9575d8af-9671-4a9d-853f-fad6e89e933b_03-18-week2-FAILING_AND_PASSING,35,4,39
352369916,apache/jackrabbit-oak,28/08/18 21:58,spirals-bears,9575d8af-9671-4a9d-853f-fad6e89e933b_03-18-week2-FAILING_AND_PASSING,9,0,1,0,2,11,0,1679,357,0,1675,468,37,1,4240
353007235,apache/jackrabbit-oak,28/08/18 22:00,spirals-bears,9575d8af-9671-4a9d-853f-fad6e89e933b_03-18-week2-FAILING_AND_PASSING,7,0,1,1,2,11,0,1739,351,1,1718,472,37,1,4341
345831030,swagger-api/swagger-codegen,28/08/18 22:01,spirals-bears,9575d8af-9671-4a9d-853f-fad6e89e933b_03-18-week2-FAILING_AND_PASSING,42,5,47
349748878,swagger-api/swagger-codegen,28/08/18 22:01,spirals-bears,9575d8af-9671-4a9d-853f-fad6e89e933b_03-18-week2-FAILING_AND_PASSING,55,225,42,0,6,1,0,329
351678450,Blazebit/blaze-persistence,28/08/18 22:02,spirals-bears,9575d8af-9671-4a9d-853f-fad6e89e933b_03-18-week2-FAILING_AND_PASSING,11,4,15
353224864,rabbitmq/rabbitmq-perf-test,28/08/18 22:03,spirals-bears,9575d8af-9671-4a9d-853f-fad6e89e933b_03-18-week2-FAILING_AND_PASSING,13,0,0,0,0,0,0,30,12,0,34,24,3,0,116
352297565,aicis/fresco,28/08/18 22:03,spirals-bears,9575d8af-9671-4a9d-853f-fad6e89e933b_03-18-week2-FAILING_AND_PASSING,8,7,0,0,7,0,0,5,0,1532,0,36,0,1231,103,10,5,0,2944
353164957,apache/incubator-servicecomb-saga,28/08/18 22:04,spirals-bears,9575d8af-9671-4a9d-853f-fad6e89e933b_03-18-week2-FAILING_AND_PASSING,5,4,9
352758133,apache/incubator-servicecomb-saga,28/08/18 22:04,spirals-bears,9575d8af-9671-4a9d-853f-fad6e89e933b_03-18-week2-FAILING_AND_PASSING,4,3,7
351132072,apache/incubator-servicecomb-saga,28/08/18 22:04,spirals-bears,9575d8af-9671-4a9d-853f-fad6e89e933b_03-18-week2-FAILING_AND_PASSING,4,2,6
350034559,swagger-api/swagger-codegen,28/08/18 22:05,spirals-bears,9575d8af-9671-4a9d-853f-fad6e89e933b_03-18-week2-FAILING_AND_PASSING,60,244,34,0,5,0,0,343
352603837,datastax/java-driver,28/08/18 22:05,spirals-bears,9575d8af-9671-4a9d-853f-fad6e89e933b_03-18-week2-FAILING_AND_PASSING,19,0,19
352583933,datastax/java-driver,28/08/18 22:05,spirals-bears,9575d8af-9671-4a9d-853f-fad6e89e933b_03-18-week2-FAILING_AND_PASSING,19,0,19
349536375,datastax/java-driver,28/08/18 22:06,spirals-bears,9575d8af-9671-4a9d-853f-fad6e89e933b_03-18-week2-FAILING_AND_PASSING,18,3,21
352349938,vaadin/vaadin-components-testbench,28/08/18 22:06,spirals-bears,9575d8af-9671-4a9d-853f-fad6e89e933b_03-18-week2-FAILING_AND_PASSING,2,2,4
351964043,vaadin/vaadin-components-testbench,28/08/18 22:06,spirals-bears,9575d8af-9671-4a9d-853f-fad6e89e933b_03-18-week2-FAILING_AND_PASSING,2,2,4
351742666,SzFMV2018-Tavasz/AutomatedCar,28/08/18 22:07,spirals-bears,9575d8af-9671-4a9d-853f-fad6e89e933b_03-18-week2-FAILING_AND_PASSING,10,0,0,0,3,0,0,0,0,7,0,8,0,9,19,9,0,0,65
353054465,datastax/java-driver,28/08/18 22:08,spirals-bears,9575d8af-9671-4a9d-853f-fad6e89e933b_03-18-week2-FAILING_AND_PASSING,69,104,19,0,1,1,0,194
351742679,SzFMV2018-Tavasz/AutomatedCar,28/08/18 22:09,spirals-bears,9575d8af-9671-4a9d-853f-fad6e89e933b_03-18-week2-FAILING_AND_PASSING,10,0,0,3,4,0,0,0,0,8,0,7,3,8,18,10,0,0,71
350770012,SzFMV2018-Tavasz/AutomatedCar,28/08/18 22:09,spirals-bears,9575d8af-9671-4a9d-853f-fad6e89e933b_03-18-week2-FAILING_AND_PASSING,9,0,0,3,4,0,0,0,0,9,0,8,2,10,20,10,0,0,75
352300409,spring-cloud/spring-cloud-gcp,28/08/18 22:10,spirals-bears,9575d8af-9671-4a9d-853f-fad6e89e933b_03-18-week2-FAILING_AND_PASSING,252,4,113,4,121,494
351745178,RipMeApp/ripme,28/08/18 22:14,spirals-bears,9575d8af-9671-4a9d-853f-fad6e89e933b_03-18-week2-FAILING_AND_PASSING,10,0,0,0,0,0,0,245,11,0,326,25,4,0,621
352752539,jcabi/jcabi-github,28/08/18 22:15,spirals-bears,9575d8af-9671-4a9d-853f-fad6e89e933b_03-18-week2-FAILING_AND_PASSING,42,300,21,0,0,0,0,363
289418462,danglotb/dspot,28/08/18 22:15,spirals-bears,9575d8af-9671-4a9d-853f-fad6e89e933b_03-18-week2-FAILING_AND_PASSING,5,0,5
352378651,jcabi/jcabi-github,28/08/18 22:16,spirals-bears,9575d8af-9671-4a9d-853f-fad6e89e933b_03-18-week2-FAILING_AND_PASSING,43,288,25,0,0,0,0,356
345206176,dhis2/dhis2-core,28/08/18 22:16,spirals-bears,9575d8af-9671-4a9d-853f-fad6e89e933b_03-18-week2-FAILING_AND_PASSING,26,5,31
353288909,dhis2/dhis2-core,28/08/18 22:17,spirals-bears,9575d8af-9671-4a9d-853f-fad6e89e933b_03-18-week2-FAILING_AND_PASSING,22,4,26
353359319,dhis2/dhis2-core,28/08/18 22:17,spirals-bears,9575d8af-9671-4a9d-853f-fad6e89e933b_03-18-week2-FAILING_AND_PASSING,92,24,0,2,1,119
351313762,debezium/debezium,28/08/18 22:18,spirals-bears,9575d8af-9671-4a9d-853f-fad6e89e933b_03-18-week2-FAILING_AND_PASSING,7,5,12
352432766,Activiti/Activiti,28/08/18 22:19,spirals-bears,9575d8af-9671-4a9d-853f-fad6e89e933b_03-18-week2-FAILING_AND_PASSING,24,32,2,0,3,61
352818555,debezium/debezium,28/08/18 22:19,spirals-bears,9575d8af-9671-4a9d-853f-fad6e89e933b_03-18-week2-FAILING_AND_PASSING,112,6,0,4,0,122
352790388,Spirals-Team/repairnator,28/08/18 22:20,spirals-bears,9575d8af-9671-4a9d-853f-fad6e89e933b_03-18-week2-FAILING_AND_PASSING,17,3,20
352159663,tencentyun/cos-java-sdk-v5,28/08/18 22:20,spirals-bears,9575d8af-9671-4a9d-853f-fad6e89e933b_03-18-week2-FAILING_AND_PASSING,8,35,3,0,0,0,0,46
352773976,Spirals-Team/repairnator,28/08/18 22:20,spirals-bears,9575d8af-9671-4a9d-853f-fad6e89e933b_03-18-week2-FAILING_AND_PASSING,17,3,20
352328700,Spirals-Team/repairnator,28/08/18 22:20,spirals-bears,9575d8af-9671-4a9d-853f-fad6e89e933b_03-18-week2-FAILING_AND_PASSING,18,4,22
352295160,Spirals-Team/repairnator,28/08/18 22:21,spirals-bears,9575d8af-9671-4a9d-853f-fad6e89e933b_03-18-week2-FAILING_AND_PASSING,17,0,17
352295214,Spirals-Team/repairnator,28/08/18 22:21,spirals-bears,9575d8af-9671-4a9d-853f-fad6e89e933b_03-18-week2-FAILING_AND_PASSING,18,2,20
352293170,Spirals-Team/repairnator,28/08/18 22:21,spirals-bears,9575d8af-9671-4a9d-853f-fad6e89e933b_03-18-week2-FAILING_AND_PASSING,16,4,20
350787277,Spirals-Team/repairnator,28/08/18 22:21,spirals-bears,9575d8af-9671-4a9d-853f-fad6e89e933b_03-18-week2-FAILING_AND_PASSING,18,3,21
353293895,jnidzwetzki/bboxdb,28/08/18 22:26,spirals-bears,9575d8af-9671-4a9d-853f-fad6e89e933b_03-18-week2-FAILING_AND_PASSING,5,0,0,0,0,1,0,26,74,0,28,127,8,0,269
353503290,jnidzwetzki/bboxdb,28/08/18 22:26,spirals-bears,9575d8af-9671-4a9d-853f-fad6e89e933b_03-18-week2-FAILING_AND_PASSING,5,0,0,0,0,1,0,27,73,0,27,129,8,0,270
352308041,danglotb/dspot,28/08/18 22:28,spirals-bears,9575d8af-9671-4a9d-853f-fad6e89e933b_03-18-week2-FAILING_AND_PASSING,660,196,6,0,0,0,0,862
352987476,jnidzwetzki/bboxdb,28/08/18 22:32,spirals-bears,9575d8af-9671-4a9d-853f-fad6e89e933b_03-18-week2-FAILING_AND_PASSING,5,0,0,0,0,2,0,32,71,0,28,188,8,0,334
351998102,jnidzwetzki/bboxdb,28/08/18 22:32,spirals-bears,9575d8af-9671-4a9d-853f-fad6e89e933b_03-18-week2-FAILING_AND_PASSING,6,0,0,0,0,1,0,28,75,0,28,187,8,0,333
351810624,jnidzwetzki/bboxdb,28/08/18 22:33,spirals-bears,9575d8af-9671-4a9d-853f-fad6e89e933b_03-18-week2-FAILING_AND_PASSING,6,0,0,0,0,2,0,27,74,0,26,135,9,0,279
351541756,jnidzwetzki/bboxdb,28/08/18 22:37,spirals-bears,9575d8af-9671-4a9d-853f-fad6e89e933b_03-18-week2-FAILING_AND_PASSING,5,0,0,0,0,1,0,27,74,0,27,134,8,0,276
351687158,jnidzwetzki/bboxdb,28/08/18 22:37,spirals-bears,9575d8af-9671-4a9d-853f-fad6e89e933b_03-18-week2-FAILING_AND_PASSING,6,0,0,0,0,1,0,27,76,0,28,132,8,0,278
350816038,jnidzwetzki/bboxdb,28/08/18 22:38,spirals-bears,9575d8af-9671-4a9d-853f-fad6e89e933b_03-18-week2-FAILING_AND_PASSING,6,0,0,0,0,1,0,27,81,0,26,123,9,0,273
350830878,MariaDB/mariadb-connector-j,28/08/18 23:13,spirals-bears,9575d8af-9671-4a9d-853f-fad6e89e933b_03-18-week2-FAILING_AND_PASSING,11,0,0,0,0,1,0,1816,27,0,1820,62,10,0,3747
