345249090,apache/flink,25/08/18 14:15,spirals-bears,f217db01-bbb8-402e-8360-dcad68a2f96f_02-18-week4-FAILING_AND_PASSING,58,11,69
347217577,apache/flink,25/08/18 14:15,spirals-bears,f217db01-bbb8-402e-8360-dcad68a2f96f_02-18-week4-FAILING_AND_PASSING,62,9,71
346818917,apache/flink,25/08/18 14:15,spirals-bears,f217db01-bbb8-402e-8360-dcad68a2f96f_02-18-week4-FAILING_AND_PASSING,79,8,87
346221890,apache/flink,25/08/18 14:16,spirals-bears,f217db01-bbb8-402e-8360-dcad68a2f96f_02-18-week4-FAILING_AND_PASSING,62,6,68
345907924,apache/flink,25/08/18 14:16,spirals-bears,f217db01-bbb8-402e-8360-dcad68a2f96f_02-18-week4-FAILING_AND_PASSING,57,7,64
345825649,apache/flink,25/08/18 14:17,spirals-bears,f217db01-bbb8-402e-8360-dcad68a2f96f_02-18-week4-FAILING_AND_PASSING,61,6,67
345708049,apache/flink,25/08/18 14:19,spirals-bears,f217db01-bbb8-402e-8360-dcad68a2f96f_02-18-week4-FAILING_AND_PASSING,60,5,65
345707830,apache/flink,25/08/18 14:20,spirals-bears,f217db01-bbb8-402e-8360-dcad68a2f96f_02-18-week4-FAILING_AND_PASSING,59,6,65
346464814,apache/flink,25/08/18 15:00,spirals-bears,f217db01-bbb8-402e-8360-dcad68a2f96f_02-18-week4-FAILING_AND_PASSING,8,0,2,0,1,134,0,47,865,3,55,1597,63,1,2776
345638356,apache/flink,25/08/18 15:02,spirals-bears,f217db01-bbb8-402e-8360-dcad68a2f96f_02-18-week4-FAILING_AND_PASSING,76,6,82
345724553,apache/flink,25/08/18 15:03,spirals-bears,f217db01-bbb8-402e-8360-dcad68a2f96f_02-18-week4-FAILING_AND_PASSING,10,0,8,0,1,134,0,40,844,10,59,1639,61,1,2807
345243673,apache/flink,25/08/18 15:05,spirals-bears,f217db01-bbb8-402e-8360-dcad68a2f96f_02-18-week4-FAILING_AND_PASSING,90,6,96
346622158,apache/flink,25/08/18 15:05,spirals-bears,f217db01-bbb8-402e-8360-dcad68a2f96f_02-18-week4-FAILING_AND_PASSING,16,0,11,0,2,127,0,42,1089,15,60,1603,61,3,3029
345618722,apache/flink,25/08/18 15:06,spirals-bears,f217db01-bbb8-402e-8360-dcad68a2f96f_02-18-week4-FAILING_AND_PASSING,12,0,2,1,1,113,0,42,824,4,49,1643,61,1,2753
345169654,apache/flink,25/08/18 15:06,spirals-bears,f217db01-bbb8-402e-8360-dcad68a2f96f_02-18-week4-FAILING_AND_PASSING,62,6,68
344892905,apache/flink,25/08/18 15:07,spirals-bears,f217db01-bbb8-402e-8360-dcad68a2f96f_02-18-week4-FAILING_AND_PASSING,61,6,67
344089148,apache/flink,25/08/18 15:08,spirals-bears,f217db01-bbb8-402e-8360-dcad68a2f96f_02-18-week4-FAILING_AND_PASSING,60,7,67
344682874,apache/flink,25/08/18 15:08,spirals-bears,f217db01-bbb8-402e-8360-dcad68a2f96f_02-18-week4-FAILING_AND_PASSING,61,6,67
344606238,apache/flink,25/08/18 15:09,spirals-bears,f217db01-bbb8-402e-8360-dcad68a2f96f_02-18-week4-FAILING_AND_PASSING,71,6,77
343931457,apache/flink,25/08/18 15:09,spirals-bears,f217db01-bbb8-402e-8360-dcad68a2f96f_02-18-week4-FAILING_AND_PASSING,72,7,79
347072648,prestodb/presto,25/08/18 15:10,spirals-bears,f217db01-bbb8-402e-8360-dcad68a2f96f_02-18-week4-FAILING_AND_PASSING,42,5,47
345528263,prestodb/presto,25/08/18 15:11,spirals-bears,f217db01-bbb8-402e-8360-dcad68a2f96f_02-18-week4-FAILING_AND_PASSING,43,4,47
345577403,prestodb/presto,25/08/18 15:12,spirals-bears,f217db01-bbb8-402e-8360-dcad68a2f96f_02-18-week4-FAILING_AND_PASSING,43,5,48
345503136,prestodb/presto,25/08/18 15:13,spirals-bears,f217db01-bbb8-402e-8360-dcad68a2f96f_02-18-week4-FAILING_AND_PASSING,41,4,45
344585758,prestodb/presto,25/08/18 15:14,spirals-bears,f217db01-bbb8-402e-8360-dcad68a2f96f_02-18-week4-FAILING_AND_PASSING,43,5,48
347414303,prestodb/presto,25/08/18 15:38,spirals-bears,f217db01-bbb8-402e-8360-dcad68a2f96f_02-18-week4-FAILING_AND_PASSING,819,865,44,0,2,2,1732
344538146,prestodb/presto,25/08/18 15:43,spirals-bears,f217db01-bbb8-402e-8360-dcad68a2f96f_02-18-week4-FAILING_AND_PASSING,813,898,44,0,2,1,1758
346993133,apache/incubator-druid,25/08/18 15:45,spirals-bears,f217db01-bbb8-402e-8360-dcad68a2f96f_02-18-week4-FAILING_AND_PASSING,47,6,53
346901175,apache/incubator-druid,25/08/18 15:46,spirals-bears,f217db01-bbb8-402e-8360-dcad68a2f96f_02-18-week4-FAILING_AND_PASSING,35,9,44
345580080,apache/flink,25/08/18 15:46,spirals-bears,f217db01-bbb8-402e-8360-dcad68a2f96f_02-18-week4-FAILING_AND_PASSING,11,0,8,0,1,107,0,40,778,6,57,1595,61,2,2666
346698427,apache/incubator-druid,25/08/18 15:47,spirals-bears,f217db01-bbb8-402e-8360-dcad68a2f96f_02-18-week4-FAILING_AND_PASSING,36,4,40
346635257,apache/incubator-druid,25/08/18 15:48,spirals-bears,f217db01-bbb8-402e-8360-dcad68a2f96f_02-18-week4-FAILING_AND_PASSING,35,4,39
346461070,apache/incubator-druid,25/08/18 15:49,spirals-bears,f217db01-bbb8-402e-8360-dcad68a2f96f_02-18-week4-FAILING_AND_PASSING,34,4,38
346295621,apache/incubator-druid,25/08/18 15:50,spirals-bears,f217db01-bbb8-402e-8360-dcad68a2f96f_02-18-week4-FAILING_AND_PASSING,54,4,58
345069000,apache/incubator-druid,25/08/18 15:51,spirals-bears,f217db01-bbb8-402e-8360-dcad68a2f96f_02-18-week4-FAILING_AND_PASSING,36,7,43
343906329,apache/flink,25/08/18 15:55,spirals-bears,f217db01-bbb8-402e-8360-dcad68a2f96f_02-18-week4-FAILING_AND_PASSING,12,0,16,0,1,103,0,36,947,11,47,1626,59,3,2861
347037174,apache/incubator-druid,25/08/18 16:49,spirals-bears,f217db01-bbb8-402e-8360-dcad68a2f96f_02-18-week4-FAILING_AND_PASSING,8,0,2,12,1,141,0,1529,461,2,1463,558,35,8,4220
345439941,apache/incubator-druid,25/08/18 16:55,spirals-bears,f217db01-bbb8-402e-8360-dcad68a2f96f_02-18-week4-FAILING_AND_PASSING,8,0,3,16,1,51,0,1461,340,1,1644,553,34,3,4115
344670602,thelastpickle/cassandra-reaper,25/08/18 16:56,spirals-bears,f217db01-bbb8-402e-8360-dcad68a2f96f_02-18-week4-FAILING_AND_PASSING,8,0,8
344954227,apache/incubator-druid,25/08/18 17:05,spirals-bears,f217db01-bbb8-402e-8360-dcad68a2f96f_02-18-week4-FAILING_AND_PASSING,16,0,9,2,1,47,0,1500,600,6,1559,655,32,2,4429
344440238,apache/incubator-druid,25/08/18 17:07,spirals-bears,f217db01-bbb8-402e-8360-dcad68a2f96f_02-18-week4-FAILING_AND_PASSING,7,0,2,0,1,110,0,1436,445,1,1490,739,37,42,4310
346706657,JMRI/JMRI,25/08/18 17:32,spirals-bears,f217db01-bbb8-402e-8360-dcad68a2f96f_02-18-week4-FAILING_AND_PASSING,1691,159,254,0,33,0,10,2147
346340718,JMRI/JMRI,25/08/18 17:46,spirals-bears,f217db01-bbb8-402e-8360-dcad68a2f96f_02-18-week4-FAILING_AND_PASSING,1702,163,392,0,47,0,8,2312
346563834,JMRI/JMRI,25/08/18 17:47,spirals-bears,f217db01-bbb8-402e-8360-dcad68a2f96f_02-18-week4-FAILING_AND_PASSING,1485,306,11,254,0,35,0,316,0,92,7,10,2516
344849623,apache/incubator-druid,25/08/18 17:56,spirals-bears,f217db01-bbb8-402e-8360-dcad68a2f96f_02-18-week4-FAILING_AND_PASSING,15,0,18,1,12,45,0,1365,332,4,1366,666,48,3,3875
345987196,JMRI/JMRI,25/08/18 18:06,spirals-bears,f217db01-bbb8-402e-8360-dcad68a2f96f_02-18-week4-FAILING_AND_PASSING,1622,160,267,0,5,0,9,2063
345349019,JMRI/JMRI,25/08/18 18:20,spirals-bears,f217db01-bbb8-402e-8360-dcad68a2f96f_02-18-week4-FAILING_AND_PASSING,1560,165,274,0,33,0,12,2044
345834201,JMRI/JMRI,25/08/18 18:21,spirals-bears,f217db01-bbb8-402e-8360-dcad68a2f96f_02-18-week4-FAILING_AND_PASSING,1560,159,265,0,30,0,8,2022
337324422,apache/nifi,25/08/18 18:22,spirals-bears,f217db01-bbb8-402e-8360-dcad68a2f96f_02-18-week4-FAILING_AND_PASSING,40,5,45
344459804,apache/nifi,25/08/18 18:23,spirals-bears,f217db01-bbb8-402e-8360-dcad68a2f96f_02-18-week4-FAILING_AND_PASSING,37,6,43
345829451,JMRI/JMRI,25/08/18 18:29,spirals-bears,f217db01-bbb8-402e-8360-dcad68a2f96f_02-18-week4-FAILING_AND_PASSING,1539,159,284,0,6,1,6,1995
346353052,apache/nifi,25/08/18 18:30,spirals-bears,f217db01-bbb8-402e-8360-dcad68a2f96f_02-18-week4-FAILING_AND_PASSING,39,8,47
345920536,apache/nifi,25/08/18 18:31,spirals-bears,f217db01-bbb8-402e-8360-dcad68a2f96f_02-18-week4-FAILING_AND_PASSING,38,5,43
344914415,apache/nifi,25/08/18 18:32,spirals-bears,f217db01-bbb8-402e-8360-dcad68a2f96f_02-18-week4-FAILING_AND_PASSING,38,5,43
345199639,JMRI/JMRI,25/08/18 18:40,spirals-bears,f217db01-bbb8-402e-8360-dcad68a2f96f_02-18-week4-FAILING_AND_PASSING,1552,156,287,0,7,0,12,2014
346070123,INRIA/spoon,25/08/18 18:41,spirals-bears,f217db01-bbb8-402e-8360-dcad68a2f96f_02-18-week4-FAILING_AND_PASSING,10,4,14
345690819,INRIA/spoon,25/08/18 18:41,spirals-bears,f217db01-bbb8-402e-8360-dcad68a2f96f_02-18-week4-FAILING_AND_PASSING,10,3,13
345645208,apache/nifi,25/08/18 18:49,spirals-bears,f217db01-bbb8-402e-8360-dcad68a2f96f_02-18-week4-FAILING_AND_PASSING,1468,35,2,2,4,1511
345332069,INRIA/spoon,25/08/18 18:49,spirals-bears,f217db01-bbb8-402e-8360-dcad68a2f96f_02-18-week4-FAILING_AND_PASSING,9,4,13
347143687,EnMasseProject/enmasse,25/08/18 18:50,spirals-bears,f217db01-bbb8-402e-8360-dcad68a2f96f_02-18-week4-FAILING_AND_PASSING,27,0,27
346408692,EnMasseProject/enmasse,25/08/18 18:50,spirals-bears,f217db01-bbb8-402e-8360-dcad68a2f96f_02-18-week4-FAILING_AND_PASSING,28,0,28
346408869,EnMasseProject/enmasse,25/08/18 18:51,spirals-bears,f217db01-bbb8-402e-8360-dcad68a2f96f_02-18-week4-FAILING_AND_PASSING,28,3,31
346226096,EnMasseProject/enmasse,25/08/18 18:52,spirals-bears,f217db01-bbb8-402e-8360-dcad68a2f96f_02-18-week4-FAILING_AND_PASSING,28,0,28
346241166,EnMasseProject/enmasse,25/08/18 18:52,spirals-bears,f217db01-bbb8-402e-8360-dcad68a2f96f_02-18-week4-FAILING_AND_PASSING,25,3,28
344669949,EnMasseProject/enmasse,25/08/18 18:56,spirals-bears,f217db01-bbb8-402e-8360-dcad68a2f96f_02-18-week4-FAILING_AND_PASSING,89,92,26,0,0,1,0,208
344918860,JMRI/JMRI,25/08/18 18:56,spirals-bears,f217db01-bbb8-402e-8360-dcad68a2f96f_02-18-week4-FAILING_AND_PASSING,1683,157,274,0,6,0,11,2131
347498764,batfish/batfish,25/08/18 18:58,spirals-bears,f217db01-bbb8-402e-8360-dcad68a2f96f_02-18-week4-FAILING_AND_PASSING,81,5,86
345374875,INRIA/spoon,25/08/18 18:58,spirals-bears,f217db01-bbb8-402e-8360-dcad68a2f96f_02-18-week4-FAILING_AND_PASSING,14,0,7,0,0,13,0,423,30,4,451,61,9,2,1014
347149012,batfish/batfish,25/08/18 18:59,spirals-bears,f217db01-bbb8-402e-8360-dcad68a2f96f_02-18-week4-FAILING_AND_PASSING,54,0,54
346440552,batfish/batfish,25/08/18 19:00,spirals-bears,f217db01-bbb8-402e-8360-dcad68a2f96f_02-18-week4-FAILING_AND_PASSING,59,0,59
344366090,EnMasseProject/enmasse,25/08/18 19:00,spirals-bears,f217db01-bbb8-402e-8360-dcad68a2f96f_02-18-week4-FAILING_AND_PASSING,89,86,29,0,4,2,0,210
346443907,batfish/batfish,25/08/18 19:00,spirals-bears,f217db01-bbb8-402e-8360-dcad68a2f96f_02-18-week4-FAILING_AND_PASSING,52,0,52
346442360,batfish/batfish,25/08/18 19:01,spirals-bears,f217db01-bbb8-402e-8360-dcad68a2f96f_02-18-week4-FAILING_AND_PASSING,52,0,52
331667964,apache/nifi,25/08/18 19:01,spirals-bears,f217db01-bbb8-402e-8360-dcad68a2f96f_02-18-week4-FAILING_AND_PASSING,1655,38,2,7,4,1706
346444169,batfish/batfish,25/08/18 19:01,spirals-bears,f217db01-bbb8-402e-8360-dcad68a2f96f_02-18-week4-FAILING_AND_PASSING,69,3,72
345401333,batfish/batfish,25/08/18 19:01,spirals-bears,f217db01-bbb8-402e-8360-dcad68a2f96f_02-18-week4-FAILING_AND_PASSING,53,0,53
345372949,batfish/batfish,25/08/18 19:02,spirals-bears,f217db01-bbb8-402e-8360-dcad68a2f96f_02-18-week4-FAILING_AND_PASSING,54,2,56
345372925,batfish/batfish,25/08/18 19:02,spirals-bears,f217db01-bbb8-402e-8360-dcad68a2f96f_02-18-week4-FAILING_AND_PASSING,53,0,53
345371032,batfish/batfish,25/08/18 19:02,spirals-bears,f217db01-bbb8-402e-8360-dcad68a2f96f_02-18-week4-FAILING_AND_PASSING,52,3,55
345371039,batfish/batfish,25/08/18 19:02,spirals-bears,f217db01-bbb8-402e-8360-dcad68a2f96f_02-18-week4-FAILING_AND_PASSING,71,0,71
344952491,batfish/batfish,25/08/18 19:03,spirals-bears,f217db01-bbb8-402e-8360-dcad68a2f96f_02-18-week4-FAILING_AND_PASSING,51,2,53
345088016,batfish/batfish,25/08/18 19:03,spirals-bears,f217db01-bbb8-402e-8360-dcad68a2f96f_02-18-week4-FAILING_AND_PASSING,57,3,60
345087877,batfish/batfish,25/08/18 19:03,spirals-bears,f217db01-bbb8-402e-8360-dcad68a2f96f_02-18-week4-FAILING_AND_PASSING,75,0,75
344952357,batfish/batfish,25/08/18 19:03,spirals-bears,f217db01-bbb8-402e-8360-dcad68a2f96f_02-18-week4-FAILING_AND_PASSING,52,0,52
344615349,batfish/batfish,25/08/18 19:04,spirals-bears,f217db01-bbb8-402e-8360-dcad68a2f96f_02-18-week4-FAILING_AND_PASSING,51,4,55
344605936,batfish/batfish,25/08/18 19:04,spirals-bears,f217db01-bbb8-402e-8360-dcad68a2f96f_02-18-week4-FAILING_AND_PASSING,52,0,52
344596990,batfish/batfish,25/08/18 19:04,spirals-bears,f217db01-bbb8-402e-8360-dcad68a2f96f_02-18-week4-FAILING_AND_PASSING,53,0,53
344569477,batfish/batfish,25/08/18 19:04,spirals-bears,f217db01-bbb8-402e-8360-dcad68a2f96f_02-18-week4-FAILING_AND_PASSING,56,4,60
344569458,batfish/batfish,25/08/18 19:05,spirals-bears,f217db01-bbb8-402e-8360-dcad68a2f96f_02-18-week4-FAILING_AND_PASSING,57,0,57
346817461,matsim-org/matsim,25/08/18 19:10,spirals-bears,f217db01-bbb8-402e-8360-dcad68a2f96f_02-18-week4-FAILING_AND_PASSING,78,229,0,1,1,309
345912800,matsim-org/matsim,25/08/18 19:11,spirals-bears,f217db01-bbb8-402e-8360-dcad68a2f96f_02-18-week4-FAILING_AND_PASSING,56,304,0,1,1,362
345360614,matsim-org/matsim,25/08/18 19:28,spirals-bears,f217db01-bbb8-402e-8360-dcad68a2f96f_02-18-week4-FAILING_AND_PASSING,1257,172,0,6,1,1436
346175415,matsim-org/matsim,25/08/18 19:30,spirals-bears,f217db01-bbb8-402e-8360-dcad68a2f96f_02-18-week4-FAILING_AND_PASSING,1338,163,0,1,1,1503
345688205,matsim-org/matsim,25/08/18 19:41,spirals-bears,f217db01-bbb8-402e-8360-dcad68a2f96f_02-18-week4-FAILING_AND_PASSING,1704,159,0,1,1,1865
346121687,lucee/Lucee,25/08/18 19:42,spirals-bears,f217db01-bbb8-402e-8360-dcad68a2f96f_02-18-week4-FAILING_AND_PASSING,3,6,19,0,1,0,0,29
345740764,matsim-org/matsim,25/08/18 19:42,spirals-bears,f217db01-bbb8-402e-8360-dcad68a2f96f_02-18-week4-FAILING_AND_PASSING,1670,157,0,5,0,1832
345505654,lucee/Lucee,25/08/18 19:42,spirals-bears,f217db01-bbb8-402e-8360-dcad68a2f96f_02-18-week4-FAILING_AND_PASSING,3,8,22,0,1,0,0,34
344689589,apache/incubator-servicecomb-java-chassis,25/08/18 19:43,spirals-bears,f217db01-bbb8-402e-8360-dcad68a2f96f_02-18-week4-FAILING_AND_PASSING,10,4,14
347464201,runelite/runelite,25/08/18 19:43,spirals-bears,f217db01-bbb8-402e-8360-dcad68a2f96f_02-18-week4-FAILING_AND_PASSING,13,12,25
347404345,runelite/runelite,25/08/18 19:43,spirals-bears,f217db01-bbb8-402e-8360-dcad68a2f96f_02-18-week4-FAILING_AND_PASSING,13,16,29
347243129,runelite/runelite,25/08/18 19:44,spirals-bears,f217db01-bbb8-402e-8360-dcad68a2f96f_02-18-week4-FAILING_AND_PASSING,10,13,23
347143747,runelite/runelite,25/08/18 19:44,spirals-bears,f217db01-bbb8-402e-8360-dcad68a2f96f_02-18-week4-FAILING_AND_PASSING,12,0,12
346320785,runelite/runelite,25/08/18 19:44,spirals-bears,f217db01-bbb8-402e-8360-dcad68a2f96f_02-18-week4-FAILING_AND_PASSING,10,14,24
347028315,runelite/runelite,25/08/18 19:44,spirals-bears,f217db01-bbb8-402e-8360-dcad68a2f96f_02-18-week4-FAILING_AND_PASSING,10,11,21
346644873,runelite/runelite,25/08/18 19:45,spirals-bears,f217db01-bbb8-402e-8360-dcad68a2f96f_02-18-week4-FAILING_AND_PASSING,11,17,28
346342911,runelite/runelite,25/08/18 19:45,spirals-bears,f217db01-bbb8-402e-8360-dcad68a2f96f_02-18-week4-FAILING_AND_PASSING,11,15,26
345635408,runelite/runelite,25/08/18 19:45,spirals-bears,f217db01-bbb8-402e-8360-dcad68a2f96f_02-18-week4-FAILING_AND_PASSING,10,2,12
345393648,runelite/runelite,25/08/18 19:46,spirals-bears,f217db01-bbb8-402e-8360-dcad68a2f96f_02-18-week4-FAILING_AND_PASSING,12,1,13
345292109,runelite/runelite,25/08/18 19:46,spirals-bears,f217db01-bbb8-402e-8360-dcad68a2f96f_02-18-week4-FAILING_AND_PASSING,12,0,12
345099583,runelite/runelite,25/08/18 19:46,spirals-bears,f217db01-bbb8-402e-8360-dcad68a2f96f_02-18-week4-FAILING_AND_PASSING,10,0,10
347166756,terasolunaorg/tutorial-apps,25/08/18 19:46,spirals-bears,f217db01-bbb8-402e-8360-dcad68a2f96f_02-18-week4-FAILING_AND_PASSING,4,2,6
347166052,terasolunaorg/tutorial-apps,25/08/18 19:47,spirals-bears,f217db01-bbb8-402e-8360-dcad68a2f96f_02-18-week4-FAILING_AND_PASSING,3,0,3
346615320,terasolunaorg/tutorial-apps,25/08/18 19:47,spirals-bears,f217db01-bbb8-402e-8360-dcad68a2f96f_02-18-week4-FAILING_AND_PASSING,4,2,6
345719096,runelite/runelite,25/08/18 19:47,spirals-bears,f217db01-bbb8-402e-8360-dcad68a2f96f_02-18-week4-FAILING_AND_PASSING,94,11,0,16,0,121
346614948,terasolunaorg/tutorial-apps,25/08/18 19:47,spirals-bears,f217db01-bbb8-402e-8360-dcad68a2f96f_02-18-week4-FAILING_AND_PASSING,3,0,3
343656330,terasolunaorg/tutorial-apps,25/08/18 19:47,spirals-bears,f217db01-bbb8-402e-8360-dcad68a2f96f_02-18-week4-FAILING_AND_PASSING,3,2,5
342191560,terasolunaorg/tutorial-apps,25/08/18 19:47,spirals-bears,f217db01-bbb8-402e-8360-dcad68a2f96f_02-18-week4-FAILING_AND_PASSING,4,0,4
344714736,terasolunaorg/tutorial-apps,25/08/18 19:48,spirals-bears,f217db01-bbb8-402e-8360-dcad68a2f96f_02-18-week4-FAILING_AND_PASSING,4,0,4
344997949,CorfuDB/CorfuDB,25/08/18 19:52,spirals-bears,f217db01-bbb8-402e-8360-dcad68a2f96f_02-18-week4-FAILING_AND_PASSING,251,0,251
346965862,CorfuDB/CorfuDB,25/08/18 19:52,spirals-bears,f217db01-bbb8-402e-8360-dcad68a2f96f_02-18-week4-FAILING_AND_PASSING,258,0,258
335102817,spring-projects/spring-data-jpa,25/08/18 19:52,spirals-bears,f217db01-bbb8-402e-8360-dcad68a2f96f_02-18-week4-FAILING_AND_PASSING,6,0,6
346514785,apache/storm,25/08/18 19:53,spirals-bears,f217db01-bbb8-402e-8360-dcad68a2f96f_02-18-week4-FAILING_AND_PASSING,35,3,38
344558919,CorfuDB/CorfuDB,25/08/18 19:56,spirals-bears,f217db01-bbb8-402e-8360-dcad68a2f96f_02-18-week4-FAILING_AND_PASSING,261,0,261
343860367,apache/storm,25/08/18 19:57,spirals-bears,f217db01-bbb8-402e-8360-dcad68a2f96f_02-18-week4-FAILING_AND_PASSING,36,6,42
346810113,apache/activemq-artemis,25/08/18 19:58,spirals-bears,f217db01-bbb8-402e-8360-dcad68a2f96f_02-18-week4-FAILING_AND_PASSING,29,4,33
345740713,matsim-org/matsim,25/08/18 19:59,spirals-bears,f217db01-bbb8-402e-8360-dcad68a2f96f_02-18-week4-FAILING_AND_PASSING,1652,195,0,1,0,1848
345465550,matsim-org/matsim,25/08/18 19:59,spirals-bears,f217db01-bbb8-402e-8360-dcad68a2f96f_02-18-week4-FAILING_AND_PASSING,1615,144,0,1,1,1761
347053584,apache/activemq-artemis,25/08/18 20:01,spirals-bears,f217db01-bbb8-402e-8360-dcad68a2f96f_02-18-week4-FAILING_AND_PASSING,29,48,77
346581667,apache/activemq-artemis,25/08/18 20:02,spirals-bears,f217db01-bbb8-402e-8360-dcad68a2f96f_02-18-week4-FAILING_AND_PASSING,27,5,32
347133846,apache/activemq-artemis,25/08/18 20:11,spirals-bears,f217db01-bbb8-402e-8360-dcad68a2f96f_02-18-week4-FAILING_AND_PASSING,306,450,28,0,6,1,1,792
346977565,apache/activemq-artemis,25/08/18 20:13,spirals-bears,f217db01-bbb8-402e-8360-dcad68a2f96f_02-18-week4-FAILING_AND_PASSING,30,43,73
347076594,apache/activemq-artemis,25/08/18 20:13,spirals-bears,f217db01-bbb8-402e-8360-dcad68a2f96f_02-18-week4-FAILING_AND_PASSING,313,450,29,0,1,1,1,795
346580729,apache/activemq-artemis,25/08/18 20:14,spirals-bears,f217db01-bbb8-402e-8360-dcad68a2f96f_02-18-week4-FAILING_AND_PASSING,29,6,35
346528896,apache/activemq-artemis,25/08/18 20:27,spirals-bears,f217db01-bbb8-402e-8360-dcad68a2f96f_02-18-week4-FAILING_AND_PASSING,349,465,29,0,1,1,1,846
346528156,apache/activemq-artemis,25/08/18 20:28,spirals-bears,f217db01-bbb8-402e-8360-dcad68a2f96f_02-18-week4-FAILING_AND_PASSING,324,476,33,0,2,3,2,840
346491641,apache/activemq-artemis,25/08/18 20:29,spirals-bears,f217db01-bbb8-402e-8360-dcad68a2f96f_02-18-week4-FAILING_AND_PASSING,29,56,85
346419359,apache/activemq-artemis,25/08/18 20:30,spirals-bears,f217db01-bbb8-402e-8360-dcad68a2f96f_02-18-week4-FAILING_AND_PASSING,28,43,71
346201823,apache/activemq-artemis,25/08/18 20:30,spirals-bears,f217db01-bbb8-402e-8360-dcad68a2f96f_02-18-week4-FAILING_AND_PASSING,29,6,35
346447222,apache/storm,25/08/18 20:30,spirals-bears,f217db01-bbb8-402e-8360-dcad68a2f96f_02-18-week4-FAILING_AND_PASSING,10,0,1,1,2,38,0,345,582,0,551,655,39,0,2224
344993350,apache/activemq-artemis,25/08/18 20:31,spirals-bears,f217db01-bbb8-402e-8360-dcad68a2f96f_02-18-week4-FAILING_AND_PASSING,27,5,32
344951683,apache/activemq-artemis,25/08/18 20:32,spirals-bears,f217db01-bbb8-402e-8360-dcad68a2f96f_02-18-week4-FAILING_AND_PASSING,28,5,33
347165585,linkedin/pinot,25/08/18 20:33,spirals-bears,f217db01-bbb8-402e-8360-dcad68a2f96f_02-18-week4-FAILING_AND_PASSING,34,3,37
346610558,linkedin/pinot,25/08/18 20:34,spirals-bears,f217db01-bbb8-402e-8360-dcad68a2f96f_02-18-week4-FAILING_AND_PASSING,40,9,49
346404198,linkedin/pinot,25/08/18 20:35,spirals-bears,f217db01-bbb8-402e-8360-dcad68a2f96f_02-18-week4-FAILING_AND_PASSING,39,3,42
346755528,apache/activemq-artemis,25/08/18 20:37,spirals-bears,f217db01-bbb8-402e-8360-dcad68a2f96f_02-18-week4-FAILING_AND_PASSING,12,40,0,1,14,0,2,40,1,299,0,445,1,677,477,27,53,1,2090
345047880,linkedin/pinot,25/08/18 20:38,spirals-bears,f217db01-bbb8-402e-8360-dcad68a2f96f_02-18-week4-FAILING_AND_PASSING,39,7,46
344625137,linkedin/pinot,25/08/18 20:39,spirals-bears,f217db01-bbb8-402e-8360-dcad68a2f96f_02-18-week4-FAILING_AND_PASSING,34,8,42
346399179,apache/activemq-artemis,25/08/18 20:43,spirals-bears,f217db01-bbb8-402e-8360-dcad68a2f96f_02-18-week4-FAILING_AND_PASSING,301,495,29,0,3,1,1,830
344974516,Azure/azure-libraries-for-java,25/08/18 20:44,spirals-bears,f217db01-bbb8-402e-8360-dcad68a2f96f_02-18-week4-FAILING_AND_PASSING,74,7,81
344998979,apache/activemq-artemis,25/08/18 20:45,spirals-bears,f217db01-bbb8-402e-8360-dcad68a2f96f_02-18-week4-FAILING_AND_PASSING,310,498,29,0,1,1,0,839
345549853,Azure/azure-libraries-for-java,25/08/18 20:47,spirals-bears,f217db01-bbb8-402e-8360-dcad68a2f96f_02-18-week4-FAILING_AND_PASSING,11,0,10,0,1,24,0,95,79,5,95,106,78,0,504
346781867,HubSpot/Singularity,25/08/18 20:56,spirals-bears,f217db01-bbb8-402e-8360-dcad68a2f96f_02-18-week4-FAILING_AND_PASSING,62,424,17,0,0,1,2,506
346925585,HubSpot/Singularity,25/08/18 21:10,spirals-bears,f217db01-bbb8-402e-8360-dcad68a2f96f_02-18-week4-FAILING_AND_PASSING,27,0,0,13,1,24,0,377,336,0,331,373,17,1,1500
346894272,HubSpot/Singularity,25/08/18 21:11,spirals-bears,f217db01-bbb8-402e-8360-dcad68a2f96f_02-18-week4-FAILING_AND_PASSING,21,0,0,16,1,30,0,461,333,0,324,386,17,1,1590
346781607,HubSpot/Singularity,25/08/18 21:25,spirals-bears,f217db01-bbb8-402e-8360-dcad68a2f96f_02-18-week4-FAILING_AND_PASSING,13,0,5,0,11,104,6,363,361,16,400,395,19,43,1736
346781601,HubSpot/Singularity,25/08/18 21:35,spirals-bears,f217db01-bbb8-402e-8360-dcad68a2f96f_02-18-week4-FAILING_AND_PASSING,14,0,1,0,4,40,0,348,345,0,340,395,19,0,1506
346430319,HubSpot/Singularity,25/08/18 21:37,spirals-bears,f217db01-bbb8-402e-8360-dcad68a2f96f_02-18-week4-FAILING_AND_PASSING,16,0,0,0,1,18,0,300,377,0,361,405,21,1,1500
344783331,HubSpot/Singularity,25/08/18 21:41,spirals-bears,f217db01-bbb8-402e-8360-dcad68a2f96f_02-18-week4-FAILING_AND_PASSING,212,17,0,0,1,230
344783254,HubSpot/Singularity,25/08/18 21:45,spirals-bears,f217db01-bbb8-402e-8360-dcad68a2f96f_02-18-week4-FAILING_AND_PASSING,222,17,0,2,1,242
346378303,HubSpot/Singularity,25/08/18 21:49,spirals-bears,f217db01-bbb8-402e-8360-dcad68a2f96f_02-18-week4-FAILING_AND_PASSING,12,0,0,0,1,4,0,306,334,0,280,437,18,0,1392
344783230,HubSpot/Singularity,25/08/18 21:49,spirals-bears,f217db01-bbb8-402e-8360-dcad68a2f96f_02-18-week4-FAILING_AND_PASSING,193,18,0,0,2,213
342685548,lettuce-io/lettuce-core,25/08/18 21:50,spirals-bears,f217db01-bbb8-402e-8360-dcad68a2f96f_02-18-week4-FAILING_AND_PASSING,19,43,8,0,0,0,0,70
345486440,linkedin/pinot,25/08/18 21:51,spirals-bears,f217db01-bbb8-402e-8360-dcad68a2f96f_02-18-week4-FAILING_AND_PASSING,4030,463,63,0,19,1,16,4592
347196078,StuPro-TOSCAna/TOSCAna,25/08/18 21:52,spirals-bears,f217db01-bbb8-402e-8360-dcad68a2f96f_02-18-week4-FAILING_AND_PASSING,18,2,20
346744833,StuPro-TOSCAna/TOSCAna,25/08/18 21:52,spirals-bears,f217db01-bbb8-402e-8360-dcad68a2f96f_02-18-week4-FAILING_AND_PASSING,15,2,17
346744593,StuPro-TOSCAna/TOSCAna,25/08/18 21:53,spirals-bears,f217db01-bbb8-402e-8360-dcad68a2f96f_02-18-week4-FAILING_AND_PASSING,14,0,14
347333445,StuPro-TOSCAna/TOSCAna,25/08/18 21:53,spirals-bears,f217db01-bbb8-402e-8360-dcad68a2f96f_02-18-week4-FAILING_AND_PASSING,14,2,16
346365100,visallo/vertexium,25/08/18 21:53,spirals-bears,f217db01-bbb8-402e-8360-dcad68a2f96f_02-18-week4-FAILING_AND_PASSING,12,157,8,0,0,1,0,178
347333151,StuPro-TOSCAna/TOSCAna,25/08/18 21:54,spirals-bears,f217db01-bbb8-402e-8360-dcad68a2f96f_02-18-week4-FAILING_AND_PASSING,14,0,14
347342574,StuPro-TOSCAna/TOSCAna,25/08/18 21:54,spirals-bears,f217db01-bbb8-402e-8360-dcad68a2f96f_02-18-week4-FAILING_AND_PASSING,14,2,16
347342481,StuPro-TOSCAna/TOSCAna,25/08/18 21:54,spirals-bears,f217db01-bbb8-402e-8360-dcad68a2f96f_02-18-week4-FAILING_AND_PASSING,13,0,13
347346678,StuPro-TOSCAna/TOSCAna,25/08/18 21:55,spirals-bears,f217db01-bbb8-402e-8360-dcad68a2f96f_02-18-week4-FAILING_AND_PASSING,17,0,17
347304379,StuPro-TOSCAna/TOSCAna,25/08/18 21:55,spirals-bears,f217db01-bbb8-402e-8360-dcad68a2f96f_02-18-week4-FAILING_AND_PASSING,21,2,23
347274898,StuPro-TOSCAna/TOSCAna,25/08/18 21:55,spirals-bears,f217db01-bbb8-402e-8360-dcad68a2f96f_02-18-week4-FAILING_AND_PASSING,16,2,18
347274889,StuPro-TOSCAna/TOSCAna,25/08/18 21:55,spirals-bears,f217db01-bbb8-402e-8360-dcad68a2f96f_02-18-week4-FAILING_AND_PASSING,17,0,17
345957337,StuPro-TOSCAna/TOSCAna,25/08/18 21:56,spirals-bears,f217db01-bbb8-402e-8360-dcad68a2f96f_02-18-week4-FAILING_AND_PASSING,14,0,14
345957335,StuPro-TOSCAna/TOSCAna,25/08/18 21:56,spirals-bears,f217db01-bbb8-402e-8360-dcad68a2f96f_02-18-week4-FAILING_AND_PASSING,26,2,28
345934236,StuPro-TOSCAna/TOSCAna,25/08/18 21:56,spirals-bears,f217db01-bbb8-402e-8360-dcad68a2f96f_02-18-week4-FAILING_AND_PASSING,15,2,17
345934140,StuPro-TOSCAna/TOSCAna,25/08/18 21:56,spirals-bears,f217db01-bbb8-402e-8360-dcad68a2f96f_02-18-week4-FAILING_AND_PASSING,14,0,14
345714929,StuPro-TOSCAna/TOSCAna,25/08/18 21:57,spirals-bears,f217db01-bbb8-402e-8360-dcad68a2f96f_02-18-week4-FAILING_AND_PASSING,18,0,18
345620297,StuPro-TOSCAna/TOSCAna,25/08/18 21:57,spirals-bears,f217db01-bbb8-402e-8360-dcad68a2f96f_02-18-week4-FAILING_AND_PASSING,14,0,14
344683083,molgenis/molgenis,25/08/18 21:57,spirals-bears,f217db01-bbb8-402e-8360-dcad68a2f96f_02-18-week4-FAILING_AND_PASSING,408,40,0,8,1,457
344851431,StuPro-TOSCAna/TOSCAna,25/08/18 21:57,spirals-bears,f217db01-bbb8-402e-8360-dcad68a2f96f_02-18-week4-FAILING_AND_PASSING,18,1,19
345620303,StuPro-TOSCAna/TOSCAna,25/08/18 21:57,spirals-bears,f217db01-bbb8-402e-8360-dcad68a2f96f_02-18-week4-FAILING_AND_PASSING,20,2,22
346588999,apache/incubator-dubbo,25/08/18 21:58,spirals-bears,f217db01-bbb8-402e-8360-dcad68a2f96f_02-18-week4-FAILING_AND_PASSING,8,0,8
345527176,apache/incubator-dubbo,25/08/18 21:58,spirals-bears,f217db01-bbb8-402e-8360-dcad68a2f96f_02-18-week4-FAILING_AND_PASSING,9,3,12
344933751,HubSpot/Singularity,25/08/18 21:58,spirals-bears,f217db01-bbb8-402e-8360-dcad68a2f96f_02-18-week4-FAILING_AND_PASSING,8,0,0,0,1,5,0,275,296,0,335,388,17,0,1325
344977999,ga4gh/dockstore,25/08/18 21:58,spirals-bears,f217db01-bbb8-402e-8360-dcad68a2f96f_02-18-week4-FAILING_AND_PASSING,8,0,8
345342983,ga4gh/dockstore,25/08/18 21:59,spirals-bears,f217db01-bbb8-402e-8360-dcad68a2f96f_02-18-week4-FAILING_AND_PASSING,8,2,10
345342998,ga4gh/dockstore,25/08/18 21:59,spirals-bears,f217db01-bbb8-402e-8360-dcad68a2f96f_02-18-week4-FAILING_AND_PASSING,8,0,8
342886648,apache/incubator-dubbo,25/08/18 22:07,spirals-bears,f217db01-bbb8-402e-8360-dcad68a2f96f_02-18-week4-FAILING_AND_PASSING,7,4,0,1,6,0,1,3,0,189,0,49,0,87,208,8,4,0,567
346169964,apache/incubator-dubbo,25/08/18 22:11,spirals-bears,f217db01-bbb8-402e-8360-dcad68a2f96f_02-18-week4-FAILING_AND_PASSING,10,3,0,1,6,0,2,3,0,180,0,147,0,108,315,8,3,0,786
344959128,languagetool-org/languagetool,25/08/18 22:17,spirals-bears,f217db01-bbb8-402e-8360-dcad68a2f96f_02-18-week4-FAILING_AND_PASSING,778,116,283,0,1,2,0,1180
347224286,apache/jackrabbit-oak,25/08/18 22:59,spirals-bears,f217db01-bbb8-402e-8360-dcad68a2f96f_02-18-week4-FAILING_AND_PASSING,8,0,2,0,1,7,0,1312,188,0,1276,287,36,1,3118
344705262,apache/jackrabbit-oak,25/08/18 23:01,spirals-bears,f217db01-bbb8-402e-8360-dcad68a2f96f_02-18-week4-FAILING_AND_PASSING,8,0,2,0,1,8,0,1270,189,0,1226,274,34,1,3013
347259239,apache/jackrabbit-oak,25/08/18 23:03,spirals-bears,f217db01-bbb8-402e-8360-dcad68a2f96f_02-18-week4-FAILING_AND_PASSING,7,0,2,0,1,6,0,1616,168,0,1717,261,35,1,3814
346413659,atomix/atomix,25/08/18 23:22,spirals-bears,f217db01-bbb8-402e-8360-dcad68a2f96f_02-18-week4-FAILING_AND_PASSING,9,4,0,0,11,0,0,3,0,472,0,80,0,479,97,12,3,0,1170
347082165,apache/jackrabbit-oak,25/08/18 23:29,spirals-bears,f217db01-bbb8-402e-8360-dcad68a2f96f_02-18-week4-FAILING_AND_PASSING,11,0,1,1,2,32,0,1652,392,1,1720,476,36,1,4325
338756266,airlift/airlift,25/08/18 23:30,spirals-bears,f217db01-bbb8-402e-8360-dcad68a2f96f_02-18-week4-FAILING_AND_PASSING,14,3,17
346747503,geoserver/geoserver,25/08/18 23:34,spirals-bears,f217db01-bbb8-402e-8360-dcad68a2f96f_02-18-week4-FAILING_AND_PASSING,157,55,0,14,1,227
346349528,geoserver/geoserver,25/08/18 23:35,spirals-bears,f217db01-bbb8-402e-8360-dcad68a2f96f_02-18-week4-FAILING_AND_PASSING,52,8,60
346413515,atomix/atomix,25/08/18 23:39,spirals-bears,f217db01-bbb8-402e-8360-dcad68a2f96f_02-18-week4-FAILING_AND_PASSING,10,3,0,0,8,0,1,2,0,481,0,83,0,294,96,12,3,0,993
345876678,geoserver/geoserver,25/08/18 23:42,spirals-bears,f217db01-bbb8-402e-8360-dcad68a2f96f_02-18-week4-FAILING_AND_PASSING,121,53,0,5,1,180
344350920,geoserver/geoserver,25/08/18 23:44,spirals-bears,f217db01-bbb8-402e-8360-dcad68a2f96f_02-18-week4-FAILING_AND_PASSING,54,6,60
344917918,geoserver/geoserver,25/08/18 23:45,spirals-bears,f217db01-bbb8-402e-8360-dcad68a2f96f_02-18-week4-FAILING_AND_PASSING,51,11,62
344933787,geoserver/geoserver,25/08/18 23:48,spirals-bears,f217db01-bbb8-402e-8360-dcad68a2f96f_02-18-week4-FAILING_AND_PASSING,117,55,0,5,0,177
345885177,geoserver/geoserver,26/08/18 00:03,spirals-bears,f217db01-bbb8-402e-8360-dcad68a2f96f_02-18-week4-FAILING_AND_PASSING,11,0,5,0,0,36,0,444,41,0,431,595,63,0,1626
345223210,isopov/tarantool-java-driver,26/08/18 00:04,spirals-bears,f217db01-bbb8-402e-8360-dcad68a2f96f_02-18-week4-FAILING_AND_PASSING,9,0,0,0,0,0,0,8,9,0,8,25,3,0,62
346256450,apache/jackrabbit-oak,26/08/18 00:10,spirals-bears,f217db01-bbb8-402e-8360-dcad68a2f96f_02-18-week4-FAILING_AND_PASSING,7,0,2,1,2,11,0,1666,387,3,1656,465,36,1,4237
346339751,apache/jackrabbit-oak,26/08/18 00:13,spirals-bears,f217db01-bbb8-402e-8360-dcad68a2f96f_02-18-week4-FAILING_AND_PASSING,8,0,1,1,2,19,0,1670,368,0,1694,448,36,1,4248
344404181,geoserver/geoserver,26/08/18 00:14,spirals-bears,f217db01-bbb8-402e-8360-dcad68a2f96f_02-18-week4-FAILING_AND_PASSING,28,0,6,0,0,39,0,433,40,0,457,512,51,0,1566
346102143,RipMeApp/ripme,26/08/18 00:23,spirals-bears,f217db01-bbb8-402e-8360-dcad68a2f96f_02-18-week4-FAILING_AND_PASSING,9,0,0,0,0,0,0,228,12,0,316,20,5,0,590
346692606,apache/incubator-servicecomb-saga,26/08/18 00:23,spirals-bears,f217db01-bbb8-402e-8360-dcad68a2f96f_02-18-week4-FAILING_AND_PASSING,4,2,6
345371006,datastax/java-driver,26/08/18 00:23,spirals-bears,f217db01-bbb8-402e-8360-dcad68a2f96f_02-18-week4-FAILING_AND_PASSING,15,0,15
345371015,datastax/java-driver,26/08/18 00:24,spirals-bears,f217db01-bbb8-402e-8360-dcad68a2f96f_02-18-week4-FAILING_AND_PASSING,15,2,17
344900277,datastax/java-driver,26/08/18 00:24,spirals-bears,f217db01-bbb8-402e-8360-dcad68a2f96f_02-18-week4-FAILING_AND_PASSING,14,2,16
344899924,datastax/java-driver,26/08/18 00:25,spirals-bears,f217db01-bbb8-402e-8360-dcad68a2f96f_02-18-week4-FAILING_AND_PASSING,18,0,18
344716881,datastax/java-driver,26/08/18 00:25,spirals-bears,f217db01-bbb8-402e-8360-dcad68a2f96f_02-18-week4-FAILING_AND_PASSING,15,2,17
344716862,datastax/java-driver,26/08/18 00:25,spirals-bears,f217db01-bbb8-402e-8360-dcad68a2f96f_02-18-week4-FAILING_AND_PASSING,16,0,16
346388661,SzFMV2018-Tavasz/AutomatedCar,26/08/18 00:27,spirals-bears,f217db01-bbb8-402e-8360-dcad68a2f96f_02-18-week4-FAILING_AND_PASSING,9,0,0,0,3,0,0,0,0,8,0,8,0,9,18,8,0,0,63
346759915,danglotb/dspot,26/08/18 00:27,spirals-bears,f217db01-bbb8-402e-8360-dcad68a2f96f_02-18-week4-FAILING_AND_PASSING,6,0,6
346518439,danglotb/dspot,26/08/18 00:27,spirals-bears,f217db01-bbb8-402e-8360-dcad68a2f96f_02-18-week4-FAILING_AND_PASSING,5,0,5
346102021,RipMeApp/ripme,26/08/18 00:27,spirals-bears,f217db01-bbb8-402e-8360-dcad68a2f96f_02-18-week4-FAILING_AND_PASSING,9,0,3,0,0,0,0,431,7,3,273,17,4,0,747
346503149,danglotb/dspot,26/08/18 00:27,spirals-bears,f217db01-bbb8-402e-8360-dcad68a2f96f_02-18-week4-FAILING_AND_PASSING,6,0,6
346313203,danglotb/dspot,26/08/18 00:27,spirals-bears,f217db01-bbb8-402e-8360-dcad68a2f96f_02-18-week4-FAILING_AND_PASSING,6,0,6
346272555,danglotb/dspot,26/08/18 00:28,spirals-bears,f217db01-bbb8-402e-8360-dcad68a2f96f_02-18-week4-FAILING_AND_PASSING,6,0,6
344870824,danglotb/dspot,26/08/18 00:28,spirals-bears,f217db01-bbb8-402e-8360-dcad68a2f96f_02-18-week4-FAILING_AND_PASSING,5,0,5
347342477,dhis2/dhis2-core,26/08/18 00:30,spirals-bears,f217db01-bbb8-402e-8360-dcad68a2f96f_02-18-week4-FAILING_AND_PASSING,79,23,0,1,0,103
346664048,aicis/fresco,26/08/18 00:30,spirals-bears,f217db01-bbb8-402e-8360-dcad68a2f96f_02-18-week4-FAILING_AND_PASSING,1462,97,9,0,0,0,0,1568
346834374,dhis2/dhis2-core,26/08/18 00:37,spirals-bears,f217db01-bbb8-402e-8360-dcad68a2f96f_02-18-week4-FAILING_AND_PASSING,12,0,3,0,0,7,0,199,12,0,13,165,31,0,442
346747075,dhis2/dhis2-core,26/08/18 00:38,spirals-bears,f217db01-bbb8-402e-8360-dcad68a2f96f_02-18-week4-FAILING_AND_PASSING,22,7,29
345422515,aicis/fresco,26/08/18 00:40,spirals-bears,f217db01-bbb8-402e-8360-dcad68a2f96f_02-18-week4-FAILING_AND_PASSING,1649,87,9,0,0,0,0,1745
346385765,dhis2/dhis2-core,26/08/18 00:40,spirals-bears,f217db01-bbb8-402e-8360-dcad68a2f96f_02-18-week4-FAILING_AND_PASSING,83,22,0,5,0,110
346255456,danglotb/dspot,26/08/18 00:40,spirals-bears,f217db01-bbb8-402e-8360-dcad68a2f96f_02-18-week4-FAILING_AND_PASSING,9,0,0,0,0,1,0,9,48,0,498,185,6,0,756
346403945,dhis2/dhis2-core,26/08/18 00:40,spirals-bears,f217db01-bbb8-402e-8360-dcad68a2f96f_02-18-week4-FAILING_AND_PASSING,14,0,3,0,0,7,0,185,15,0,187,163,25,0,599
344355768,dhis2/dhis2-core,26/08/18 00:41,spirals-bears,f217db01-bbb8-402e-8360-dcad68a2f96f_02-18-week4-FAILING_AND_PASSING,24,3,27
344713389,debezium/debezium,26/08/18 00:41,spirals-bears,f217db01-bbb8-402e-8360-dcad68a2f96f_02-18-week4-FAILING_AND_PASSING,7,5,12
346328584,dhis2/dhis2-core,26/08/18 00:42,spirals-bears,f217db01-bbb8-402e-8360-dcad68a2f96f_02-18-week4-FAILING_AND_PASSING,87,22,0,1,0,110
346132400,FrankSauve/345BudgetApp,26/08/18 00:43,spirals-bears,f217db01-bbb8-402e-8360-dcad68a2f96f_02-18-week4-FAILING_AND_PASSING,12,41,3,0,0,0,0,56
346314718,debezium/debezium,26/08/18 00:44,spirals-bears,f217db01-bbb8-402e-8360-dcad68a2f96f_02-18-week4-FAILING_AND_PASSING,53,115,8,0,4,0,0,180
346808225,debezium/debezium,26/08/18 00:44,spirals-bears,f217db01-bbb8-402e-8360-dcad68a2f96f_02-18-week4-FAILING_AND_PASSING,53,131,6,0,7,0,0,197
346214998,Spirals-Team/repairnator,26/08/18 00:44,spirals-bears,f217db01-bbb8-402e-8360-dcad68a2f96f_02-18-week4-FAILING_AND_PASSING,17,0,17
346215143,Spirals-Team/repairnator,26/08/18 00:45,spirals-bears,f217db01-bbb8-402e-8360-dcad68a2f96f_02-18-week4-FAILING_AND_PASSING,16,2,18
346006276,FrankSauve/345BudgetApp,26/08/18 00:45,spirals-bears,f217db01-bbb8-402e-8360-dcad68a2f96f_02-18-week4-FAILING_AND_PASSING,6,1,0,0,4,0,0,1,0,10,0,17,0,13,41,3,1,0,97
346006609,FrankSauve/345BudgetApp,26/08/18 00:46,spirals-bears,f217db01-bbb8-402e-8360-dcad68a2f96f_02-18-week4-FAILING_AND_PASSING,6,1,0,2,5,0,0,1,0,10,0,16,2,12,43,3,1,0,102
345316410,MyCoRe-Org/mycore,26/08/18 00:49,spirals-bears,f217db01-bbb8-402e-8360-dcad68a2f96f_02-18-week4-FAILING_AND_PASSING,383,48,28,2,29,490
346346339,jnidzwetzki/bboxdb,26/08/18 00:49,spirals-bears,f217db01-bbb8-402e-8360-dcad68a2f96f_02-18-week4-FAILING_AND_PASSING,5,0,0,0,0,1,0,27,70,0,28,133,9,0,273
345281730,jnidzwetzki/bboxdb,26/08/18 00:50,spirals-bears,f217db01-bbb8-402e-8360-dcad68a2f96f_02-18-week4-FAILING_AND_PASSING,5,0,0,0,0,1,0,36,78,0,39,120,8,0,287
345162567,jnidzwetzki/bboxdb,26/08/18 00:51,spirals-bears,f217db01-bbb8-402e-8360-dcad68a2f96f_02-18-week4-FAILING_AND_PASSING,5,0,0,0,0,1,0,37,78,0,41,123,8,0,293
344771467,jnidzwetzki/bboxdb,26/08/18 00:55,spirals-bears,f217db01-bbb8-402e-8360-dcad68a2f96f_02-18-week4-FAILING_AND_PASSING,5,0,0,0,0,1,0,37,74,0,38,135,8,0,298
