337550434,apache/flink,22/08/18 03:57,spirals-bears,d75f4a89-740d-4a70-a89e-2e09374fb945_02-18-week1-FAILING_AND_PASSING,72,7,79
338604155,apache/flink,22/08/18 03:57,spirals-bears,d75f4a89-740d-4a70-a89e-2e09374fb945_02-18-week1-FAILING_AND_PASSING,72,7,79
337474312,apache/flink,22/08/18 03:58,spirals-bears,d75f4a89-740d-4a70-a89e-2e09374fb945_02-18-week1-FAILING_AND_PASSING,59,6,65
336567326,apache/flink,22/08/18 03:58,spirals-bears,d75f4a89-740d-4a70-a89e-2e09374fb945_02-18-week1-FAILING_AND_PASSING,63,6,69
338152503,apache/flink,22/08/18 04:37,spirals-bears,d75f4a89-740d-4a70-a89e-2e09374fb945_02-18-week1-FAILING_AND_PASSING,8,0,3,0,2,82,0,40,697,9,41,1498,77,1,2458
338212139,apache/flink,22/08/18 04:40,spirals-bears,d75f4a89-740d-4a70-a89e-2e09374fb945_02-18-week1-FAILING_AND_PASSING,11,0,4,0,1,109,0,47,754,4,53,1571,67,1,2622
336094491,apache/flink,22/08/18 04:41,spirals-bears,d75f4a89-740d-4a70-a89e-2e09374fb945_02-18-week1-FAILING_AND_PASSING,59,5,64
337376835,apache/flink,22/08/18 04:44,spirals-bears,d75f4a89-740d-4a70-a89e-2e09374fb945_02-18-week1-FAILING_AND_PASSING,15,0,9,0,1,133,5,41,767,11,52,1581,74,2,2691
337293550,apache/flink,22/08/18 04:50,spirals-bears,d75f4a89-740d-4a70-a89e-2e09374fb945_02-18-week1-FAILING_AND_PASSING,12,0,9,1,1,141,0,46,1116,14,55,1586,76,5,3062
336235533,apache/flink,22/08/18 04:51,spirals-bears,d75f4a89-740d-4a70-a89e-2e09374fb945_02-18-week1-FAILING_AND_PASSING,60,6,66
337251148,apache/flink,22/08/18 05:19,spirals-bears,d75f4a89-740d-4a70-a89e-2e09374fb945_02-18-week1-FAILING_AND_PASSING,9,0,7,1,1,85,0,50,710,8,54,1539,61,1,2526
336560928,apache/flink,22/08/18 05:24,spirals-bears,d75f4a89-740d-4a70-a89e-2e09374fb945_02-18-week1-FAILING_AND_PASSING,48,1571,11,64,0,2,1,111,0,585,2,5,2400
338312074,prestodb/presto,22/08/18 05:25,spirals-bears,d75f4a89-740d-4a70-a89e-2e09374fb945_02-18-week1-FAILING_AND_PASSING,43,4,47
336927679,apache/flink,22/08/18 05:26,spirals-bears,d75f4a89-740d-4a70-a89e-2e09374fb945_02-18-week1-FAILING_AND_PASSING,9,0,7,0,1,106,0,47,830,10,57,1538,58,1,2664
338252836,prestodb/presto,22/08/18 05:26,spirals-bears,d75f4a89-740d-4a70-a89e-2e09374fb945_02-18-week1-FAILING_AND_PASSING,45,5,50
338186756,prestodb/presto,22/08/18 05:27,spirals-bears,d75f4a89-740d-4a70-a89e-2e09374fb945_02-18-week1-FAILING_AND_PASSING,44,6,50
337586854,prestodb/presto,22/08/18 05:27,spirals-bears,d75f4a89-740d-4a70-a89e-2e09374fb945_02-18-week1-FAILING_AND_PASSING,43,9,52
337192494,prestodb/presto,22/08/18 05:28,spirals-bears,d75f4a89-740d-4a70-a89e-2e09374fb945_02-18-week1-FAILING_AND_PASSING,51,5,56
336809339,prestodb/presto,22/08/18 05:28,spirals-bears,d75f4a89-740d-4a70-a89e-2e09374fb945_02-18-week1-FAILING_AND_PASSING,45,7,52
336377280,prestodb/presto,22/08/18 05:29,spirals-bears,d75f4a89-740d-4a70-a89e-2e09374fb945_02-18-week1-FAILING_AND_PASSING,43,4,47
336121868,prestodb/presto,22/08/18 05:29,spirals-bears,d75f4a89-740d-4a70-a89e-2e09374fb945_02-18-week1-FAILING_AND_PASSING,41,9,50
335969556,prestodb/presto,22/08/18 05:30,spirals-bears,d75f4a89-740d-4a70-a89e-2e09374fb945_02-18-week1-FAILING_AND_PASSING,42,4,46
335627310,apache/flink,22/08/18 05:35,spirals-bears,d75f4a89-740d-4a70-a89e-2e09374fb945_02-18-week1-FAILING_AND_PASSING,8,0,2,0,1,101,0,52,773,4,59,1562,63,2,2627
335775842,apache/flink,22/08/18 06:15,spirals-bears,d75f4a89-740d-4a70-a89e-2e09374fb945_02-18-week1-FAILING_AND_PASSING,12,0,10,1,2,638,0,39,1002,9,87,1447,77,1,3325
337956234,apache/incubator-druid,22/08/18 06:17,spirals-bears,d75f4a89-740d-4a70-a89e-2e09374fb945_02-18-week1-FAILING_AND_PASSING,38,10,48
338180984,apache/incubator-druid,22/08/18 06:33,spirals-bears,d75f4a89-740d-4a70-a89e-2e09374fb945_02-18-week1-FAILING_AND_PASSING,12,0,2,1,45,0,1040,338,1,1844,468,38,2,3791
338662538,apache/incubator-druid,22/08/18 06:37,spirals-bears,d75f4a89-740d-4a70-a89e-2e09374fb945_02-18-week1-FAILING_AND_PASSING,10,0,3,1,44,0,1196,339,1,1862,522,36,5,4019
337681835,apache/incubator-druid,22/08/18 06:39,spirals-bears,d75f4a89-740d-4a70-a89e-2e09374fb945_02-18-week1-FAILING_AND_PASSING,38,9,47
337677079,apache/incubator-druid,22/08/18 06:40,spirals-bears,d75f4a89-740d-4a70-a89e-2e09374fb945_02-18-week1-FAILING_AND_PASSING,35,8,43
337446564,apache/incubator-druid,22/08/18 06:41,spirals-bears,d75f4a89-740d-4a70-a89e-2e09374fb945_02-18-week1-FAILING_AND_PASSING,35,8,43
338120476,apache/incubator-druid,22/08/18 06:52,spirals-bears,d75f4a89-740d-4a70-a89e-2e09374fb945_02-18-week1-FAILING_AND_PASSING,10,0,3,35,1,61,0,1890,340,0,1648,540,36,3,4567
335802054,apache/incubator-druid,22/08/18 06:54,spirals-bears,d75f4a89-740d-4a70-a89e-2e09374fb945_02-18-week1-FAILING_AND_PASSING,36,10,46
336224476,apache/incubator-druid,22/08/18 07:09,spirals-bears,d75f4a89-740d-4a70-a89e-2e09374fb945_02-18-week1-FAILING_AND_PASSING,79,715,7,32,0,9,1,11,0,45,0,7,906
318026539,thelastpickle/cassandra-reaper,22/08/18 07:09,spirals-bears,d75f4a89-740d-4a70-a89e-2e09374fb945_02-18-week1-FAILING_AND_PASSING,7,2,9
318026519,thelastpickle/cassandra-reaper,22/08/18 07:10,spirals-bears,d75f4a89-740d-4a70-a89e-2e09374fb945_02-18-week1-FAILING_AND_PASSING,9,0,9
336555578,thelastpickle/cassandra-reaper,22/08/18 07:10,spirals-bears,d75f4a89-740d-4a70-a89e-2e09374fb945_02-18-week1-FAILING_AND_PASSING,7,2,9
338013274,JMRI/JMRI,22/08/18 07:41,spirals-bears,d75f4a89-740d-4a70-a89e-2e09374fb945_02-18-week1-FAILING_AND_PASSING,1332,177,338,0,6,1,1854
337881545,apache/incubator-druid,22/08/18 07:41,spirals-bears,d75f4a89-740d-4a70-a89e-2e09374fb945_02-18-week1-FAILING_AND_PASSING,9,0,2,58,1,50,0,1588,366,1,1702,1255,36,4,5072
336568048,apache/incubator-druid,22/08/18 07:43,spirals-bears,d75f4a89-740d-4a70-a89e-2e09374fb945_02-18-week1-FAILING_AND_PASSING,8,0,2,2,1,57,0,1387,342,0,1567,454,37,1,3858
336714986,apache/incubator-druid,22/08/18 07:54,spirals-bears,d75f4a89-740d-4a70-a89e-2e09374fb945_02-18-week1-FAILING_AND_PASSING,8,0,2,2,1,53,0,1591,482,2,1442,707,41,1,4332
338193099,JMRI/JMRI,22/08/18 08:16,spirals-bears,d75f4a89-740d-4a70-a89e-2e09374fb945_02-18-week1-FAILING_AND_PASSING,1541,172,288,0,33,0,9,2043
337761337,JMRI/JMRI,22/08/18 08:17,spirals-bears,d75f4a89-740d-4a70-a89e-2e09374fb945_02-18-week1-FAILING_AND_PASSING,1549,168,299,0,30,0,9,2055
337289294,JMRI/JMRI,22/08/18 08:17,spirals-bears,d75f4a89-740d-4a70-a89e-2e09374fb945_02-18-week1-FAILING_AND_PASSING,1545,168,296,0,6,0,11,2026
337172154,JMRI/JMRI,22/08/18 08:27,spirals-bears,d75f4a89-740d-4a70-a89e-2e09374fb945_02-18-week1-FAILING_AND_PASSING,1541,167,273,0,8,0,9,1998
338555477,apache/nifi,22/08/18 08:52,spirals-bears,d75f4a89-740d-4a70-a89e-2e09374fb945_02-18-week1-FAILING_AND_PASSING,1435,38,2,2,4,1481
338655840,apache/nifi,22/08/18 08:54,spirals-bears,d75f4a89-740d-4a70-a89e-2e09374fb945_02-18-week1-FAILING_AND_PASSING,42,12,54
335677283,JMRI/JMRI,22/08/18 08:55,spirals-bears,d75f4a89-740d-4a70-a89e-2e09374fb945_02-18-week1-FAILING_AND_PASSING,1635,192,295,0,7,0,103,2232
336418443,JMRI/JMRI,22/08/18 08:55,spirals-bears,d75f4a89-740d-4a70-a89e-2e09374fb945_02-18-week1-FAILING_AND_PASSING,1686,190,295,0,33,0,64,2268
336255016,apache/nifi,22/08/18 08:55,spirals-bears,d75f4a89-740d-4a70-a89e-2e09374fb945_02-18-week1-FAILING_AND_PASSING,42,0,42
337038559,JMRI/JMRI,22/08/18 08:59,spirals-bears,d75f4a89-740d-4a70-a89e-2e09374fb945_02-18-week1-FAILING_AND_PASSING,1685,191,12,280,0,14,0,215,0,92,22,15,2526
337917449,EnMasseProject/enmasse,22/08/18 09:00,spirals-bears,d75f4a89-740d-4a70-a89e-2e09374fb945_02-18-week1-FAILING_AND_PASSING,130,86,30,0,1,2,0,249
337917481,EnMasseProject/enmasse,22/08/18 09:00,spirals-bears,d75f4a89-740d-4a70-a89e-2e09374fb945_02-18-week1-FAILING_AND_PASSING,129,83,32,0,4,2,0,250
337444527,EnMasseProject/enmasse,22/08/18 09:00,spirals-bears,d75f4a89-740d-4a70-a89e-2e09374fb945_02-18-week1-FAILING_AND_PASSING,136,81,39,0,1,2,0,259
338330994,batfish/batfish,22/08/18 09:01,spirals-bears,d75f4a89-740d-4a70-a89e-2e09374fb945_02-18-week1-FAILING_AND_PASSING,48,0,48
338279650,batfish/batfish,22/08/18 09:02,spirals-bears,d75f4a89-740d-4a70-a89e-2e09374fb945_02-18-week1-FAILING_AND_PASSING,52,0,52
338279662,batfish/batfish,22/08/18 09:03,spirals-bears,d75f4a89-740d-4a70-a89e-2e09374fb945_02-18-week1-FAILING_AND_PASSING,67,4,71
335994526,EnMasseProject/enmasse,22/08/18 09:03,spirals-bears,d75f4a89-740d-4a70-a89e-2e09374fb945_02-18-week1-FAILING_AND_PASSING,133,85,28,0,6,2,0,254
338262116,batfish/batfish,22/08/18 09:04,spirals-bears,d75f4a89-740d-4a70-a89e-2e09374fb945_02-18-week1-FAILING_AND_PASSING,53,0,53
337900566,batfish/batfish,22/08/18 09:04,spirals-bears,d75f4a89-740d-4a70-a89e-2e09374fb945_02-18-week1-FAILING_AND_PASSING,52,0,52
338690072,batfish/batfish,22/08/18 09:05,spirals-bears,d75f4a89-740d-4a70-a89e-2e09374fb945_02-18-week1-FAILING_AND_PASSING,7,224,57,0,1,5,0,294
338386571,batfish/batfish,22/08/18 09:05,spirals-bears,d75f4a89-740d-4a70-a89e-2e09374fb945_02-18-week1-FAILING_AND_PASSING,7,227,57,0,3,2,0,296
337830465,batfish/batfish,22/08/18 09:05,spirals-bears,d75f4a89-740d-4a70-a89e-2e09374fb945_02-18-week1-FAILING_AND_PASSING,52,0,52
337830676,batfish/batfish,22/08/18 09:06,spirals-bears,d75f4a89-740d-4a70-a89e-2e09374fb945_02-18-week1-FAILING_AND_PASSING,59,4,63
337728830,batfish/batfish,22/08/18 09:06,spirals-bears,d75f4a89-740d-4a70-a89e-2e09374fb945_02-18-week1-FAILING_AND_PASSING,49,3,52
337793447,batfish/batfish,22/08/18 09:06,spirals-bears,d75f4a89-740d-4a70-a89e-2e09374fb945_02-18-week1-FAILING_AND_PASSING,54,0,54
337728785,batfish/batfish,22/08/18 09:06,spirals-bears,d75f4a89-740d-4a70-a89e-2e09374fb945_02-18-week1-FAILING_AND_PASSING,50,0,50
336776009,batfish/batfish,22/08/18 09:07,spirals-bears,d75f4a89-740d-4a70-a89e-2e09374fb945_02-18-week1-FAILING_AND_PASSING,50,3,53
336745613,batfish/batfish,22/08/18 09:07,spirals-bears,d75f4a89-740d-4a70-a89e-2e09374fb945_02-18-week1-FAILING_AND_PASSING,55,0,55
338491801,apache/incubator-servicecomb-java-chassis,22/08/18 09:07,spirals-bears,d75f4a89-740d-4a70-a89e-2e09374fb945_02-18-week1-FAILING_AND_PASSING,9,0,9
336662206,lucee/Lucee,22/08/18 09:07,spirals-bears,d75f4a89-740d-4a70-a89e-2e09374fb945_02-18-week1-FAILING_AND_PASSING,3,6,24,0,0,1,0,34
337899036,apache/incubator-servicecomb-java-chassis,22/08/18 09:08,spirals-bears,d75f4a89-740d-4a70-a89e-2e09374fb945_02-18-week1-FAILING_AND_PASSING,9,4,13
338137052,runelite/runelite,22/08/18 09:08,spirals-bears,d75f4a89-740d-4a70-a89e-2e09374fb945_02-18-week1-FAILING_AND_PASSING,11,13,24
337571586,runelite/runelite,22/08/18 09:08,spirals-bears,d75f4a89-740d-4a70-a89e-2e09374fb945_02-18-week1-FAILING_AND_PASSING,10,0,10
337383520,runelite/runelite,22/08/18 09:08,spirals-bears,d75f4a89-740d-4a70-a89e-2e09374fb945_02-18-week1-FAILING_AND_PASSING,10,0,10
337316304,runelite/runelite,22/08/18 09:09,spirals-bears,d75f4a89-740d-4a70-a89e-2e09374fb945_02-18-week1-FAILING_AND_PASSING,9,0,9
337282140,runelite/runelite,22/08/18 09:09,spirals-bears,d75f4a89-740d-4a70-a89e-2e09374fb945_02-18-week1-FAILING_AND_PASSING,10,0,10
337744896,matsim-org/matsim,22/08/18 09:09,spirals-bears,d75f4a89-740d-4a70-a89e-2e09374fb945_02-18-week1-FAILING_AND_PASSING,164,0,164
337251264,runelite/runelite,22/08/18 09:09,spirals-bears,d75f4a89-740d-4a70-a89e-2e09374fb945_02-18-week1-FAILING_AND_PASSING,11,0,11
337116516,runelite/runelite,22/08/18 09:09,spirals-bears,d75f4a89-740d-4a70-a89e-2e09374fb945_02-18-week1-FAILING_AND_PASSING,11,0,11
337102287,runelite/runelite,22/08/18 09:09,spirals-bears,d75f4a89-740d-4a70-a89e-2e09374fb945_02-18-week1-FAILING_AND_PASSING,10,0,10
337101470,runelite/runelite,22/08/18 09:09,spirals-bears,d75f4a89-740d-4a70-a89e-2e09374fb945_02-18-week1-FAILING_AND_PASSING,12,0,12
337143343,runelite/runelite,22/08/18 09:09,spirals-bears,d75f4a89-740d-4a70-a89e-2e09374fb945_02-18-week1-FAILING_AND_PASSING,11,13,24
337095354,runelite/runelite,22/08/18 09:10,spirals-bears,d75f4a89-740d-4a70-a89e-2e09374fb945_02-18-week1-FAILING_AND_PASSING,11,0,11
337086119,runelite/runelite,22/08/18 09:10,spirals-bears,d75f4a89-740d-4a70-a89e-2e09374fb945_02-18-week1-FAILING_AND_PASSING,12,0,12
337061594,runelite/runelite,22/08/18 09:10,spirals-bears,d75f4a89-740d-4a70-a89e-2e09374fb945_02-18-week1-FAILING_AND_PASSING,12,0,12
336750649,runelite/runelite,22/08/18 09:10,spirals-bears,d75f4a89-740d-4a70-a89e-2e09374fb945_02-18-week1-FAILING_AND_PASSING,11,0,11
336746306,runelite/runelite,22/08/18 09:10,spirals-bears,d75f4a89-740d-4a70-a89e-2e09374fb945_02-18-week1-FAILING_AND_PASSING,11,13,24
336703591,runelite/runelite,22/08/18 09:10,spirals-bears,d75f4a89-740d-4a70-a89e-2e09374fb945_02-18-week1-FAILING_AND_PASSING,11,0,11
336695379,runelite/runelite,22/08/18 09:11,spirals-bears,d75f4a89-740d-4a70-a89e-2e09374fb945_02-18-week1-FAILING_AND_PASSING,12,0,12
336463636,runelite/runelite,22/08/18 09:11,spirals-bears,d75f4a89-740d-4a70-a89e-2e09374fb945_02-18-week1-FAILING_AND_PASSING,12,0,12
336409346,runelite/runelite,22/08/18 09:11,spirals-bears,d75f4a89-740d-4a70-a89e-2e09374fb945_02-18-week1-FAILING_AND_PASSING,10,0,10
336408844,runelite/runelite,22/08/18 09:11,spirals-bears,d75f4a89-740d-4a70-a89e-2e09374fb945_02-18-week1-FAILING_AND_PASSING,10,0,10
335940196,runelite/runelite,22/08/18 09:11,spirals-bears,d75f4a89-740d-4a70-a89e-2e09374fb945_02-18-week1-FAILING_AND_PASSING,10,0,10
336359641,runelite/runelite,22/08/18 09:12,spirals-bears,d75f4a89-740d-4a70-a89e-2e09374fb945_02-18-week1-FAILING_AND_PASSING,10,15,25
336905977,runelite/runelite,22/08/18 09:12,spirals-bears,d75f4a89-740d-4a70-a89e-2e09374fb945_02-18-week1-FAILING_AND_PASSING,87,12,0,16,0,115
335890420,runelite/runelite,22/08/18 09:12,spirals-bears,d75f4a89-740d-4a70-a89e-2e09374fb945_02-18-week1-FAILING_AND_PASSING,10,0,10
335894617,CorfuDB/CorfuDB,22/08/18 09:16,spirals-bears,d75f4a89-740d-4a70-a89e-2e09374fb945_02-18-week1-FAILING_AND_PASSING,243,0,243
335926935,CorfuDB/CorfuDB,22/08/18 09:16,spirals-bears,d75f4a89-740d-4a70-a89e-2e09374fb945_02-18-week1-FAILING_AND_PASSING,259,3,262
335905968,CorfuDB/CorfuDB,22/08/18 09:17,spirals-bears,d75f4a89-740d-4a70-a89e-2e09374fb945_02-18-week1-FAILING_AND_PASSING,309,3,312
338237828,apache/storm,22/08/18 09:17,spirals-bears,d75f4a89-740d-4a70-a89e-2e09374fb945_02-18-week1-FAILING_AND_PASSING,38,7,45
334174640,apache/storm,22/08/18 09:18,spirals-bears,d75f4a89-740d-4a70-a89e-2e09374fb945_02-18-week1-FAILING_AND_PASSING,35,6,41
337901489,linkedin/pinot,22/08/18 09:18,spirals-bears,d75f4a89-740d-4a70-a89e-2e09374fb945_02-18-week1-FAILING_AND_PASSING,58,3,61
337118832,Azure/azure-libraries-for-java,22/08/18 09:19,spirals-bears,d75f4a89-740d-4a70-a89e-2e09374fb945_02-18-week1-FAILING_AND_PASSING,65,4,69
335815306,CorfuDB/CorfuDB,22/08/18 09:20,spirals-bears,d75f4a89-740d-4a70-a89e-2e09374fb945_02-18-week1-FAILING_AND_PASSING,246,4,250
336757444,Azure/azure-libraries-for-java,22/08/18 09:20,spirals-bears,d75f4a89-740d-4a70-a89e-2e09374fb945_02-18-week1-FAILING_AND_PASSING,59,4,63
335888589,Azure/azure-libraries-for-java,22/08/18 09:22,spirals-bears,d75f4a89-740d-4a70-a89e-2e09374fb945_02-18-week1-FAILING_AND_PASSING,96,5,101
337796471,graphhopper/graphhopper,22/08/18 09:25,spirals-bears,d75f4a89-740d-4a70-a89e-2e09374fb945_02-18-week1-FAILING_AND_PASSING,76,129,32,0,1,0,0,238
336824539,Azure/azure-libraries-for-java,22/08/18 09:26,spirals-bears,d75f4a89-740d-4a70-a89e-2e09374fb945_02-18-week1-FAILING_AND_PASSING,12,0,11,0,0,15,0,92,75,4,96,91,58,0,454
335985628,matsim-org/matsim,22/08/18 09:35,spirals-bears,d75f4a89-740d-4a70-a89e-2e09374fb945_02-18-week1-FAILING_AND_PASSING,1528,173,0,5,1,1707
338593327,HubSpot/Singularity,22/08/18 09:46,spirals-bears,d75f4a89-740d-4a70-a89e-2e09374fb945_02-18-week1-FAILING_AND_PASSING,9,0,3,6,1,11,0,363,333,7,290,356,18,0,1397
338513857,HubSpot/Singularity,22/08/18 09:49,spirals-bears,d75f4a89-740d-4a70-a89e-2e09374fb945_02-18-week1-FAILING_AND_PASSING,9,0,3,3,1,9,0,362,370,4,276,365,16,0,1418
338513921,HubSpot/Singularity,22/08/18 09:50,spirals-bears,d75f4a89-740d-4a70-a89e-2e09374fb945_02-18-week1-FAILING_AND_PASSING,13,0,0,1,1,3,0,323,406,0,291,376,17,0,1431
337776497,HubSpot/Singularity,22/08/18 10:02,spirals-bears,d75f4a89-740d-4a70-a89e-2e09374fb945_02-18-week1-FAILING_AND_PASSING,12,0,0,0,1,48,2,352,368,1,354,427,16,8,1589
336716857,HubSpot/Singularity,22/08/18 10:12,spirals-bears,d75f4a89-740d-4a70-a89e-2e09374fb945_02-18-week1-FAILING_AND_PASSING,18,0,3,9,2,44,0,360,328,5,360,381,18,0,1528
337745166,HubSpot/Singularity,22/08/18 10:15,spirals-bears,d75f4a89-740d-4a70-a89e-2e09374fb945_02-18-week1-FAILING_AND_PASSING,15,0,1,2,2,15,0,354,377,0,348,415,21,0,1550
336397094,HubSpot/Singularity,22/08/18 10:16,spirals-bears,d75f4a89-740d-4a70-a89e-2e09374fb945_02-18-week1-FAILING_AND_PASSING,192,20,0,3,2,217
336592736,HubSpot/Singularity,22/08/18 10:16,spirals-bears,d75f4a89-740d-4a70-a89e-2e09374fb945_02-18-week1-FAILING_AND_PASSING,11,0,0,2,1,12,0,344,364,0,298,435,26,0,1493
335111136,lettuce-io/lettuce-core,22/08/18 10:17,spirals-bears,d75f4a89-740d-4a70-a89e-2e09374fb945_02-18-week1-FAILING_AND_PASSING,18,83,8,0,1,0,0,110
336398116,HubSpot/Singularity,22/08/18 10:26,spirals-bears,d75f4a89-740d-4a70-a89e-2e09374fb945_02-18-week1-FAILING_AND_PASSING,11,0,0,0,1,36,0,253,290,0,354,429,20,7,1401
338264660,magefree/mage,22/08/18 10:33,spirals-bears,d75f4a89-740d-4a70-a89e-2e09374fb945_02-18-week1-FAILING_AND_PASSING,10,0,13,0,1,42,0,171,29,1,208,329,182,1,987
337368511,magefree/mage,22/08/18 10:33,spirals-bears,d75f4a89-740d-4a70-a89e-2e09374fb945_02-18-week1-FAILING_AND_PASSING,8,0,13,0,0,44,0,169,28,1,211,325,188,1,988
337255850,magefree/mage,22/08/18 10:34,spirals-bears,d75f4a89-740d-4a70-a89e-2e09374fb945_02-18-week1-FAILING_AND_PASSING,9,0,12,0,0,42,0,176,28,1,196,338,174,1,977
337440600,molgenis/molgenis,22/08/18 10:34,spirals-bears,d75f4a89-740d-4a70-a89e-2e09374fb945_02-18-week1-FAILING_AND_PASSING,47,8,55
336445628,molgenis/molgenis,22/08/18 10:35,spirals-bears,d75f4a89-740d-4a70-a89e-2e09374fb945_02-18-week1-FAILING_AND_PASSING,38,7,45
334843335,visallo/vertexium,22/08/18 10:38,spirals-bears,d75f4a89-740d-4a70-a89e-2e09374fb945_02-18-week1-FAILING_AND_PASSING,11,148,9,0,0,0,0,168
337679202,StuPro-TOSCAna/TOSCAna,22/08/18 10:39,spirals-bears,d75f4a89-740d-4a70-a89e-2e09374fb945_02-18-week1-FAILING_AND_PASSING,13,3,16
337982434,StuPro-TOSCAna/TOSCAna,22/08/18 10:39,spirals-bears,d75f4a89-740d-4a70-a89e-2e09374fb945_02-18-week1-FAILING_AND_PASSING,22,0,22
337972530,StuPro-TOSCAna/TOSCAna,22/08/18 10:40,spirals-bears,d75f4a89-740d-4a70-a89e-2e09374fb945_02-18-week1-FAILING_AND_PASSING,17,4,21
337736892,StuPro-TOSCAna/TOSCAna,22/08/18 10:40,spirals-bears,d75f4a89-740d-4a70-a89e-2e09374fb945_02-18-week1-FAILING_AND_PASSING,14,2,16
337736851,StuPro-TOSCAna/TOSCAna,22/08/18 10:40,spirals-bears,d75f4a89-740d-4a70-a89e-2e09374fb945_02-18-week1-FAILING_AND_PASSING,13,0,13
337040912,magefree/mage,22/08/18 10:43,spirals-bears,d75f4a89-740d-4a70-a89e-2e09374fb945_02-18-week1-FAILING_AND_PASSING,7,0,21,0,2,33,0,171,35,5,198,321,235,1,1029
337164791,StuPro-TOSCAna/TOSCAna,22/08/18 10:43,spirals-bears,d75f4a89-740d-4a70-a89e-2e09374fb945_02-18-week1-FAILING_AND_PASSING,14,0,14
337164800,StuPro-TOSCAna/TOSCAna,22/08/18 10:44,spirals-bears,d75f4a89-740d-4a70-a89e-2e09374fb945_02-18-week1-FAILING_AND_PASSING,14,2,16
336979174,StuPro-TOSCAna/TOSCAna,22/08/18 10:44,spirals-bears,d75f4a89-740d-4a70-a89e-2e09374fb945_02-18-week1-FAILING_AND_PASSING,17,2,19
336720064,StuPro-TOSCAna/TOSCAna,22/08/18 10:45,spirals-bears,d75f4a89-740d-4a70-a89e-2e09374fb945_02-18-week1-FAILING_AND_PASSING,28,2,30
336720049,StuPro-TOSCAna/TOSCAna,22/08/18 10:45,spirals-bears,d75f4a89-740d-4a70-a89e-2e09374fb945_02-18-week1-FAILING_AND_PASSING,16,0,16
336932501,StuPro-TOSCAna/TOSCAna,22/08/18 10:46,spirals-bears,d75f4a89-740d-4a70-a89e-2e09374fb945_02-18-week1-FAILING_AND_PASSING,20,0,20
337254943,StuPro-TOSCAna/TOSCAna,22/08/18 10:46,spirals-bears,d75f4a89-740d-4a70-a89e-2e09374fb945_02-18-week1-FAILING_AND_PASSING,301,24,0,0,2,327
336355570,StuPro-TOSCAna/TOSCAna,22/08/18 10:46,spirals-bears,d75f4a89-740d-4a70-a89e-2e09374fb945_02-18-week1-FAILING_AND_PASSING,17,2,19
336355199,StuPro-TOSCAna/TOSCAna,22/08/18 10:47,spirals-bears,d75f4a89-740d-4a70-a89e-2e09374fb945_02-18-week1-FAILING_AND_PASSING,19,0,19
336248894,StuPro-TOSCAna/TOSCAna,22/08/18 10:47,spirals-bears,d75f4a89-740d-4a70-a89e-2e09374fb945_02-18-week1-FAILING_AND_PASSING,21,2,23
336247376,StuPro-TOSCAna/TOSCAna,22/08/18 10:47,spirals-bears,d75f4a89-740d-4a70-a89e-2e09374fb945_02-18-week1-FAILING_AND_PASSING,17,0,17
336151370,StuPro-TOSCAna/TOSCAna,22/08/18 10:47,spirals-bears,d75f4a89-740d-4a70-a89e-2e09374fb945_02-18-week1-FAILING_AND_PASSING,15,0,15
336151398,StuPro-TOSCAna/TOSCAna,22/08/18 10:48,spirals-bears,d75f4a89-740d-4a70-a89e-2e09374fb945_02-18-week1-FAILING_AND_PASSING,21,3,24
336126759,StuPro-TOSCAna/TOSCAna,22/08/18 10:48,spirals-bears,d75f4a89-740d-4a70-a89e-2e09374fb945_02-18-week1-FAILING_AND_PASSING,13,2,15
336124406,StuPro-TOSCAna/TOSCAna,22/08/18 10:48,spirals-bears,d75f4a89-740d-4a70-a89e-2e09374fb945_02-18-week1-FAILING_AND_PASSING,16,0,16
335856606,StuPro-TOSCAna/TOSCAna,22/08/18 10:48,spirals-bears,d75f4a89-740d-4a70-a89e-2e09374fb945_02-18-week1-FAILING_AND_PASSING,18,2,20
335856515,StuPro-TOSCAna/TOSCAna,22/08/18 10:48,spirals-bears,d75f4a89-740d-4a70-a89e-2e09374fb945_02-18-week1-FAILING_AND_PASSING,17,0,17
337910172,apache/incubator-dubbo,22/08/18 10:49,spirals-bears,d75f4a89-740d-4a70-a89e-2e09374fb945_02-18-week1-FAILING_AND_PASSING,9,0,9
337909441,apache/incubator-dubbo,22/08/18 10:49,spirals-bears,d75f4a89-740d-4a70-a89e-2e09374fb945_02-18-week1-FAILING_AND_PASSING,9,0,9
338613799,ga4gh/dockstore,22/08/18 10:49,spirals-bears,d75f4a89-740d-4a70-a89e-2e09374fb945_02-18-week1-FAILING_AND_PASSING,10,0,10
337546289,molgenis/molgenis,22/08/18 10:55,spirals-bears,d75f4a89-740d-4a70-a89e-2e09374fb945_02-18-week1-FAILING_AND_PASSING,767,481,41,0,10,1,1,1301
337427993,molgenis/molgenis,22/08/18 10:55,spirals-bears,d75f4a89-740d-4a70-a89e-2e09374fb945_02-18-week1-FAILING_AND_PASSING,755,475,47,0,11,1,1,1290
338121462,atomix/atomix,22/08/18 11:01,spirals-bears,d75f4a89-740d-4a70-a89e-2e09374fb945_02-18-week1-FAILING_AND_PASSING,219,89,13,0,1,1,0,323
337617223,dropwizard/metrics,22/08/18 11:06,spirals-bears,d75f4a89-740d-4a70-a89e-2e09374fb945_02-18-week1-FAILING_AND_PASSING,10,3,0,0,4,1,0,22,82,0,23,124,6,0,275
338603736,ga4gh/dockstore,22/08/18 11:06,spirals-bears,d75f4a89-740d-4a70-a89e-2e09374fb945_02-18-week1-FAILING_AND_PASSING,984,8,0,0,0,992
336172698,dropwizard/metrics,22/08/18 11:06,spirals-bears,d75f4a89-740d-4a70-a89e-2e09374fb945_02-18-week1-FAILING_AND_PASSING,7,2,9
333945094,dropwizard/metrics,22/08/18 11:07,spirals-bears,d75f4a89-740d-4a70-a89e-2e09374fb945_02-18-week1-FAILING_AND_PASSING,7,2,9
333945053,dropwizard/metrics,22/08/18 11:07,spirals-bears,d75f4a89-740d-4a70-a89e-2e09374fb945_02-18-week1-FAILING_AND_PASSING,7,0,7
338502679,languagetool-org/languagetool,22/08/18 11:07,spirals-bears,d75f4a89-740d-4a70-a89e-2e09374fb945_02-18-week1-FAILING_AND_PASSING,755,98,276,0,3,1,0,1133
336355904,openzipkin/zipkin,22/08/18 11:08,spirals-bears,d75f4a89-740d-4a70-a89e-2e09374fb945_02-18-week1-FAILING_AND_PASSING,24,0,24
335282424,resteasy/Resteasy,22/08/18 11:08,spirals-bears,d75f4a89-740d-4a70-a89e-2e09374fb945_02-18-week1-FAILING_AND_PASSING,18,4,22
337249133,pgjdbc/pgjdbc,22/08/18 11:09,spirals-bears,d75f4a89-740d-4a70-a89e-2e09374fb945_02-18-week1-FAILING_AND_PASSING,8,2,10
338433582,geoserver/geoserver,22/08/18 11:10,spirals-bears,d75f4a89-740d-4a70-a89e-2e09374fb945_02-18-week1-FAILING_AND_PASSING,53,8,61
336563220,isopov/tarantool-java-driver,22/08/18 11:10,spirals-bears,d75f4a89-740d-4a70-a89e-2e09374fb945_02-18-week1-FAILING_AND_PASSING,2,0,2
336007188,isopov/tarantool-java-driver,22/08/18 11:10,spirals-bears,d75f4a89-740d-4a70-a89e-2e09374fb945_02-18-week1-FAILING_AND_PASSING,2,0,2
336168312,dropwizard/metrics,22/08/18 11:11,spirals-bears,d75f4a89-740d-4a70-a89e-2e09374fb945_02-18-week1-FAILING_AND_PASSING,10,1,3,0,4,0,4,1,0,66,0,83,0,21,115,7,1,0,316
335412310,airlift/airlift,22/08/18 11:16,spirals-bears,d75f4a89-740d-4a70-a89e-2e09374fb945_02-18-week1-FAILING_AND_PASSING,275,227,12,0,0,1,0,515
338439832,aicis/fresco,22/08/18 11:35,spirals-bears,d75f4a89-740d-4a70-a89e-2e09374fb945_02-18-week1-FAILING_AND_PASSING,1318,93,10,0,1,0,0,1422
338476621,aicis/fresco,22/08/18 11:38,spirals-bears,d75f4a89-740d-4a70-a89e-2e09374fb945_02-18-week1-FAILING_AND_PASSING,1543,100,8,0,0,0,0,1651
337535538,apache/jackrabbit-oak,22/08/18 11:47,spirals-bears,d75f4a89-740d-4a70-a89e-2e09374fb945_02-18-week1-FAILING_AND_PASSING,8,0,2,1,2,9,0,1591,358,0,610,465,36,1,3083
338016101,aicis/fresco,22/08/18 11:50,spirals-bears,d75f4a89-740d-4a70-a89e-2e09374fb945_02-18-week1-FAILING_AND_PASSING,7,5,0,0,9,0,0,4,0,1601,0,35,0,264,89,8,5,0,2027
337636286,aicis/fresco,22/08/18 12:09,spirals-bears,d75f4a89-740d-4a70-a89e-2e09374fb945_02-18-week1-FAILING_AND_PASSING,9,6,0,0,7,0,0,4,0,1531,0,35,0,294,91,8,6,0,1991
336060691,swagger-api/swagger-codegen,22/08/18 12:09,spirals-bears,d75f4a89-740d-4a70-a89e-2e09374fb945_02-18-week1-FAILING_AND_PASSING,32,4,36
338605066,spring-cloud/spring-cloud-gcp,22/08/18 12:10,spirals-bears,d75f4a89-740d-4a70-a89e-2e09374fb945_02-18-week1-FAILING_AND_PASSING,5,3,8
337518160,aicis/fresco,22/08/18 12:10,spirals-bears,d75f4a89-740d-4a70-a89e-2e09374fb945_02-18-week1-FAILING_AND_PASSING,9,4,0,0,6,0,0,3,0,1474,0,37,0,291,93,9,3,0,1929
337534426,danglotb/dspot,22/08/18 12:13,spirals-bears,d75f4a89-740d-4a70-a89e-2e09374fb945_02-18-week1-FAILING_AND_PASSING,126,5,0,0,0,131
338465840,dhis2/dhis2-core,22/08/18 12:15,spirals-bears,d75f4a89-740d-4a70-a89e-2e09374fb945_02-18-week1-FAILING_AND_PASSING,86,22,0,5,0,113
338452516,dhis2/dhis2-core,22/08/18 12:16,spirals-bears,d75f4a89-740d-4a70-a89e-2e09374fb945_02-18-week1-FAILING_AND_PASSING,41,23,0,7,0,71
338450634,dhis2/dhis2-core,22/08/18 12:18,spirals-bears,d75f4a89-740d-4a70-a89e-2e09374fb945_02-18-week1-FAILING_AND_PASSING,80,23,0,2,0,105
335860500,aicis/fresco,22/08/18 12:19,spirals-bears,d75f4a89-740d-4a70-a89e-2e09374fb945_02-18-week1-FAILING_AND_PASSING,8,5,0,0,8,0,0,3,0,1478,0,34,0,264,88,9,2,0,1899
337400728,debezium/debezium,22/08/18 12:19,spirals-bears,d75f4a89-740d-4a70-a89e-2e09374fb945_02-18-week1-FAILING_AND_PASSING,6,4,10
336057055,debezium/debezium,22/08/18 12:19,spirals-bears,d75f4a89-740d-4a70-a89e-2e09374fb945_02-18-week1-FAILING_AND_PASSING,6,5,11
336095714,debezium/debezium,22/08/18 12:20,spirals-bears,d75f4a89-740d-4a70-a89e-2e09374fb945_02-18-week1-FAILING_AND_PASSING,7,5,12
336045433,dhis2/dhis2-core,22/08/18 12:20,spirals-bears,d75f4a89-740d-4a70-a89e-2e09374fb945_02-18-week1-FAILING_AND_PASSING,81,24,0,9,0,114
336074023,Activiti/Activiti,22/08/18 12:29,spirals-bears,d75f4a89-740d-4a70-a89e-2e09374fb945_02-18-week1-FAILING_AND_PASSING,432,52,29,0,5,0,0,518
338034519,B3Partners/brmo,22/08/18 12:31,spirals-bears,d75f4a89-740d-4a70-a89e-2e09374fb945_02-18-week1-FAILING_AND_PASSING,29,76,0,5,0,110
338034537,B3Partners/brmo,22/08/18 12:33,spirals-bears,d75f4a89-740d-4a70-a89e-2e09374fb945_02-18-week1-FAILING_AND_PASSING,14,98,0,8,1,121
338514993,Spirals-Team/repairnator,22/08/18 12:34,spirals-bears,d75f4a89-740d-4a70-a89e-2e09374fb945_02-18-week1-FAILING_AND_PASSING,17,4,21
338514950,Spirals-Team/repairnator,22/08/18 12:34,spirals-bears,d75f4a89-740d-4a70-a89e-2e09374fb945_02-18-week1-FAILING_AND_PASSING,24,0,24
337924015,Spirals-Team/repairnator,22/08/18 12:35,spirals-bears,d75f4a89-740d-4a70-a89e-2e09374fb945_02-18-week1-FAILING_AND_PASSING,19,0,19
336640686,Spirals-Team/repairnator,22/08/18 12:35,spirals-bears,d75f4a89-740d-4a70-a89e-2e09374fb945_02-18-week1-FAILING_AND_PASSING,16,4,20
336110154,Spirals-Team/repairnator,22/08/18 12:36,spirals-bears,d75f4a89-740d-4a70-a89e-2e09374fb945_02-18-week1-FAILING_AND_PASSING,15,0,15
336084758,Spirals-Team/repairnator,22/08/18 12:36,spirals-bears,d75f4a89-740d-4a70-a89e-2e09374fb945_02-18-week1-FAILING_AND_PASSING,16,3,19
336084732,Spirals-Team/repairnator,22/08/18 12:37,spirals-bears,d75f4a89-740d-4a70-a89e-2e09374fb945_02-18-week1-FAILING_AND_PASSING,16,0,16
335027721,MyCoRe-Org/mycore,22/08/18 12:40,spirals-bears,d75f4a89-740d-4a70-a89e-2e09374fb945_02-18-week1-FAILING_AND_PASSING,383,326,9,53,55,2,55,33,0,267,1,1,1185
336715520,jacoco/jacoco,22/08/18 12:40,spirals-bears,d75f4a89-740d-4a70-a89e-2e09374fb945_02-18-week1-FAILING_AND_PASSING,5,2,7
336715509,jacoco/jacoco,22/08/18 12:40,spirals-bears,d75f4a89-740d-4a70-a89e-2e09374fb945_02-18-week1-FAILING_AND_PASSING,6,0,6
336329922,jacoco/jacoco,22/08/18 12:41,spirals-bears,d75f4a89-740d-4a70-a89e-2e09374fb945_02-18-week1-FAILING_AND_PASSING,8,0,8
335860560,aicis/fresco,22/08/18 12:41,spirals-bears,d75f4a89-740d-4a70-a89e-2e09374fb945_02-18-week1-FAILING_AND_PASSING,9,4,0,5,8,0,0,4,0,1558,0,35,3,1328,84,9,4,0,3051
336552231,jnidzwetzki/bboxdb,22/08/18 12:42,spirals-bears,d75f4a89-740d-4a70-a89e-2e09374fb945_02-18-week1-FAILING_AND_PASSING,5,0,0,0,0,1,0,36,72,0,38,128,8,0,288
338448140,MariaDB/mariadb-connector-j,22/08/18 13:11,spirals-bears,d75f4a89-740d-4a70-a89e-2e09374fb945_02-18-week1-FAILING_AND_PASSING,10,0,0,0,0,1,0,1786,31,0,1787,60,8,0,3683
