335707780,apache/flink,20/08/18 11:59,spirals-bears,d3f42f02-1b81-4352-bd2f-1d26a43f6972_01-18-week4-FAILING_AND_PASSING,66,9,75
334683207,apache/flink,20/08/18 11:59,spirals-bears,d3f42f02-1b81-4352-bd2f-1d26a43f6972_01-18-week4-FAILING_AND_PASSING,68,8,76
335044579,apache/flink,20/08/18 11:59,spirals-bears,d3f42f02-1b81-4352-bd2f-1d26a43f6972_01-18-week4-FAILING_AND_PASSING,77,6,83
334642880,apache/flink,20/08/18 12:00,spirals-bears,d3f42f02-1b81-4352-bd2f-1d26a43f6972_01-18-week4-FAILING_AND_PASSING,60,7,67
334746901,apache/flink,20/08/18 12:01,spirals-bears,d3f42f02-1b81-4352-bd2f-1d26a43f6972_01-18-week4-FAILING_AND_PASSING,61,11,72
333347694,apache/flink,20/08/18 12:01,spirals-bears,d3f42f02-1b81-4352-bd2f-1d26a43f6972_01-18-week4-FAILING_AND_PASSING,67,9,76
333705578,apache/flink,20/08/18 12:02,spirals-bears,d3f42f02-1b81-4352-bd2f-1d26a43f6972_01-18-week4-FAILING_AND_PASSING,64,7,71
332770312,apache/flink,20/08/18 12:02,spirals-bears,d3f42f02-1b81-4352-bd2f-1d26a43f6972_01-18-week4-FAILING_AND_PASSING,64,7,71
332320231,apache/flink,20/08/18 12:02,spirals-bears,d3f42f02-1b81-4352-bd2f-1d26a43f6972_01-18-week4-FAILING_AND_PASSING,70,6,76
333805674,apache/flink,20/08/18 12:03,spirals-bears,d3f42f02-1b81-4352-bd2f-1d26a43f6972_01-18-week4-FAILING_AND_PASSING,67,6,73
333157017,apache/flink,20/08/18 12:03,spirals-bears,d3f42f02-1b81-4352-bd2f-1d26a43f6972_01-18-week4-FAILING_AND_PASSING,62,7,69
332796323,apache/flink,20/08/18 12:05,spirals-bears,d3f42f02-1b81-4352-bd2f-1d26a43f6972_01-18-week4-FAILING_AND_PASSING,74,9,83
332228865,apache/flink,20/08/18 12:06,spirals-bears,d3f42f02-1b81-4352-bd2f-1d26a43f6972_01-18-week4-FAILING_AND_PASSING,62,7,69
331595236,apache/flink,20/08/18 12:07,spirals-bears,d3f42f02-1b81-4352-bd2f-1d26a43f6972_01-18-week4-FAILING_AND_PASSING,59,6,65
335279559,prestodb/presto,20/08/18 12:08,spirals-bears,d3f42f02-1b81-4352-bd2f-1d26a43f6972_01-18-week4-FAILING_AND_PASSING,44,4,48
335145142,prestodb/presto,20/08/18 12:09,spirals-bears,d3f42f02-1b81-4352-bd2f-1d26a43f6972_01-18-week4-FAILING_AND_PASSING,44,7,51
334782832,prestodb/presto,20/08/18 12:10,spirals-bears,d3f42f02-1b81-4352-bd2f-1d26a43f6972_01-18-week4-FAILING_AND_PASSING,43,8,51
334766106,prestodb/presto,20/08/18 12:12,spirals-bears,d3f42f02-1b81-4352-bd2f-1d26a43f6972_01-18-week4-FAILING_AND_PASSING,51,10,61
334483529,prestodb/presto,20/08/18 12:13,spirals-bears,d3f42f02-1b81-4352-bd2f-1d26a43f6972_01-18-week4-FAILING_AND_PASSING,42,10,52
333720259,prestodb/presto,20/08/18 12:43,spirals-bears,d3f42f02-1b81-4352-bd2f-1d26a43f6972_01-18-week4-FAILING_AND_PASSING,827,905,42,0,11,1,1786
333702230,prestodb/presto,20/08/18 12:44,spirals-bears,d3f42f02-1b81-4352-bd2f-1d26a43f6972_01-18-week4-FAILING_AND_PASSING,45,9,54
335558792,apache/flink,20/08/18 12:45,spirals-bears,d3f42f02-1b81-4352-bd2f-1d26a43f6972_01-18-week4-FAILING_AND_PASSING,9,0,11,1,2,131,0,45,1019,13,47,1491,62,3,2834
331405510,apache/flink,20/08/18 12:46,spirals-bears,d3f42f02-1b81-4352-bd2f-1d26a43f6972_01-18-week4-FAILING_AND_PASSING,9,0,3,0,1,134,0,46,706,5,66,1484,63,5,2522
332459472,prestodb/presto,20/08/18 12:46,spirals-bears,d3f42f02-1b81-4352-bd2f-1d26a43f6972_01-18-week4-FAILING_AND_PASSING,47,5,52
332551542,prestodb/presto,20/08/18 12:47,spirals-bears,d3f42f02-1b81-4352-bd2f-1d26a43f6972_01-18-week4-FAILING_AND_PASSING,44,7,51
332400944,prestodb/presto,20/08/18 12:47,spirals-bears,d3f42f02-1b81-4352-bd2f-1d26a43f6972_01-18-week4-FAILING_AND_PASSING,50,3,53
328351747,prestodb/presto,20/08/18 12:48,spirals-bears,d3f42f02-1b81-4352-bd2f-1d26a43f6972_01-18-week4-FAILING_AND_PASSING,45,7,52
331688613,prestodb/presto,20/08/18 12:48,spirals-bears,d3f42f02-1b81-4352-bd2f-1d26a43f6972_01-18-week4-FAILING_AND_PASSING,44,6,50
331287276,prestodb/presto,20/08/18 12:49,spirals-bears,d3f42f02-1b81-4352-bd2f-1d26a43f6972_01-18-week4-FAILING_AND_PASSING,43,10,53
335454504,apache/incubator-druid,20/08/18 12:49,spirals-bears,d3f42f02-1b81-4352-bd2f-1d26a43f6972_01-18-week4-FAILING_AND_PASSING,37,9,46
332388196,apache/flink,20/08/18 12:50,spirals-bears,d3f42f02-1b81-4352-bd2f-1d26a43f6972_01-18-week4-FAILING_AND_PASSING,10,0,8,0,2,168,0,55,987,16,60,1485,61,3,2855
335032187,apache/incubator-druid,20/08/18 12:51,spirals-bears,d3f42f02-1b81-4352-bd2f-1d26a43f6972_01-18-week4-FAILING_AND_PASSING,41,4,45
332063876,prestodb/presto,20/08/18 13:13,spirals-bears,d3f42f02-1b81-4352-bd2f-1d26a43f6972_01-18-week4-FAILING_AND_PASSING,796,851,44,0,7,2,1700
334640062,apache/incubator-druid,20/08/18 13:16,spirals-bears,d3f42f02-1b81-4352-bd2f-1d26a43f6972_01-18-week4-FAILING_AND_PASSING,62,4,66
335331228,apache/incubator-druid,20/08/18 13:35,spirals-bears,d3f42f02-1b81-4352-bd2f-1d26a43f6972_01-18-week4-FAILING_AND_PASSING,13,0,2,25,1,27,0,1595,408,2,95,533,36,0,2737
332545313,apache/incubator-druid,20/08/18 13:55,spirals-bears,d3f42f02-1b81-4352-bd2f-1d26a43f6972_01-18-week4-FAILING_AND_PASSING,10,0,3,3,1,44,0,1365,329,1,1604,499,37,3,3899
334772542,apache/incubator-druid,20/08/18 14:03,spirals-bears,d3f42f02-1b81-4352-bd2f-1d26a43f6972_01-18-week4-FAILING_AND_PASSING,8,0,2,32,1,40,0,1483,448,1,1646,606,47,4,4318
333811285,apache/incubator-druid,20/08/18 14:20,spirals-bears,d3f42f02-1b81-4352-bd2f-1d26a43f6972_01-18-week4-FAILING_AND_PASSING,7,0,2,0,0,46,0,1354,305,1,1442,607,36,8,3808
333140157,apache/incubator-druid,20/08/18 14:21,spirals-bears,d3f42f02-1b81-4352-bd2f-1d26a43f6972_01-18-week4-FAILING_AND_PASSING,55,19,74
333101585,apache/incubator-druid,20/08/18 14:26,spirals-bears,d3f42f02-1b81-4352-bd2f-1d26a43f6972_01-18-week4-FAILING_AND_PASSING,9,0,23,0,2,152,0,32,378,9,1530,771,75,5,2986
332967093,apache/incubator-druid,20/08/18 14:33,spirals-bears,d3f42f02-1b81-4352-bd2f-1d26a43f6972_01-18-week4-FAILING_AND_PASSING,1518,619,11,37,0,8,1,28,0,51,1,7,2281
332535286,apache/incubator-druid,20/08/18 14:36,spirals-bears,d3f42f02-1b81-4352-bd2f-1d26a43f6972_01-18-week4-FAILING_AND_PASSING,1321,501,14,35,0,8,1,24,0,52,1,6,1963
332272422,apache/incubator-druid,20/08/18 14:37,spirals-bears,d3f42f02-1b81-4352-bd2f-1d26a43f6972_01-18-week4-FAILING_AND_PASSING,38,4,42
332154183,apache/incubator-druid,20/08/18 14:38,spirals-bears,d3f42f02-1b81-4352-bd2f-1d26a43f6972_01-18-week4-FAILING_AND_PASSING,39,4,43
331947958,apache/incubator-druid,20/08/18 14:39,spirals-bears,d3f42f02-1b81-4352-bd2f-1d26a43f6972_01-18-week4-FAILING_AND_PASSING,51,8,59
329658417,apache/incubator-druid,20/08/18 15:18,spirals-bears,d3f42f02-1b81-4352-bd2f-1d26a43f6972_01-18-week4-FAILING_AND_PASSING,1721,668,11,67,0,7,1,47,0,98,1,4,2625
331680822,apache/incubator-druid,20/08/18 15:22,spirals-bears,d3f42f02-1b81-4352-bd2f-1d26a43f6972_01-18-week4-FAILING_AND_PASSING,1478,772,9,55,0,26,3,129,0,117,4,2593
331975740,jruby/jruby,20/08/18 15:25,spirals-bears,d3f42f02-1b81-4352-bd2f-1d26a43f6972_01-18-week4-FAILING_AND_PASSING,124,0,124
332719956,thelastpickle/cassandra-reaper,20/08/18 15:25,spirals-bears,d3f42f02-1b81-4352-bd2f-1d26a43f6972_01-18-week4-FAILING_AND_PASSING,8,0,8
332854614,jruby/jruby,20/08/18 15:27,spirals-bears,d3f42f02-1b81-4352-bd2f-1d26a43f6972_01-18-week4-FAILING_AND_PASSING,16,159,120,0,3,0,0,298
333078442,apache/incubator-druid,20/08/18 15:33,spirals-bears,d3f42f02-1b81-4352-bd2f-1d26a43f6972_01-18-week4-FAILING_AND_PASSING,7,0,13,2,2,189,0,1463,484,9,1504,540,61,1,4275
332386615,apache/incubator-druid,20/08/18 15:33,spirals-bears,d3f42f02-1b81-4352-bd2f-1d26a43f6972_01-18-week4-FAILING_AND_PASSING,10,0,7,1,1,74,0,1442,483,4,1496,455,38,13,4024
335233898,JMRI/JMRI,20/08/18 15:50,spirals-bears,d3f42f02-1b81-4352-bd2f-1d26a43f6972_01-18-week4-FAILING_AND_PASSING,609,189,11,441,0,37,1,119,0,70,6,6,1489
333590859,JMRI/JMRI,20/08/18 15:52,spirals-bears,d3f42f02-1b81-4352-bd2f-1d26a43f6972_01-18-week4-FAILING_AND_PASSING,533,181,361,0,36,0,4,1115
333727619,JMRI/JMRI,20/08/18 16:06,spirals-bears,d3f42f02-1b81-4352-bd2f-1d26a43f6972_01-18-week4-FAILING_AND_PASSING,1548,183,10,377,0,9,0,149,0,67,8,2,2353
333514449,JMRI/JMRI,20/08/18 16:08,spirals-bears,d3f42f02-1b81-4352-bd2f-1d26a43f6972_01-18-week4-FAILING_AND_PASSING,1522,178,373,0,6,1,9,2089
331695236,JMRI/JMRI,20/08/18 16:26,spirals-bears,d3f42f02-1b81-4352-bd2f-1d26a43f6972_01-18-week4-FAILING_AND_PASSING,1462,178,385,0,8,0,12,2045
334853568,apache/nifi,20/08/18 16:27,spirals-bears,d3f42f02-1b81-4352-bd2f-1d26a43f6972_01-18-week4-FAILING_AND_PASSING,39,6,45
332723044,JMRI/JMRI,20/08/18 16:31,spirals-bears,d3f42f02-1b81-4352-bd2f-1d26a43f6972_01-18-week4-FAILING_AND_PASSING,1494,175,12,523,0,7,0,145,0,71,11,1,2439
333880642,apache/nifi,20/08/18 16:32,spirals-bears,d3f42f02-1b81-4352-bd2f-1d26a43f6972_01-18-week4-FAILING_AND_PASSING,35,5,40
334320022,apache/nifi,20/08/18 16:34,spirals-bears,d3f42f02-1b81-4352-bd2f-1d26a43f6972_01-18-week4-FAILING_AND_PASSING,296,43,2,9,5,355
330889995,apache/nifi,20/08/18 16:35,spirals-bears,d3f42f02-1b81-4352-bd2f-1d26a43f6972_01-18-week4-FAILING_AND_PASSING,40,10,50
331591654,JMRI/JMRI,20/08/18 16:39,spirals-bears,d3f42f02-1b81-4352-bd2f-1d26a43f6972_01-18-week4-FAILING_AND_PASSING,1437,173,333,0,7,0,3,1953
331465256,JMRI/JMRI,20/08/18 16:50,spirals-bears,d3f42f02-1b81-4352-bd2f-1d26a43f6972_01-18-week4-FAILING_AND_PASSING,1416,178,14,586,0,31,0,122,0,107,10,8,2472
335644207,EnMasseProject/enmasse,20/08/18 16:51,spirals-bears,d3f42f02-1b81-4352-bd2f-1d26a43f6972_01-18-week4-FAILING_AND_PASSING,28,5,33
335558890,EnMasseProject/enmasse,20/08/18 16:51,spirals-bears,d3f42f02-1b81-4352-bd2f-1d26a43f6972_01-18-week4-FAILING_AND_PASSING,26,3,29
335552082,EnMasseProject/enmasse,20/08/18 16:52,spirals-bears,d3f42f02-1b81-4352-bd2f-1d26a43f6972_01-18-week4-FAILING_AND_PASSING,28,0,28
335552093,EnMasseProject/enmasse,20/08/18 16:53,spirals-bears,d3f42f02-1b81-4352-bd2f-1d26a43f6972_01-18-week4-FAILING_AND_PASSING,33,4,37
334657018,EnMasseProject/enmasse,20/08/18 16:54,spirals-bears,d3f42f02-1b81-4352-bd2f-1d26a43f6972_01-18-week4-FAILING_AND_PASSING,29,0,29
333653727,EnMasseProject/enmasse,20/08/18 16:58,spirals-bears,d3f42f02-1b81-4352-bd2f-1d26a43f6972_01-18-week4-FAILING_AND_PASSING,157,91,29,0,1,2,0,280
333105216,EnMasseProject/enmasse,20/08/18 16:59,spirals-bears,d3f42f02-1b81-4352-bd2f-1d26a43f6972_01-18-week4-FAILING_AND_PASSING,27,3,30
332877612,apache/nifi,20/08/18 16:59,spirals-bears,d3f42f02-1b81-4352-bd2f-1d26a43f6972_01-18-week4-FAILING_AND_PASSING,1591,37,2,2,4,1636
335469430,batfish/batfish,20/08/18 17:00,spirals-bears,d3f42f02-1b81-4352-bd2f-1d26a43f6972_01-18-week4-FAILING_AND_PASSING,54,3,57
335469428,batfish/batfish,20/08/18 17:01,spirals-bears,d3f42f02-1b81-4352-bd2f-1d26a43f6972_01-18-week4-FAILING_AND_PASSING,63,0,63
335491115,batfish/batfish,20/08/18 17:01,spirals-bears,d3f42f02-1b81-4352-bd2f-1d26a43f6972_01-18-week4-FAILING_AND_PASSING,56,0,56
335482856,batfish/batfish,20/08/18 17:02,spirals-bears,d3f42f02-1b81-4352-bd2f-1d26a43f6972_01-18-week4-FAILING_AND_PASSING,51,3,54
335482834,batfish/batfish,20/08/18 17:02,spirals-bears,d3f42f02-1b81-4352-bd2f-1d26a43f6972_01-18-week4-FAILING_AND_PASSING,52,0,52
332648587,apache/nifi,20/08/18 17:03,spirals-bears,d3f42f02-1b81-4352-bd2f-1d26a43f6972_01-18-week4-FAILING_AND_PASSING,1625,35,2,8,4,1674
334972980,batfish/batfish,20/08/18 17:03,spirals-bears,d3f42f02-1b81-4352-bd2f-1d26a43f6972_01-18-week4-FAILING_AND_PASSING,56,0,56
334972988,batfish/batfish,20/08/18 17:04,spirals-bears,d3f42f02-1b81-4352-bd2f-1d26a43f6972_01-18-week4-FAILING_AND_PASSING,53,3,56
333149353,batfish/batfish,20/08/18 17:04,spirals-bears,d3f42f02-1b81-4352-bd2f-1d26a43f6972_01-18-week4-FAILING_AND_PASSING,60,0,60
333149367,batfish/batfish,20/08/18 17:05,spirals-bears,d3f42f02-1b81-4352-bd2f-1d26a43f6972_01-18-week4-FAILING_AND_PASSING,56,3,59
333067728,batfish/batfish,20/08/18 17:05,spirals-bears,d3f42f02-1b81-4352-bd2f-1d26a43f6972_01-18-week4-FAILING_AND_PASSING,52,3,55
332981082,batfish/batfish,20/08/18 17:06,spirals-bears,d3f42f02-1b81-4352-bd2f-1d26a43f6972_01-18-week4-FAILING_AND_PASSING,49,0,49
332981088,batfish/batfish,20/08/18 17:06,spirals-bears,d3f42f02-1b81-4352-bd2f-1d26a43f6972_01-18-week4-FAILING_AND_PASSING,54,4,58
332099005,batfish/batfish,20/08/18 17:07,spirals-bears,d3f42f02-1b81-4352-bd2f-1d26a43f6972_01-18-week4-FAILING_AND_PASSING,8,160,58,0,1,0,0,227
332938214,batfish/batfish,20/08/18 17:07,spirals-bears,d3f42f02-1b81-4352-bd2f-1d26a43f6972_01-18-week4-FAILING_AND_PASSING,58,0,58
332662194,batfish/batfish,20/08/18 17:08,spirals-bears,d3f42f02-1b81-4352-bd2f-1d26a43f6972_01-18-week4-FAILING_AND_PASSING,53,0,53
332280654,apache/nifi,20/08/18 17:08,spirals-bears,d3f42f02-1b81-4352-bd2f-1d26a43f6972_01-18-week4-FAILING_AND_PASSING,1681,42,2,8,4,1737
332189897,batfish/batfish,20/08/18 17:09,spirals-bears,d3f42f02-1b81-4352-bd2f-1d26a43f6972_01-18-week4-FAILING_AND_PASSING,56,3,59
332622461,batfish/batfish,20/08/18 17:09,spirals-bears,d3f42f02-1b81-4352-bd2f-1d26a43f6972_01-18-week4-FAILING_AND_PASSING,7,159,53,0,2,0,0,221
332189727,batfish/batfish,20/08/18 17:10,spirals-bears,d3f42f02-1b81-4352-bd2f-1d26a43f6972_01-18-week4-FAILING_AND_PASSING,50,0,50
332161375,batfish/batfish,20/08/18 17:11,spirals-bears,d3f42f02-1b81-4352-bd2f-1d26a43f6972_01-18-week4-FAILING_AND_PASSING,60,0,60
331932928,batfish/batfish,20/08/18 17:11,spirals-bears,d3f42f02-1b81-4352-bd2f-1d26a43f6972_01-18-week4-FAILING_AND_PASSING,60,0,60
332371750,batfish/batfish,20/08/18 17:11,spirals-bears,d3f42f02-1b81-4352-bd2f-1d26a43f6972_01-18-week4-FAILING_AND_PASSING,7,164,49,0,1,2,1,224
331932940,batfish/batfish,20/08/18 17:12,spirals-bears,d3f42f02-1b81-4352-bd2f-1d26a43f6972_01-18-week4-FAILING_AND_PASSING,49,3,52
332183880,batfish/batfish,20/08/18 17:13,spirals-bears,d3f42f02-1b81-4352-bd2f-1d26a43f6972_01-18-week4-FAILING_AND_PASSING,6,168,52,0,1,0,0,227
335110367,matsim-org/matsim,20/08/18 17:39,spirals-bears,d3f42f02-1b81-4352-bd2f-1d26a43f6972_01-18-week4-FAILING_AND_PASSING,1499,178,0,2,0,1679
335526278,matsim-org/matsim,20/08/18 17:39,spirals-bears,d3f42f02-1b81-4352-bd2f-1d26a43f6972_01-18-week4-FAILING_AND_PASSING,1531,180,0,1,2,1714
334856699,matsim-org/matsim,20/08/18 17:39,spirals-bears,d3f42f02-1b81-4352-bd2f-1d26a43f6972_01-18-week4-FAILING_AND_PASSING,1469,178,0,8,0,1655
334855529,matsim-org/matsim,20/08/18 17:41,spirals-bears,d3f42f02-1b81-4352-bd2f-1d26a43f6972_01-18-week4-FAILING_AND_PASSING,1537,154,0,1,0,1692
332030372,matsim-org/matsim,20/08/18 17:43,spirals-bears,d3f42f02-1b81-4352-bd2f-1d26a43f6972_01-18-week4-FAILING_AND_PASSING,180,0,180
333299198,lucee/Lucee,20/08/18 17:44,spirals-bears,d3f42f02-1b81-4352-bd2f-1d26a43f6972_01-18-week4-FAILING_AND_PASSING,3,6,18,0,1,0,0,28
332030432,matsim-org/matsim,20/08/18 17:44,spirals-bears,d3f42f02-1b81-4352-bd2f-1d26a43f6972_01-18-week4-FAILING_AND_PASSING,242,3,245
333175910,lucee/Lucee,20/08/18 17:44,spirals-bears,d3f42f02-1b81-4352-bd2f-1d26a43f6972_01-18-week4-FAILING_AND_PASSING,4,6,20,0,0,0,0,30
334583780,apache/incubator-servicecomb-java-chassis,20/08/18 17:47,spirals-bears,d3f42f02-1b81-4352-bd2f-1d26a43f6972_01-18-week4-FAILING_AND_PASSING,145,9,1,5,5,165
334026471,apache/incubator-servicecomb-java-chassis,20/08/18 17:48,spirals-bears,d3f42f02-1b81-4352-bd2f-1d26a43f6972_01-18-week4-FAILING_AND_PASSING,10,4,14
333559017,apache/incubator-servicecomb-java-chassis,20/08/18 17:48,spirals-bears,d3f42f02-1b81-4352-bd2f-1d26a43f6972_01-18-week4-FAILING_AND_PASSING,10,3,13
332656451,apache/incubator-servicecomb-java-chassis,20/08/18 17:48,spirals-bears,d3f42f02-1b81-4352-bd2f-1d26a43f6972_01-18-week4-FAILING_AND_PASSING,9,3,12
332156705,apache/incubator-servicecomb-java-chassis,20/08/18 17:49,spirals-bears,d3f42f02-1b81-4352-bd2f-1d26a43f6972_01-18-week4-FAILING_AND_PASSING,9,3,12
335819979,runelite/runelite,20/08/18 17:49,spirals-bears,d3f42f02-1b81-4352-bd2f-1d26a43f6972_01-18-week4-FAILING_AND_PASSING,11,13,24
335562775,runelite/runelite,20/08/18 17:50,spirals-bears,d3f42f02-1b81-4352-bd2f-1d26a43f6972_01-18-week4-FAILING_AND_PASSING,10,0,10
335445344,runelite/runelite,20/08/18 17:50,spirals-bears,d3f42f02-1b81-4352-bd2f-1d26a43f6972_01-18-week4-FAILING_AND_PASSING,10,0,10
334991040,runelite/runelite,20/08/18 17:50,spirals-bears,d3f42f02-1b81-4352-bd2f-1d26a43f6972_01-18-week4-FAILING_AND_PASSING,10,3,13
334933430,runelite/runelite,20/08/18 17:51,spirals-bears,d3f42f02-1b81-4352-bd2f-1d26a43f6972_01-18-week4-FAILING_AND_PASSING,11,0,11
334920075,runelite/runelite,20/08/18 17:51,spirals-bears,d3f42f02-1b81-4352-bd2f-1d26a43f6972_01-18-week4-FAILING_AND_PASSING,10,13,23
334711550,runelite/runelite,20/08/18 17:52,spirals-bears,d3f42f02-1b81-4352-bd2f-1d26a43f6972_01-18-week4-FAILING_AND_PASSING,10,0,10
334710236,runelite/runelite,20/08/18 17:52,spirals-bears,d3f42f02-1b81-4352-bd2f-1d26a43f6972_01-18-week4-FAILING_AND_PASSING,11,14,25
334708797,runelite/runelite,20/08/18 17:52,spirals-bears,d3f42f02-1b81-4352-bd2f-1d26a43f6972_01-18-week4-FAILING_AND_PASSING,11,0,11
334354181,runelite/runelite,20/08/18 17:53,spirals-bears,d3f42f02-1b81-4352-bd2f-1d26a43f6972_01-18-week4-FAILING_AND_PASSING,11,0,11
334189186,runelite/runelite,20/08/18 17:53,spirals-bears,d3f42f02-1b81-4352-bd2f-1d26a43f6972_01-18-week4-FAILING_AND_PASSING,10,0,10
335148838,apache/incubator-servicecomb-java-chassis,20/08/18 17:53,spirals-bears,d3f42f02-1b81-4352-bd2f-1d26a43f6972_01-18-week4-FAILING_AND_PASSING,327,204,10,1,6,6,1,555
334140534,runelite/runelite,20/08/18 17:53,spirals-bears,d3f42f02-1b81-4352-bd2f-1d26a43f6972_01-18-week4-FAILING_AND_PASSING,11,0,11
334017824,runelite/runelite,20/08/18 17:54,spirals-bears,d3f42f02-1b81-4352-bd2f-1d26a43f6972_01-18-week4-FAILING_AND_PASSING,11,14,25
334095972,runelite/runelite,20/08/18 17:54,spirals-bears,d3f42f02-1b81-4352-bd2f-1d26a43f6972_01-18-week4-FAILING_AND_PASSING,12,18,30
333959743,runelite/runelite,20/08/18 17:54,spirals-bears,d3f42f02-1b81-4352-bd2f-1d26a43f6972_01-18-week4-FAILING_AND_PASSING,11,0,11
333882204,runelite/runelite,20/08/18 17:54,spirals-bears,d3f42f02-1b81-4352-bd2f-1d26a43f6972_01-18-week4-FAILING_AND_PASSING,10,0,10
333047580,runelite/runelite,20/08/18 17:55,spirals-bears,d3f42f02-1b81-4352-bd2f-1d26a43f6972_01-18-week4-FAILING_AND_PASSING,11,0,11
333493181,runelite/runelite,20/08/18 17:55,spirals-bears,d3f42f02-1b81-4352-bd2f-1d26a43f6972_01-18-week4-FAILING_AND_PASSING,12,0,12
333131213,runelite/runelite,20/08/18 17:55,spirals-bears,d3f42f02-1b81-4352-bd2f-1d26a43f6972_01-18-week4-FAILING_AND_PASSING,10,0,10
333037356,runelite/runelite,20/08/18 17:55,spirals-bears,d3f42f02-1b81-4352-bd2f-1d26a43f6972_01-18-week4-FAILING_AND_PASSING,10,0,10
333036166,runelite/runelite,20/08/18 17:55,spirals-bears,d3f42f02-1b81-4352-bd2f-1d26a43f6972_01-18-week4-FAILING_AND_PASSING,9,0,9
332917176,runelite/runelite,20/08/18 17:56,spirals-bears,d3f42f02-1b81-4352-bd2f-1d26a43f6972_01-18-week4-FAILING_AND_PASSING,10,0,10
332860516,runelite/runelite,20/08/18 17:56,spirals-bears,d3f42f02-1b81-4352-bd2f-1d26a43f6972_01-18-week4-FAILING_AND_PASSING,10,0,10
332579845,runelite/runelite,20/08/18 17:56,spirals-bears,d3f42f02-1b81-4352-bd2f-1d26a43f6972_01-18-week4-FAILING_AND_PASSING,10,0,10
332461564,runelite/runelite,20/08/18 17:56,spirals-bears,d3f42f02-1b81-4352-bd2f-1d26a43f6972_01-18-week4-FAILING_AND_PASSING,10,0,10
332130241,runelite/runelite,20/08/18 17:56,spirals-bears,d3f42f02-1b81-4352-bd2f-1d26a43f6972_01-18-week4-FAILING_AND_PASSING,10,0,10
331927839,runelite/runelite,20/08/18 17:57,spirals-bears,d3f42f02-1b81-4352-bd2f-1d26a43f6972_01-18-week4-FAILING_AND_PASSING,11,0,11
331603252,runelite/runelite,20/08/18 17:57,spirals-bears,d3f42f02-1b81-4352-bd2f-1d26a43f6972_01-18-week4-FAILING_AND_PASSING,11,13,24
331819439,runelite/runelite,20/08/18 17:57,spirals-bears,d3f42f02-1b81-4352-bd2f-1d26a43f6972_01-18-week4-FAILING_AND_PASSING,11,15,26
331815828,runelite/runelite,20/08/18 17:57,spirals-bears,d3f42f02-1b81-4352-bd2f-1d26a43f6972_01-18-week4-FAILING_AND_PASSING,10,14,24
331603972,runelite/runelite,20/08/18 17:58,spirals-bears,d3f42f02-1b81-4352-bd2f-1d26a43f6972_01-18-week4-FAILING_AND_PASSING,11,1,12
331443188,runelite/runelite,20/08/18 17:58,spirals-bears,d3f42f02-1b81-4352-bd2f-1d26a43f6972_01-18-week4-FAILING_AND_PASSING,11,15,26
333699221,terasolunaorg/tutorial-apps,20/08/18 17:58,spirals-bears,d3f42f02-1b81-4352-bd2f-1d26a43f6972_01-18-week4-FAILING_AND_PASSING,4,0,4
333699293,terasolunaorg/tutorial-apps,20/08/18 17:58,spirals-bears,d3f42f02-1b81-4352-bd2f-1d26a43f6972_01-18-week4-FAILING_AND_PASSING,4,3,7
333141088,terasolunaorg/tutorial-apps,20/08/18 17:58,spirals-bears,d3f42f02-1b81-4352-bd2f-1d26a43f6972_01-18-week4-FAILING_AND_PASSING,3,2,5
327125099,terasolunaorg/tutorial-apps,20/08/18 17:58,spirals-bears,d3f42f02-1b81-4352-bd2f-1d26a43f6972_01-18-week4-FAILING_AND_PASSING,4,7,4,0,0,0,0,15
333141106,terasolunaorg/tutorial-apps,20/08/18 17:58,spirals-bears,d3f42f02-1b81-4352-bd2f-1d26a43f6972_01-18-week4-FAILING_AND_PASSING,4,0,4
332571483,CorfuDB/CorfuDB,20/08/18 18:03,spirals-bears,d3f42f02-1b81-4352-bd2f-1d26a43f6972_01-18-week4-FAILING_AND_PASSING,237,0,237
332571774,CorfuDB/CorfuDB,20/08/18 18:03,spirals-bears,d3f42f02-1b81-4352-bd2f-1d26a43f6972_01-18-week4-FAILING_AND_PASSING,242,5,247
315078624,CorfuDB/CorfuDB,20/08/18 18:07,spirals-bears,d3f42f02-1b81-4352-bd2f-1d26a43f6972_01-18-week4-FAILING_AND_PASSING,235,0,235
330907223,spring-projects/spring-data-jpa,20/08/18 18:07,spirals-bears,d3f42f02-1b81-4352-bd2f-1d26a43f6972_01-18-week4-FAILING_AND_PASSING,6,0,6
332593733,CorfuDB/CorfuDB,20/08/18 18:07,spirals-bears,d3f42f02-1b81-4352-bd2f-1d26a43f6972_01-18-week4-FAILING_AND_PASSING,261,0,261
330783691,apache/storm,20/08/18 18:08,spirals-bears,d3f42f02-1b81-4352-bd2f-1d26a43f6972_01-18-week4-FAILING_AND_PASSING,36,4,40
332372286,matsim-org/matsim,20/08/18 18:09,spirals-bears,d3f42f02-1b81-4352-bd2f-1d26a43f6972_01-18-week4-FAILING_AND_PASSING,1570,187,0,5,1,1763
333018688,linkedin/pinot,20/08/18 18:10,spirals-bears,d3f42f02-1b81-4352-bd2f-1d26a43f6972_01-18-week4-FAILING_AND_PASSING,37,3,40
331801816,matsim-org/matsim,20/08/18 18:11,spirals-bears,d3f42f02-1b81-4352-bd2f-1d26a43f6972_01-18-week4-FAILING_AND_PASSING,1547,181,0,1,0,1729
332597532,Azure/azure-libraries-for-java,20/08/18 18:11,spirals-bears,d3f42f02-1b81-4352-bd2f-1d26a43f6972_01-18-week4-FAILING_AND_PASSING,69,0,69
332589093,Azure/azure-libraries-for-java,20/08/18 18:12,spirals-bears,d3f42f02-1b81-4352-bd2f-1d26a43f6972_01-18-week4-FAILING_AND_PASSING,61,5,66
331982342,Azure/azure-libraries-for-java,20/08/18 18:19,spirals-bears,d3f42f02-1b81-4352-bd2f-1d26a43f6972_01-18-week4-FAILING_AND_PASSING,13,0,12,0,1,19,0,94,69,5,94,92,64,0,463
292769166,HubSpot/Singularity,20/08/18 18:35,spirals-bears,d3f42f02-1b81-4352-bd2f-1d26a43f6972_01-18-week4-FAILING_AND_PASSING,7,0,4,0,1,3,0,299,327,4,315,382,19,0,1361
333365756,apache/storm,20/08/18 18:41,spirals-bears,d3f42f02-1b81-4352-bd2f-1d26a43f6972_01-18-week4-FAILING_AND_PASSING,8,0,17,1,2,18,0,575,578,5,102,677,40,0,2023
334803634,HubSpot/Singularity,20/08/18 18:42,spirals-bears,d3f42f02-1b81-4352-bd2f-1d26a43f6972_01-18-week4-FAILING_AND_PASSING,14,0,3,0,1,10,0,314,298,3,296,362,18,0,1319
334803974,HubSpot/Singularity,20/08/18 18:58,spirals-bears,d3f42f02-1b81-4352-bd2f-1d26a43f6972_01-18-week4-FAILING_AND_PASSING,9,0,0,0,1,5,0,306,357,0,318,362,17,0,1375
334792855,HubSpot/Singularity,20/08/18 19:06,spirals-bears,d3f42f02-1b81-4352-bd2f-1d26a43f6972_01-18-week4-FAILING_AND_PASSING,11,0,0,0,1,60,0,335,305,1,345,391,16,0,1465
333800141,HubSpot/Singularity,20/08/18 19:06,spirals-bears,d3f42f02-1b81-4352-bd2f-1d26a43f6972_01-18-week4-FAILING_AND_PASSING,11,0,0,0,2,57,0,338,309,0,336,384,17,1,1455
332880669,HubSpot/Singularity,20/08/18 19:23,spirals-bears,d3f42f02-1b81-4352-bd2f-1d26a43f6972_01-18-week4-FAILING_AND_PASSING,10,0,0,2,1,5,0,370,399,0,292,405,18,0,1502
331993498,HubSpot/Singularity,20/08/18 19:31,spirals-bears,d3f42f02-1b81-4352-bd2f-1d26a43f6972_01-18-week4-FAILING_AND_PASSING,379,18,0,3,2,402
332933675,HubSpot/Singularity,20/08/18 19:34,spirals-bears,d3f42f02-1b81-4352-bd2f-1d26a43f6972_01-18-week4-FAILING_AND_PASSING,31,0,4,0,1,105,2,355,364,9,355,368,19,17,1630
332835706,HubSpot/Singularity,20/08/18 19:34,spirals-bears,d3f42f02-1b81-4352-bd2f-1d26a43f6972_01-18-week4-FAILING_AND_PASSING,14,0,1,1,1,102,0,351,347,2,367,372,19,62,1639
335207080,lettuce-io/lettuce-core,20/08/18 19:35,spirals-bears,d3f42f02-1b81-4352-bd2f-1d26a43f6972_01-18-week4-FAILING_AND_PASSING,21,47,8,0,6,0,0,82
335102024,lettuce-io/lettuce-core,20/08/18 19:36,spirals-bears,d3f42f02-1b81-4352-bd2f-1d26a43f6972_01-18-week4-FAILING_AND_PASSING,22,49,8,0,0,1,0,80
332295187,lettuce-io/lettuce-core,20/08/18 19:37,spirals-bears,d3f42f02-1b81-4352-bd2f-1d26a43f6972_01-18-week4-FAILING_AND_PASSING,18,43,8,0,1,1,0,71
331993475,HubSpot/Singularity,20/08/18 19:37,spirals-bears,d3f42f02-1b81-4352-bd2f-1d26a43f6972_01-18-week4-FAILING_AND_PASSING,317,19,0,0,3,339
333184905,magefree/mage,20/08/18 19:42,spirals-bears,d3f42f02-1b81-4352-bd2f-1d26a43f6972_01-18-week4-FAILING_AND_PASSING,108,195,0,14,0,317
334672344,molgenis/molgenis,20/08/18 19:43,spirals-bears,d3f42f02-1b81-4352-bd2f-1d26a43f6972_01-18-week4-FAILING_AND_PASSING,41,8,49
333035313,linkedin/pinot,20/08/18 19:51,spirals-bears,d3f42f02-1b81-4352-bd2f-1d26a43f6972_01-18-week4-FAILING_AND_PASSING,11,33,0,7,24,4,0,90,0,3832,1,103,6,1447,431,35,119,1,6144
334066520,magefree/mage,20/08/18 19:51,spirals-bears,d3f42f02-1b81-4352-bd2f-1d26a43f6972_01-18-week4-FAILING_AND_PASSING,9,0,13,0,1,29,0,186,29,1,166,326,171,1,932
333278717,molgenis/molgenis,20/08/18 19:52,spirals-bears,d3f42f02-1b81-4352-bd2f-1d26a43f6972_01-18-week4-FAILING_AND_PASSING,490,43,0,1,1,535
330784416,algolia/algoliasearch-client-java-2,20/08/18 19:53,spirals-bears,d3f42f02-1b81-4352-bd2f-1d26a43f6972_01-18-week4-FAILING_AND_PASSING,4,2,6
330784413,algolia/algoliasearch-client-java-2,20/08/18 19:53,spirals-bears,d3f42f02-1b81-4352-bd2f-1d26a43f6972_01-18-week4-FAILING_AND_PASSING,4,0,4
330871810,algolia/algoliasearch-client-java-2,20/08/18 19:53,spirals-bears,d3f42f02-1b81-4352-bd2f-1d26a43f6972_01-18-week4-FAILING_AND_PASSING,4,2,6
330871856,algolia/algoliasearch-client-java-2,20/08/18 19:53,spirals-bears,d3f42f02-1b81-4352-bd2f-1d26a43f6972_01-18-week4-FAILING_AND_PASSING,4,0,4
330784390,algolia/algoliasearch-client-java-2,20/08/18 19:54,spirals-bears,d3f42f02-1b81-4352-bd2f-1d26a43f6972_01-18-week4-FAILING_AND_PASSING,4,2,6
330784364,algolia/algoliasearch-client-java-2,20/08/18 19:54,spirals-bears,d3f42f02-1b81-4352-bd2f-1d26a43f6972_01-18-week4-FAILING_AND_PASSING,4,0,4
330790910,algolia/algoliasearch-client-java-2,20/08/18 19:54,spirals-bears,d3f42f02-1b81-4352-bd2f-1d26a43f6972_01-18-week4-FAILING_AND_PASSING,4,2,6
330790795,algolia/algoliasearch-client-java-2,20/08/18 19:54,spirals-bears,d3f42f02-1b81-4352-bd2f-1d26a43f6972_01-18-week4-FAILING_AND_PASSING,4,0,4
331719413,molgenis/molgenis,20/08/18 19:55,spirals-bears,d3f42f02-1b81-4352-bd2f-1d26a43f6972_01-18-week4-FAILING_AND_PASSING,184,48,0,9,1,242
332225176,algolia/algoliasearch-client-java-2,20/08/18 19:55,spirals-bears,d3f42f02-1b81-4352-bd2f-1d26a43f6972_01-18-week4-FAILING_AND_PASSING,3,2,5
332225062,algolia/algoliasearch-client-java-2,20/08/18 19:55,spirals-bears,d3f42f02-1b81-4352-bd2f-1d26a43f6972_01-18-week4-FAILING_AND_PASSING,4,0,4
331920456,algolia/algoliasearch-client-java-2,20/08/18 19:56,spirals-bears,d3f42f02-1b81-4352-bd2f-1d26a43f6972_01-18-week4-FAILING_AND_PASSING,4,2,6
333100620,visallo/vertexium,20/08/18 19:56,spirals-bears,d3f42f02-1b81-4352-bd2f-1d26a43f6972_01-18-week4-FAILING_AND_PASSING,7,2,9
330783963,algolia/algoliasearch-client-java-2,20/08/18 19:57,spirals-bears,d3f42f02-1b81-4352-bd2f-1d26a43f6972_01-18-week4-FAILING_AND_PASSING,10,0,0,0,0,0,0,23,34,0,23,53,4,0,147
335190329,StuPro-TOSCAna/TOSCAna,20/08/18 19:57,spirals-bears,d3f42f02-1b81-4352-bd2f-1d26a43f6972_01-18-week4-FAILING_AND_PASSING,16,0,16
335278990,StuPro-TOSCAna/TOSCAna,20/08/18 19:58,spirals-bears,d3f42f02-1b81-4352-bd2f-1d26a43f6972_01-18-week4-FAILING_AND_PASSING,16,0,16
334708722,StuPro-TOSCAna/TOSCAna,20/08/18 19:58,spirals-bears,d3f42f02-1b81-4352-bd2f-1d26a43f6972_01-18-week4-FAILING_AND_PASSING,14,2,16
334629181,molgenis/molgenis,20/08/18 19:59,spirals-bears,d3f42f02-1b81-4352-bd2f-1d26a43f6972_01-18-week4-FAILING_AND_PASSING,761,486,39,0,1,1,1,1289
334949727,StuPro-TOSCAna/TOSCAna,20/08/18 19:59,spirals-bears,d3f42f02-1b81-4352-bd2f-1d26a43f6972_01-18-week4-FAILING_AND_PASSING,14,0,14
331959098,visallo/vertexium,20/08/18 19:59,spirals-bears,d3f42f02-1b81-4352-bd2f-1d26a43f6972_01-18-week4-FAILING_AND_PASSING,12,158,7,0,0,0,0,177
333911789,StuPro-TOSCAna/TOSCAna,20/08/18 19:59,spirals-bears,d3f42f02-1b81-4352-bd2f-1d26a43f6972_01-18-week4-FAILING_AND_PASSING,18,0,18
334949731,StuPro-TOSCAna/TOSCAna,20/08/18 19:59,spirals-bears,d3f42f02-1b81-4352-bd2f-1d26a43f6972_01-18-week4-FAILING_AND_PASSING,17,3,20
333868450,StuPro-TOSCAna/TOSCAna,20/08/18 20:00,spirals-bears,d3f42f02-1b81-4352-bd2f-1d26a43f6972_01-18-week4-FAILING_AND_PASSING,16,0,16
333911801,StuPro-TOSCAna/TOSCAna,20/08/18 20:00,spirals-bears,d3f42f02-1b81-4352-bd2f-1d26a43f6972_01-18-week4-FAILING_AND_PASSING,22,3,25
333868513,StuPro-TOSCAna/TOSCAna,20/08/18 20:00,spirals-bears,d3f42f02-1b81-4352-bd2f-1d26a43f6972_01-18-week4-FAILING_AND_PASSING,23,3,26
333760390,StuPro-TOSCAna/TOSCAna,20/08/18 20:00,spirals-bears,d3f42f02-1b81-4352-bd2f-1d26a43f6972_01-18-week4-FAILING_AND_PASSING,18,0,18
333726380,StuPro-TOSCAna/TOSCAna,20/08/18 20:00,spirals-bears,d3f42f02-1b81-4352-bd2f-1d26a43f6972_01-18-week4-FAILING_AND_PASSING,14,2,16
333764068,StuPro-TOSCAna/TOSCAna,20/08/18 20:00,spirals-bears,d3f42f02-1b81-4352-bd2f-1d26a43f6972_01-18-week4-FAILING_AND_PASSING,20,0,20
333726352,StuPro-TOSCAna/TOSCAna,20/08/18 20:01,spirals-bears,d3f42f02-1b81-4352-bd2f-1d26a43f6972_01-18-week4-FAILING_AND_PASSING,20,0,20
333063197,StuPro-TOSCAna/TOSCAna,20/08/18 20:01,spirals-bears,d3f42f02-1b81-4352-bd2f-1d26a43f6972_01-18-week4-FAILING_AND_PASSING,20,0,20
333063205,StuPro-TOSCAna/TOSCAna,20/08/18 20:01,spirals-bears,d3f42f02-1b81-4352-bd2f-1d26a43f6972_01-18-week4-FAILING_AND_PASSING,19,3,22
329854331,molgenis/molgenis,20/08/18 20:01,spirals-bears,d3f42f02-1b81-4352-bd2f-1d26a43f6972_01-18-week4-FAILING_AND_PASSING,508,57,0,11,1,577
332369194,StuPro-TOSCAna/TOSCAna,20/08/18 20:01,spirals-bears,d3f42f02-1b81-4352-bd2f-1d26a43f6972_01-18-week4-FAILING_AND_PASSING,17,0,17
332952612,StuPro-TOSCAna/TOSCAna,20/08/18 20:01,spirals-bears,d3f42f02-1b81-4352-bd2f-1d26a43f6972_01-18-week4-FAILING_AND_PASSING,19,0,19
332952721,StuPro-TOSCAna/TOSCAna,20/08/18 20:01,spirals-bears,d3f42f02-1b81-4352-bd2f-1d26a43f6972_01-18-week4-FAILING_AND_PASSING,16,2,18
332609646,apache/incubator-dubbo,20/08/18 20:02,spirals-bears,d3f42f02-1b81-4352-bd2f-1d26a43f6972_01-18-week4-FAILING_AND_PASSING,8,3,11
334974868,apache/incubator-dubbo,20/08/18 20:02,spirals-bears,d3f42f02-1b81-4352-bd2f-1d26a43f6972_01-18-week4-FAILING_AND_PASSING,9,3,12
332304107,StuPro-TOSCAna/TOSCAna,20/08/18 20:02,spirals-bears,d3f42f02-1b81-4352-bd2f-1d26a43f6972_01-18-week4-FAILING_AND_PASSING,20,0,20
332369247,StuPro-TOSCAna/TOSCAna,20/08/18 20:02,spirals-bears,d3f42f02-1b81-4352-bd2f-1d26a43f6972_01-18-week4-FAILING_AND_PASSING,20,2,22
334808235,ga4gh/dockstore,20/08/18 20:02,spirals-bears,d3f42f02-1b81-4352-bd2f-1d26a43f6972_01-18-week4-FAILING_AND_PASSING,10,0,10
331969281,ga4gh/dockstore,20/08/18 20:02,spirals-bears,d3f42f02-1b81-4352-bd2f-1d26a43f6972_01-18-week4-FAILING_AND_PASSING,10,2,12
332432254,atomix/atomix,20/08/18 20:02,spirals-bears,d3f42f02-1b81-4352-bd2f-1d26a43f6972_01-18-week4-FAILING_AND_PASSING,12,2,14
332022184,atomix/atomix,20/08/18 20:03,spirals-bears,d3f42f02-1b81-4352-bd2f-1d26a43f6972_01-18-week4-FAILING_AND_PASSING,11,2,13
332103984,resteasy/Resteasy,20/08/18 20:03,spirals-bears,d3f42f02-1b81-4352-bd2f-1d26a43f6972_01-18-week4-FAILING_AND_PASSING,19,6,25
330931107,dropwizard/metrics,20/08/18 20:04,spirals-bears,d3f42f02-1b81-4352-bd2f-1d26a43f6972_01-18-week4-FAILING_AND_PASSING,53,6,3,0,4,66
334146147,pgjdbc/pgjdbc,20/08/18 20:04,spirals-bears,d3f42f02-1b81-4352-bd2f-1d26a43f6972_01-18-week4-FAILING_AND_PASSING,9,4,13
334506115,pgjdbc/pgjdbc,20/08/18 20:06,spirals-bears,d3f42f02-1b81-4352-bd2f-1d26a43f6972_01-18-week4-FAILING_AND_PASSING,10,0,4,1,0,2,0,36,19,2,36,40,9,2,161
334110960,pgjdbc/pgjdbc,20/08/18 20:07,spirals-bears,d3f42f02-1b81-4352-bd2f-1d26a43f6972_01-18-week4-FAILING_AND_PASSING,9,0,4,1,0,4,0,37,14,4,38,38,8,1,158
332119052,pgjdbc/pgjdbc,20/08/18 20:07,spirals-bears,d3f42f02-1b81-4352-bd2f-1d26a43f6972_01-18-week4-FAILING_AND_PASSING,9,3,12
333273467,pgjdbc/pgjdbc,20/08/18 20:09,spirals-bears,d3f42f02-1b81-4352-bd2f-1d26a43f6972_01-18-week4-FAILING_AND_PASSING,11,0,4,1,0,3,0,31,21,2,38,44,8,2,165
331999557,pgjdbc/pgjdbc,20/08/18 20:10,spirals-bears,d3f42f02-1b81-4352-bd2f-1d26a43f6972_01-18-week4-FAILING_AND_PASSING,9,0,5,1,0,3,0,36,20,3,36,41,9,2,165
335245833,geoserver/geoserver,20/08/18 20:11,spirals-bears,d3f42f02-1b81-4352-bd2f-1d26a43f6972_01-18-week4-FAILING_AND_PASSING,56,6,62
331727639,pgjdbc/pgjdbc,20/08/18 20:12,spirals-bears,d3f42f02-1b81-4352-bd2f-1d26a43f6972_01-18-week4-FAILING_AND_PASSING,9,0,4,2,0,3,0,36,19,3,34,40,9,2,161
335200980,geoserver/geoserver,20/08/18 20:13,spirals-bears,d3f42f02-1b81-4352-bd2f-1d26a43f6972_01-18-week4-FAILING_AND_PASSING,59,6,65
334849075,geoserver/geoserver,20/08/18 20:13,spirals-bears,d3f42f02-1b81-4352-bd2f-1d26a43f6972_01-18-week4-FAILING_AND_PASSING,49,5,54
327472820,airlift/airlift,20/08/18 20:16,spirals-bears,d3f42f02-1b81-4352-bd2f-1d26a43f6972_01-18-week4-FAILING_AND_PASSING,8,1,0,0,5,0,1,1,0,281,0,103,0,174,235,14,1,0,824
333929886,geoserver/geoserver,20/08/18 20:18,spirals-bears,d3f42f02-1b81-4352-bd2f-1d26a43f6972_01-18-week4-FAILING_AND_PASSING,54,16,70
334710197,geoserver/geoserver,20/08/18 20:21,spirals-bears,d3f42f02-1b81-4352-bd2f-1d26a43f6972_01-18-week4-FAILING_AND_PASSING,450,47,0,7,1,505
334108276,geoserver/geoserver,20/08/18 20:21,spirals-bears,d3f42f02-1b81-4352-bd2f-1d26a43f6972_01-18-week4-FAILING_AND_PASSING,414,57,0,4,1,476
333481107,geoserver/geoserver,20/08/18 20:26,spirals-bears,d3f42f02-1b81-4352-bd2f-1d26a43f6972_01-18-week4-FAILING_AND_PASSING,380,53,0,18,1,452
332193800,aicis/fresco,20/08/18 20:43,spirals-bears,d3f42f02-1b81-4352-bd2f-1d26a43f6972_01-18-week4-FAILING_AND_PASSING,924,75,9,0,4,0,0,1012
333245800,aicis/fresco,20/08/18 20:46,spirals-bears,d3f42f02-1b81-4352-bd2f-1d26a43f6972_01-18-week4-FAILING_AND_PASSING,1347,100,8,0,6,0,0,1461
334458501,swagger-api/swagger-codegen,20/08/18 20:48,spirals-bears,d3f42f02-1b81-4352-bd2f-1d26a43f6972_01-18-week4-FAILING_AND_PASSING,25,227,34,0,2,0,0,288
334312040,swagger-api/swagger-codegen,20/08/18 20:48,spirals-bears,d3f42f02-1b81-4352-bd2f-1d26a43f6972_01-18-week4-FAILING_AND_PASSING,64,33,0,2,0,99
333168412,swagger-api/swagger-codegen,20/08/18 20:48,spirals-bears,d3f42f02-1b81-4352-bd2f-1d26a43f6972_01-18-week4-FAILING_AND_PASSING,34,5,39
332817698,swagger-api/swagger-codegen,20/08/18 20:49,spirals-bears,d3f42f02-1b81-4352-bd2f-1d26a43f6972_01-18-week4-FAILING_AND_PASSING,35,4,39
332450644,swagger-api/swagger-codegen,20/08/18 20:49,spirals-bears,d3f42f02-1b81-4352-bd2f-1d26a43f6972_01-18-week4-FAILING_AND_PASSING,36,5,41
332306644,swagger-api/swagger-codegen,20/08/18 20:50,spirals-bears,d3f42f02-1b81-4352-bd2f-1d26a43f6972_01-18-week4-FAILING_AND_PASSING,32,5,37
331685720,swagger-api/swagger-codegen,20/08/18 20:56,spirals-bears,d3f42f02-1b81-4352-bd2f-1d26a43f6972_01-18-week4-FAILING_AND_PASSING,57,266,32,0,8,0,0,363
331149864,swagger-api/swagger-codegen,20/08/18 20:56,spirals-bears,d3f42f02-1b81-4352-bd2f-1d26a43f6972_01-18-week4-FAILING_AND_PASSING,48,276,34,0,2,0,0,360
332235103,rabbitmq/rabbitmq-perf-test,20/08/18 20:59,spirals-bears,d3f42f02-1b81-4352-bd2f-1d26a43f6972_01-18-week4-FAILING_AND_PASSING,10,0,2,0,3,0,0,41,13,3,32,24,5,0,133
333409277,spring-cloud/spring-cloud-gcp,20/08/18 20:59,spirals-bears,d3f42f02-1b81-4352-bd2f-1d26a43f6972_01-18-week4-FAILING_AND_PASSING,4,2,6
334607542,apache/incubator-servicecomb-saga,20/08/18 20:59,spirals-bears,d3f42f02-1b81-4352-bd2f-1d26a43f6972_01-18-week4-FAILING_AND_PASSING,4,4,8
333306747,apache/incubator-servicecomb-saga,20/08/18 20:59,spirals-bears,d3f42f02-1b81-4352-bd2f-1d26a43f6972_01-18-week4-FAILING_AND_PASSING,4,2,6
332701874,apache/incubator-servicecomb-saga,20/08/18 21:00,spirals-bears,d3f42f02-1b81-4352-bd2f-1d26a43f6972_01-18-week4-FAILING_AND_PASSING,4,0,4
330719643,apache/incubator-servicecomb-saga,20/08/18 21:00,spirals-bears,d3f42f02-1b81-4352-bd2f-1d26a43f6972_01-18-week4-FAILING_AND_PASSING,4,2,6
335496828,vaadin/vaadin-components-testbench,20/08/18 21:00,spirals-bears,d3f42f02-1b81-4352-bd2f-1d26a43f6972_01-18-week4-FAILING_AND_PASSING,2,0,2
331100166,swagger-api/swagger-codegen,20/08/18 21:02,spirals-bears,d3f42f02-1b81-4352-bd2f-1d26a43f6972_01-18-week4-FAILING_AND_PASSING,51,277,36,0,13,0,0,377
334960353,apache/jackrabbit-oak,20/08/18 21:04,spirals-bears,d3f42f02-1b81-4352-bd2f-1d26a43f6972_01-18-week4-FAILING_AND_PASSING,10,0,1,0,1,7,0,1590,158,0,1611,261,37,1,3677
332324658,dhis2/dhis2-core,20/08/18 21:07,spirals-bears,d3f42f02-1b81-4352-bd2f-1d26a43f6972_01-18-week4-FAILING_AND_PASSING,148,24,0,6,0,178
331849997,dhis2/dhis2-core,20/08/18 21:07,spirals-bears,d3f42f02-1b81-4352-bd2f-1d26a43f6972_01-18-week4-FAILING_AND_PASSING,26,4,30
335827320,cpesch/RouteConverter,20/08/18 21:07,spirals-bears,d3f42f02-1b81-4352-bd2f-1d26a43f6972_01-18-week4-FAILING_AND_PASSING,21,7,0,0,7,0,0,4,0,50,0,68,0,36,219,17,5,0,434
332877978,dhis2/dhis2-core,20/08/18 21:08,spirals-bears,d3f42f02-1b81-4352-bd2f-1d26a43f6972_01-18-week4-FAILING_AND_PASSING,25,3,28
333586057,dhis2/dhis2-core,20/08/18 21:10,spirals-bears,d3f42f02-1b81-4352-bd2f-1d26a43f6972_01-18-week4-FAILING_AND_PASSING,94,23,0,1,1,119
332714488,dhis2/dhis2-core,20/08/18 21:10,spirals-bears,d3f42f02-1b81-4352-bd2f-1d26a43f6972_01-18-week4-FAILING_AND_PASSING,80,23,0,1,0,104
334589171,debezium/debezium,20/08/18 21:10,spirals-bears,d3f42f02-1b81-4352-bd2f-1d26a43f6972_01-18-week4-FAILING_AND_PASSING,6,4,10
334460776,debezium/debezium,20/08/18 21:11,spirals-bears,d3f42f02-1b81-4352-bd2f-1d26a43f6972_01-18-week4-FAILING_AND_PASSING,6,3,9
332279952,aicis/fresco,20/08/18 21:11,spirals-bears,d3f42f02-1b81-4352-bd2f-1d26a43f6972_01-18-week4-FAILING_AND_PASSING,10,3,0,1,7,0,0,3,0,1446,0,38,0,1340,100,8,4,0,2960
333186148,debezium/debezium,20/08/18 21:13,spirals-bears,d3f42f02-1b81-4352-bd2f-1d26a43f6972_01-18-week4-FAILING_AND_PASSING,46,148,6,0,0,0,0,200
330480393,debezium/debezium,20/08/18 21:13,spirals-bears,d3f42f02-1b81-4352-bd2f-1d26a43f6972_01-18-week4-FAILING_AND_PASSING,40,96,6,0,4,0,0,146
330968417,debezium/debezium,20/08/18 21:14,spirals-bears,d3f42f02-1b81-4352-bd2f-1d26a43f6972_01-18-week4-FAILING_AND_PASSING,43,94,6,0,4,1,0,148
334678438,MyCoRe-Org/mycore,20/08/18 21:14,spirals-bears,d3f42f02-1b81-4352-bd2f-1d26a43f6972_01-18-week4-FAILING_AND_PASSING,44,0,44
331712157,MyCoRe-Org/mycore,20/08/18 21:14,spirals-bears,d3f42f02-1b81-4352-bd2f-1d26a43f6972_01-18-week4-FAILING_AND_PASSING,47,0,47
334894067,danglotb/dspot,20/08/18 21:15,spirals-bears,d3f42f02-1b81-4352-bd2f-1d26a43f6972_01-18-week4-FAILING_AND_PASSING,9,0,0,0,0,1,0,9,47,0,481,179,5,0,731
335631296,Activiti/Activiti,20/08/18 21:15,spirals-bears,d3f42f02-1b81-4352-bd2f-1d26a43f6972_01-18-week4-FAILING_AND_PASSING,31,0,31
335077761,Spirals-Team/repairnator,20/08/18 21:15,spirals-bears,d3f42f02-1b81-4352-bd2f-1d26a43f6972_01-18-week4-FAILING_AND_PASSING,15,0,15
331712177,MyCoRe-Org/mycore,20/08/18 21:15,spirals-bears,d3f42f02-1b81-4352-bd2f-1d26a43f6972_01-18-week4-FAILING_AND_PASSING,62,3,65
334637352,Activiti/Activiti,20/08/18 21:15,spirals-bears,d3f42f02-1b81-4352-bd2f-1d26a43f6972_01-18-week4-FAILING_AND_PASSING,34,4,38
335077822,Spirals-Team/repairnator,20/08/18 21:15,spirals-bears,d3f42f02-1b81-4352-bd2f-1d26a43f6972_01-18-week4-FAILING_AND_PASSING,18,2,20
334717539,Spirals-Team/repairnator,20/08/18 21:16,spirals-bears,d3f42f02-1b81-4352-bd2f-1d26a43f6972_01-18-week4-FAILING_AND_PASSING,19,0,19
333779392,Spirals-Team/repairnator,20/08/18 21:16,spirals-bears,d3f42f02-1b81-4352-bd2f-1d26a43f6972_01-18-week4-FAILING_AND_PASSING,19,7,26
334717672,Spirals-Team/repairnator,20/08/18 21:16,spirals-bears,d3f42f02-1b81-4352-bd2f-1d26a43f6972_01-18-week4-FAILING_AND_PASSING,19,6,25
331832736,Spirals-Team/repairnator,20/08/18 21:16,spirals-bears,d3f42f02-1b81-4352-bd2f-1d26a43f6972_01-18-week4-FAILING_AND_PASSING,23,0,23
331833009,Spirals-Team/repairnator,20/08/18 21:16,spirals-bears,d3f42f02-1b81-4352-bd2f-1d26a43f6972_01-18-week4-FAILING_AND_PASSING,21,3,24
333859696,jnidzwetzki/bboxdb,20/08/18 21:21,spirals-bears,d3f42f02-1b81-4352-bd2f-1d26a43f6972_01-18-week4-FAILING_AND_PASSING,7,0,0,0,1,2,0,38,88,0,48,124,9,0,317
334194058,jnidzwetzki/bboxdb,20/08/18 21:21,spirals-bears,d3f42f02-1b81-4352-bd2f-1d26a43f6972_01-18-week4-FAILING_AND_PASSING,7,0,0,0,0,2,0,41,88,0,49,130,9,0,326
333697929,4Science/DSpace,20/08/18 21:22,spirals-bears,d3f42f02-1b81-4352-bd2f-1d26a43f6972_01-18-week4-FAILING_AND_PASSING,73,252,44,0,1,0,0,370
332893996,4Science/DSpace,20/08/18 21:22,spirals-bears,d3f42f02-1b81-4352-bd2f-1d26a43f6972_01-18-week4-FAILING_AND_PASSING,40,0,40
333340188,4Science/DSpace,20/08/18 21:22,spirals-bears,d3f42f02-1b81-4352-bd2f-1d26a43f6972_01-18-week4-FAILING_AND_PASSING,52,265,44,0,2,0,0,363
