340400883,apache/flink,23/08/18 23:37,spirals-bears,d3ce7021-6f7e-4bbd-b7fc-dc7f588b701c_02-18-week2-PASSING_AND_PASSING,60,8,68
340934914,apache/flink,23/08/18 23:37,spirals-bears,d3ce7021-6f7e-4bbd-b7fc-dc7f588b701c_02-18-week2-PASSING_AND_PASSING,61,8,69
341319594,apache/flink,23/08/18 23:38,spirals-bears,d3ce7021-6f7e-4bbd-b7fc-dc7f588b701c_02-18-week2-PASSING_AND_PASSING,65,7,72
341360262,apache/flink,23/08/18 23:38,spirals-bears,d3ce7021-6f7e-4bbd-b7fc-dc7f588b701c_02-18-week2-PASSING_AND_PASSING,66,1,2,6,10,85
339431097,apache/flink,23/08/18 23:39,spirals-bears,d3ce7021-6f7e-4bbd-b7fc-dc7f588b701c_02-18-week2-PASSING_AND_PASSING,60,6,66
339498902,apache/flink,23/08/18 23:39,spirals-bears,d3ce7021-6f7e-4bbd-b7fc-dc7f588b701c_02-18-week2-PASSING_AND_PASSING,60,8,68
340456728,apache/flink,23/08/18 23:39,spirals-bears,d3ce7021-6f7e-4bbd-b7fc-dc7f588b701c_02-18-week2-PASSING_AND_PASSING,72,8,80
340021221,apache/flink,23/08/18 23:40,spirals-bears,d3ce7021-6f7e-4bbd-b7fc-dc7f588b701c_02-18-week2-PASSING_AND_PASSING,60,0,2,6,8,76
340509291,apache/flink,23/08/18 23:41,spirals-bears,d3ce7021-6f7e-4bbd-b7fc-dc7f588b701c_02-18-week2-PASSING_AND_PASSING,59,8,67
340292521,apache/flink,23/08/18 23:42,spirals-bears,d3ce7021-6f7e-4bbd-b7fc-dc7f588b701c_02-18-week2-PASSING_AND_PASSING,60,6,66
340518194,apache/flink,23/08/18 23:42,spirals-bears,d3ce7021-6f7e-4bbd-b7fc-dc7f588b701c_02-18-week2-PASSING_AND_PASSING,60,0,2,1,121,2,186
339739551,apache/flink,23/08/18 23:43,spirals-bears,d3ce7021-6f7e-4bbd-b7fc-dc7f588b701c_02-18-week2-PASSING_AND_PASSING,59,5,64
339793800,apache/flink,23/08/18 23:44,spirals-bears,d3ce7021-6f7e-4bbd-b7fc-dc7f588b701c_02-18-week2-PASSING_AND_PASSING,64,6,70
340407197,apache/flink,23/08/18 23:45,spirals-bears,d3ce7021-6f7e-4bbd-b7fc-dc7f588b701c_02-18-week2-PASSING_AND_PASSING,61,0,1,1,210,2,275
305744849,apache/flink,23/08/18 23:46,spirals-bears,d3ce7021-6f7e-4bbd-b7fc-dc7f588b701c_02-18-week2-PASSING_AND_PASSING,61,0,2,5,8,76
335169291,apache/flink,23/08/18 23:47,spirals-bears,d3ce7021-6f7e-4bbd-b7fc-dc7f588b701c_02-18-week2-PASSING_AND_PASSING,59,6,65
339344740,apache/flink,23/08/18 23:48,spirals-bears,d3ce7021-6f7e-4bbd-b7fc-dc7f588b701c_02-18-week2-PASSING_AND_PASSING,60,6,66
339057444,apache/flink,24/08/18 00:09,spirals-bears,d3ce7021-6f7e-4bbd-b7fc-dc7f588b701c_02-18-week2-PASSING_AND_PASSING,60,0,1,1,1362,2,1426
331806110,apache/flink,24/08/18 00:12,spirals-bears,d3ce7021-6f7e-4bbd-b7fc-dc7f588b701c_02-18-week2-PASSING_AND_PASSING,60,0,1,8,13,82
335314102,prestodb/presto,24/08/18 00:13,spirals-bears,d3ce7021-6f7e-4bbd-b7fc-dc7f588b701c_02-18-week2-PASSING_AND_PASSING,53,5,58
341334949,prestodb/presto,24/08/18 00:14,spirals-bears,d3ce7021-6f7e-4bbd-b7fc-dc7f588b701c_02-18-week2-PASSING_AND_PASSING,50,7,57
335312387,prestodb/presto,24/08/18 00:16,spirals-bears,d3ce7021-6f7e-4bbd-b7fc-dc7f588b701c_02-18-week2-PASSING_AND_PASSING,59,8,67
340690819,prestodb/presto,24/08/18 00:17,spirals-bears,d3ce7021-6f7e-4bbd-b7fc-dc7f588b701c_02-18-week2-PASSING_AND_PASSING,43,6,49
340996715,prestodb/presto,24/08/18 00:18,spirals-bears,d3ce7021-6f7e-4bbd-b7fc-dc7f588b701c_02-18-week2-PASSING_AND_PASSING,43,9,52
339238584,prestodb/presto,24/08/18 00:19,spirals-bears,d3ce7021-6f7e-4bbd-b7fc-dc7f588b701c_02-18-week2-PASSING_AND_PASSING,53,5,58
340909507,apache/flink,24/08/18 00:24,spirals-bears,d3ce7021-6f7e-4bbd-b7fc-dc7f588b701c_02-18-week2-PASSING_AND_PASSING,14,0,0,52,1,1,108,0,48,5,1,788,1,62,103,1572,2756
336711940,prestodb/presto,24/08/18 00:25,spirals-bears,d3ce7021-6f7e-4bbd-b7fc-dc7f588b701c_02-18-week2-PASSING_AND_PASSING,54,0,4,5,8,71
340805023,prestodb/presto,24/08/18 00:26,spirals-bears,d3ce7021-6f7e-4bbd-b7fc-dc7f588b701c_02-18-week2-PASSING_AND_PASSING,42,6,48
337448973,prestodb/presto,24/08/18 00:27,spirals-bears,d3ce7021-6f7e-4bbd-b7fc-dc7f588b701c_02-18-week2-PASSING_AND_PASSING,43,5,48
339349001,prestodb/presto,24/08/18 00:28,spirals-bears,d3ce7021-6f7e-4bbd-b7fc-dc7f588b701c_02-18-week2-PASSING_AND_PASSING,43,10,53
339383831,prestodb/presto,24/08/18 00:29,spirals-bears,d3ce7021-6f7e-4bbd-b7fc-dc7f588b701c_02-18-week2-PASSING_AND_PASSING,40,9,49
339562339,apache/flink,24/08/18 00:30,spirals-bears,d3ce7021-6f7e-4bbd-b7fc-dc7f588b701c_02-18-week2-PASSING_AND_PASSING,13,0,0,59,1,1,176,0,39,2,1,807,1,59,41,1656,2856
340542334,prestodb/presto,24/08/18 00:31,spirals-bears,d3ce7021-6f7e-4bbd-b7fc-dc7f588b701c_02-18-week2-PASSING_AND_PASSING,46,10,56
340263099,prestodb/presto,24/08/18 00:31,spirals-bears,d3ce7021-6f7e-4bbd-b7fc-dc7f588b701c_02-18-week2-PASSING_AND_PASSING,48,7,55
339967161,prestodb/presto,24/08/18 00:32,spirals-bears,d3ce7021-6f7e-4bbd-b7fc-dc7f588b701c_02-18-week2-PASSING_AND_PASSING,69,8,77
338894452,apache/flink,24/08/18 00:32,spirals-bears,d3ce7021-6f7e-4bbd-b7fc-dc7f588b701c_02-18-week2-PASSING_AND_PASSING,13,0,7,44,0,1,82,0,42,12,1,696,6,61,38,1582,2585
340054980,prestodb/presto,24/08/18 00:32,spirals-bears,d3ce7021-6f7e-4bbd-b7fc-dc7f588b701c_02-18-week2-PASSING_AND_PASSING,48,13,61
339548551,prestodb/presto,24/08/18 00:33,spirals-bears,d3ce7021-6f7e-4bbd-b7fc-dc7f588b701c_02-18-week2-PASSING_AND_PASSING,42,6,48
339548769,prestodb/presto,24/08/18 00:35,spirals-bears,d3ce7021-6f7e-4bbd-b7fc-dc7f588b701c_02-18-week2-PASSING_AND_PASSING,45,9,54
339447738,prestodb/presto,24/08/18 00:36,spirals-bears,d3ce7021-6f7e-4bbd-b7fc-dc7f588b701c_02-18-week2-PASSING_AND_PASSING,43,8,51
338918858,prestodb/presto,24/08/18 00:37,spirals-bears,d3ce7021-6f7e-4bbd-b7fc-dc7f588b701c_02-18-week2-PASSING_AND_PASSING,42,9,51
339374310,prestodb/presto,24/08/18 00:41,spirals-bears,d3ce7021-6f7e-4bbd-b7fc-dc7f588b701c_02-18-week2-PASSING_AND_PASSING,40,0,2,1,196,2,241
339351092,prestodb/presto,24/08/18 00:42,spirals-bears,d3ce7021-6f7e-4bbd-b7fc-dc7f588b701c_02-18-week2-PASSING_AND_PASSING,41,8,49
339347306,prestodb/presto,24/08/18 00:46,spirals-bears,d3ce7021-6f7e-4bbd-b7fc-dc7f588b701c_02-18-week2-PASSING_AND_PASSING,42,0,1,0,216,3,262
341243067,prestodb/presto,24/08/18 00:47,spirals-bears,d3ce7021-6f7e-4bbd-b7fc-dc7f588b701c_02-18-week2-PASSING_AND_PASSING,51,0,779,1,0,843,1,1675
338678201,prestodb/presto,24/08/18 00:49,spirals-bears,d3ce7021-6f7e-4bbd-b7fc-dc7f588b701c_02-18-week2-PASSING_AND_PASSING,48,0,1,5,9,63
339590445,apache/incubator-druid,24/08/18 00:53,spirals-bears,d3ce7021-6f7e-4bbd-b7fc-dc7f588b701c_02-18-week2-PASSING_AND_PASSING,36,0,1,6,151,11,205
337590070,apache/incubator-druid,24/08/18 00:54,spirals-bears,d3ce7021-6f7e-4bbd-b7fc-dc7f588b701c_02-18-week2-PASSING_AND_PASSING,88,12,100
338157169,apache/incubator-druid,24/08/18 00:57,spirals-bears,d3ce7021-6f7e-4bbd-b7fc-dc7f588b701c_02-18-week2-PASSING_AND_PASSING,33,0,1,6,91,7,138
338922555,thelastpickle/cassandra-reaper,24/08/18 00:58,spirals-bears,d3ce7021-6f7e-4bbd-b7fc-dc7f588b701c_02-18-week2-PASSING_AND_PASSING,6,0,0,0,48,0,54
336893998,thelastpickle/cassandra-reaper,24/08/18 00:58,spirals-bears,d3ce7021-6f7e-4bbd-b7fc-dc7f588b701c_02-18-week2-PASSING_AND_PASSING,6,2,8
339696099,prestodb/presto,24/08/18 01:01,spirals-bears,d3ce7021-6f7e-4bbd-b7fc-dc7f588b701c_02-18-week2-PASSING_AND_PASSING,44,0,805,2,0,892,3,1746
339539729,prestodb/presto,24/08/18 01:02,spirals-bears,d3ce7021-6f7e-4bbd-b7fc-dc7f588b701c_02-18-week2-PASSING_AND_PASSING,41,0,786,1,1,903,3,1735
341064501,JMRI/JMRI,24/08/18 01:07,spirals-bears,d3ce7021-6f7e-4bbd-b7fc-dc7f588b701c_02-18-week2-PASSING_AND_PASSING,272,24,296
341101752,JMRI/JMRI,24/08/18 01:11,spirals-bears,d3ce7021-6f7e-4bbd-b7fc-dc7f588b701c_02-18-week2-PASSING_AND_PASSING,748,23,771
339728203,JMRI/JMRI,24/08/18 01:12,spirals-bears,d3ce7021-6f7e-4bbd-b7fc-dc7f588b701c_02-18-week2-PASSING_AND_PASSING,259,5,264
339873649,JMRI/JMRI,24/08/18 01:15,spirals-bears,d3ce7021-6f7e-4bbd-b7fc-dc7f588b701c_02-18-week2-PASSING_AND_PASSING,745,5,750
338341548,prestodb/presto,24/08/18 01:15,spirals-bears,d3ce7021-6f7e-4bbd-b7fc-dc7f588b701c_02-18-week2-PASSING_AND_PASSING,44,0,813,1,1,837,3,1699
338939573,JMRI/JMRI,24/08/18 01:23,spirals-bears,d3ce7021-6f7e-4bbd-b7fc-dc7f588b701c_02-18-week2-PASSING_AND_PASSING,285,0,0,14,159,14,472
341124048,apache/nifi,24/08/18 01:36,spirals-bears,d3ce7021-6f7e-4bbd-b7fc-dc7f588b701c_02-18-week2-PASSING_AND_PASSING,34,2,5,1,748,1,791
339612051,apache/nifi,24/08/18 01:37,spirals-bears,d3ce7021-6f7e-4bbd-b7fc-dc7f588b701c_02-18-week2-PASSING_AND_PASSING,37,5,42
333579764,apache/nifi,24/08/18 01:38,spirals-bears,d3ce7021-6f7e-4bbd-b7fc-dc7f588b701c_02-18-week2-PASSING_AND_PASSING,37,2,4,7,8,58
338789653,JMRI/JMRI,24/08/18 01:49,spirals-bears,d3ce7021-6f7e-4bbd-b7fc-dc7f588b701c_02-18-week2-PASSING_AND_PASSING,301,0,1557,0,5,166,4,6,2039
339321612,JMRI/JMRI,24/08/18 01:52,spirals-bears,d3ce7021-6f7e-4bbd-b7fc-dc7f588b701c_02-18-week2-PASSING_AND_PASSING,12,0,0,1562,0,174,0,3,4,86,1,301,84,166,2393
339476581,JMRI/JMRI,24/08/18 01:53,spirals-bears,d3ce7021-6f7e-4bbd-b7fc-dc7f588b701c_02-18-week2-PASSING_AND_PASSING,11,0,5,1591,0,175,0,15,10,89,7,270,70,167,2410
339528962,apache/nifi,24/08/18 01:58,spirals-bears,d3ce7021-6f7e-4bbd-b7fc-dc7f588b701c_02-18-week2-PASSING_AND_PASSING,39,2,5,1,266,2,315
339268557,apache/nifi,24/08/18 01:59,spirals-bears,d3ce7021-6f7e-4bbd-b7fc-dc7f588b701c_02-18-week2-PASSING_AND_PASSING,39,2,4,6,10,61
339167097,apache/nifi,24/08/18 02:00,spirals-bears,d3ce7021-6f7e-4bbd-b7fc-dc7f588b701c_02-18-week2-PASSING_AND_PASSING,67,10,77
340253930,apache/nifi,24/08/18 02:03,spirals-bears,d3ce7021-6f7e-4bbd-b7fc-dc7f588b701c_02-18-week2-PASSING_AND_PASSING,36,2,4,1,1448,3,1494
339639234,apache/nifi,24/08/18 02:19,spirals-bears,d3ce7021-6f7e-4bbd-b7fc-dc7f588b701c_02-18-week2-PASSING_AND_PASSING,40,2,5,2,1703,4,1756
339280789,apache/nifi,24/08/18 02:23,spirals-bears,d3ce7021-6f7e-4bbd-b7fc-dc7f588b701c_02-18-week2-PASSING_AND_PASSING,41,2,4,1,1716,2,1766
338923868,apache/nifi,24/08/18 02:30,spirals-bears,d3ce7021-6f7e-4bbd-b7fc-dc7f588b701c_02-18-week2-PASSING_AND_PASSING,41,2,4,2,1720,1,1770
338781843,apache/nifi,24/08/18 02:33,spirals-bears,d3ce7021-6f7e-4bbd-b7fc-dc7f588b701c_02-18-week2-PASSING_AND_PASSING,36,2,4,1,1707,2,1752
341483196,INRIA/spoon,24/08/18 02:34,spirals-bears,d3ce7021-6f7e-4bbd-b7fc-dc7f588b701c_02-18-week2-PASSING_AND_PASSING,9,3,12
340944954,INRIA/spoon,24/08/18 02:34,spirals-bears,d3ce7021-6f7e-4bbd-b7fc-dc7f588b701c_02-18-week2-PASSING_AND_PASSING,10,3,13
339617358,INRIA/spoon,24/08/18 02:40,spirals-bears,d3ce7021-6f7e-4bbd-b7fc-dc7f588b701c_02-18-week2-PASSING_AND_PASSING,9,0,3,427,0,0,5,0,415,5,0,35,3,11,5,58,976
331273103,INRIA/spoon,24/08/18 02:41,spirals-bears,d3ce7021-6f7e-4bbd-b7fc-dc7f588b701c_02-18-week2-PASSING_AND_PASSING,9,0,0,4,79,4,96
338719376,apache/nifi,24/08/18 02:44,spirals-bears,d3ce7021-6f7e-4bbd-b7fc-dc7f588b701c_02-18-week2-PASSING_AND_PASSING,40,3,5,1,1428,2,1479
339173386,INRIA/spoon,24/08/18 02:45,spirals-bears,d3ce7021-6f7e-4bbd-b7fc-dc7f588b701c_02-18-week2-PASSING_AND_PASSING,9,4,13
340895199,INRIA/spoon,24/08/18 02:47,spirals-bears,d3ce7021-6f7e-4bbd-b7fc-dc7f588b701c_02-18-week2-PASSING_AND_PASSING,7,0,0,409,0,0,4,0,436,0,0,32,0,10,7,60,965
280005016,EnMasseProject/enmasse,24/08/18 02:47,spirals-bears,d3ce7021-6f7e-4bbd-b7fc-dc7f588b701c_02-18-week2-PASSING_AND_PASSING,28,0,28
339693406,INRIA/spoon,24/08/18 02:50,spirals-bears,d3ce7021-6f7e-4bbd-b7fc-dc7f588b701c_02-18-week2-PASSING_AND_PASSING,8,0,0,449,0,0,5,0,411,0,1,37,0,9,4,58,982
341418093,EnMasseProject/enmasse,24/08/18 02:51,spirals-bears,d3ce7021-6f7e-4bbd-b7fc-dc7f588b701c_02-18-week2-PASSING_AND_PASSING,28,0,127,1,1,75,0,1,233
341407336,EnMasseProject/enmasse,24/08/18 02:54,spirals-bears,d3ce7021-6f7e-4bbd-b7fc-dc7f588b701c_02-18-week2-PASSING_AND_PASSING,26,0,121,1,1,75,0,1,225
340778498,EnMasseProject/enmasse,24/08/18 02:55,spirals-bears,d3ce7021-6f7e-4bbd-b7fc-dc7f588b701c_02-18-week2-PASSING_AND_PASSING,27,3,30
341331904,EnMasseProject/enmasse,24/08/18 02:55,spirals-bears,d3ce7021-6f7e-4bbd-b7fc-dc7f588b701c_02-18-week2-PASSING_AND_PASSING,27,0,122,3,1,77,0,0,230
341364622,EnMasseProject/enmasse,24/08/18 02:56,spirals-bears,d3ce7021-6f7e-4bbd-b7fc-dc7f588b701c_02-18-week2-PASSING_AND_PASSING,33,0,33
339440809,INRIA/spoon,24/08/18 02:57,spirals-bears,d3ce7021-6f7e-4bbd-b7fc-dc7f588b701c_02-18-week2-PASSING_AND_PASSING,7,0,0,413,0,0,5,0,414,0,0,26,0,9,5,62,941
341303538,EnMasseProject/enmasse,24/08/18 02:58,spirals-bears,d3ce7021-6f7e-4bbd-b7fc-dc7f588b701c_02-18-week2-PASSING_AND_PASSING,26,0,1,1,69,1,98
341073567,EnMasseProject/enmasse,24/08/18 02:59,spirals-bears,d3ce7021-6f7e-4bbd-b7fc-dc7f588b701c_02-18-week2-PASSING_AND_PASSING,27,0,126,1,1,78,0,0,233
341193893,EnMasseProject/enmasse,24/08/18 03:00,spirals-bears,d3ce7021-6f7e-4bbd-b7fc-dc7f588b701c_02-18-week2-PASSING_AND_PASSING,28,0,1,6,70,4,109
338667831,INRIA/spoon,24/08/18 03:00,spirals-bears,d3ce7021-6f7e-4bbd-b7fc-dc7f588b701c_02-18-week2-PASSING_AND_PASSING,7,0,0,405,0,0,4,0,417,0,0,32,0,9,6,56,936
341194980,EnMasseProject/enmasse,24/08/18 03:01,spirals-bears,d3ce7021-6f7e-4bbd-b7fc-dc7f588b701c_02-18-week2-PASSING_AND_PASSING,28,0,2,1,72,1,104
341202494,EnMasseProject/enmasse,24/08/18 03:02,spirals-bears,d3ce7021-6f7e-4bbd-b7fc-dc7f588b701c_02-18-week2-PASSING_AND_PASSING,29,0,128,2,1,79,1,1,241
340836781,EnMasseProject/enmasse,24/08/18 03:03,spirals-bears,d3ce7021-6f7e-4bbd-b7fc-dc7f588b701c_02-18-week2-PASSING_AND_PASSING,27,0,3,1,83,0,114
340836791,EnMasseProject/enmasse,24/08/18 03:04,spirals-bears,d3ce7021-6f7e-4bbd-b7fc-dc7f588b701c_02-18-week2-PASSING_AND_PASSING,29,0,2,6,76,5,118
340473983,EnMasseProject/enmasse,24/08/18 03:04,spirals-bears,d3ce7021-6f7e-4bbd-b7fc-dc7f588b701c_02-18-week2-PASSING_AND_PASSING,29,0,29
341193878,EnMasseProject/enmasse,24/08/18 03:04,spirals-bears,d3ce7021-6f7e-4bbd-b7fc-dc7f588b701c_02-18-week2-PASSING_AND_PASSING,27,0,133,2,1,81,0,0,244
340473830,EnMasseProject/enmasse,24/08/18 03:05,spirals-bears,d3ce7021-6f7e-4bbd-b7fc-dc7f588b701c_02-18-week2-PASSING_AND_PASSING,30,3,33
341082026,EnMasseProject/enmasse,24/08/18 03:05,spirals-bears,d3ce7021-6f7e-4bbd-b7fc-dc7f588b701c_02-18-week2-PASSING_AND_PASSING,30,0,128,2,1,93,0,1,255
340533092,EnMasseProject/enmasse,24/08/18 03:06,spirals-bears,d3ce7021-6f7e-4bbd-b7fc-dc7f588b701c_02-18-week2-PASSING_AND_PASSING,29,0,2,0,2,33
340777186,EnMasseProject/enmasse,24/08/18 03:06,spirals-bears,d3ce7021-6f7e-4bbd-b7fc-dc7f588b701c_02-18-week2-PASSING_AND_PASSING,31,0,2,1,71,0,105
340533728,EnMasseProject/enmasse,24/08/18 03:07,spirals-bears,d3ce7021-6f7e-4bbd-b7fc-dc7f588b701c_02-18-week2-PASSING_AND_PASSING,32,0,3,5,3,43
338898892,EnMasseProject/enmasse,24/08/18 03:07,spirals-bears,d3ce7021-6f7e-4bbd-b7fc-dc7f588b701c_02-18-week2-PASSING_AND_PASSING,33,0,33
336567577,EnMasseProject/enmasse,24/08/18 03:07,spirals-bears,d3ce7021-6f7e-4bbd-b7fc-dc7f588b701c_02-18-week2-PASSING_AND_PASSING,27,0,27
336567536,EnMasseProject/enmasse,24/08/18 03:08,spirals-bears,d3ce7021-6f7e-4bbd-b7fc-dc7f588b701c_02-18-week2-PASSING_AND_PASSING,30,2,32
340486802,EnMasseProject/enmasse,24/08/18 03:08,spirals-bears,d3ce7021-6f7e-4bbd-b7fc-dc7f588b701c_02-18-week2-PASSING_AND_PASSING,28,0,1,1,73,1,104
340540132,EnMasseProject/enmasse,24/08/18 03:09,spirals-bears,d3ce7021-6f7e-4bbd-b7fc-dc7f588b701c_02-18-week2-PASSING_AND_PASSING,31,0,129,2,5,88,0,5,260
340540199,EnMasseProject/enmasse,24/08/18 03:09,spirals-bears,d3ce7021-6f7e-4bbd-b7fc-dc7f588b701c_02-18-week2-PASSING_AND_PASSING,28,0,130,2,1,87,1,2,251
340413353,EnMasseProject/enmasse,24/08/18 03:12,spirals-bears,d3ce7021-6f7e-4bbd-b7fc-dc7f588b701c_02-18-week2-PASSING_AND_PASSING,28,0,131,1,6,87,0,4,257
340413346,EnMasseProject/enmasse,24/08/18 03:13,spirals-bears,d3ce7021-6f7e-4bbd-b7fc-dc7f588b701c_02-18-week2-PASSING_AND_PASSING,29,0,131,2,1,86,0,0,249
340381995,EnMasseProject/enmasse,24/08/18 03:13,spirals-bears,d3ce7021-6f7e-4bbd-b7fc-dc7f588b701c_02-18-week2-PASSING_AND_PASSING,30,0,129,2,1,94,0,1,257
340382013,EnMasseProject/enmasse,24/08/18 03:13,spirals-bears,d3ce7021-6f7e-4bbd-b7fc-dc7f588b701c_02-18-week2-PASSING_AND_PASSING,28,0,129,3,7,96,0,4,267
338991529,EnMasseProject/enmasse,24/08/18 03:14,spirals-bears,d3ce7021-6f7e-4bbd-b7fc-dc7f588b701c_02-18-week2-PASSING_AND_PASSING,32,3,35
340358622,EnMasseProject/enmasse,24/08/18 03:15,spirals-bears,d3ce7021-6f7e-4bbd-b7fc-dc7f588b701c_02-18-week2-PASSING_AND_PASSING,29,0,1,5,79,4,118
340369097,EnMasseProject/enmasse,24/08/18 03:17,spirals-bears,d3ce7021-6f7e-4bbd-b7fc-dc7f588b701c_02-18-week2-PASSING_AND_PASSING,29,0,135,2,6,82,0,3,257
339337638,EnMasseProject/enmasse,24/08/18 03:18,spirals-bears,d3ce7021-6f7e-4bbd-b7fc-dc7f588b701c_02-18-week2-PASSING_AND_PASSING,30,0,129,1,2,93,0,2,257
339212162,EnMasseProject/enmasse,24/08/18 03:19,spirals-bears,d3ce7021-6f7e-4bbd-b7fc-dc7f588b701c_02-18-week2-PASSING_AND_PASSING,30,0,129,2,1,81,0,1,244
339017500,EnMasseProject/enmasse,24/08/18 03:19,spirals-bears,d3ce7021-6f7e-4bbd-b7fc-dc7f588b701c_02-18-week2-PASSING_AND_PASSING,29,0,130,2,5,81,0,4,251
338401863,EnMasseProject/enmasse,24/08/18 03:20,spirals-bears,d3ce7021-6f7e-4bbd-b7fc-dc7f588b701c_02-18-week2-PASSING_AND_PASSING,29,0,29
339017476,EnMasseProject/enmasse,24/08/18 03:21,spirals-bears,d3ce7021-6f7e-4bbd-b7fc-dc7f588b701c_02-18-week2-PASSING_AND_PASSING,30,0,131,1,1,81,0,1,245
338839430,EnMasseProject/enmasse,24/08/18 03:22,spirals-bears,d3ce7021-6f7e-4bbd-b7fc-dc7f588b701c_02-18-week2-PASSING_AND_PASSING,28,0,1,1,70,1,101
341637871,batfish/batfish,24/08/18 03:22,spirals-bears,d3ce7021-6f7e-4bbd-b7fc-dc7f588b701c_02-18-week2-PASSING_AND_PASSING,55,0,55
339003843,EnMasseProject/enmasse,24/08/18 03:22,spirals-bears,d3ce7021-6f7e-4bbd-b7fc-dc7f588b701c_02-18-week2-PASSING_AND_PASSING,29,0,133,2,1,87,1,1,254
339006033,EnMasseProject/enmasse,24/08/18 03:23,spirals-bears,d3ce7021-6f7e-4bbd-b7fc-dc7f588b701c_02-18-week2-PASSING_AND_PASSING,27,0,128,1,4,87,0,3,250
341607910,batfish/batfish,24/08/18 03:23,spirals-bears,d3ce7021-6f7e-4bbd-b7fc-dc7f588b701c_02-18-week2-PASSING_AND_PASSING,52,0,52
341608488,batfish/batfish,24/08/18 03:23,spirals-bears,d3ce7021-6f7e-4bbd-b7fc-dc7f588b701c_02-18-week2-PASSING_AND_PASSING,53,0,53
341608497,batfish/batfish,24/08/18 03:23,spirals-bears,d3ce7021-6f7e-4bbd-b7fc-dc7f588b701c_02-18-week2-PASSING_AND_PASSING,48,3,51
341584157,batfish/batfish,24/08/18 03:24,spirals-bears,d3ce7021-6f7e-4bbd-b7fc-dc7f588b701c_02-18-week2-PASSING_AND_PASSING,51,0,51
341157403,batfish/batfish,24/08/18 03:26,spirals-bears,d3ce7021-6f7e-4bbd-b7fc-dc7f588b701c_02-18-week2-PASSING_AND_PASSING,53,0,0,6,99,8,166
339600915,batfish/batfish,24/08/18 03:27,spirals-bears,d3ce7021-6f7e-4bbd-b7fc-dc7f588b701c_02-18-week2-PASSING_AND_PASSING,53,0,0,5,102,5,165
340804905,batfish/batfish,24/08/18 03:27,spirals-bears,d3ce7021-6f7e-4bbd-b7fc-dc7f588b701c_02-18-week2-PASSING_AND_PASSING,48,0,48
340804921,batfish/batfish,24/08/18 03:28,spirals-bears,d3ce7021-6f7e-4bbd-b7fc-dc7f588b701c_02-18-week2-PASSING_AND_PASSING,47,3,50
341157367,batfish/batfish,24/08/18 03:28,spirals-bears,d3ce7021-6f7e-4bbd-b7fc-dc7f588b701c_02-18-week2-PASSING_AND_PASSING,49,0,7,1,0,231,0,1,289
340786369,batfish/batfish,24/08/18 03:29,spirals-bears,d3ce7021-6f7e-4bbd-b7fc-dc7f588b701c_02-18-week2-PASSING_AND_PASSING,63,3,66
339600892,batfish/batfish,24/08/18 03:29,spirals-bears,d3ce7021-6f7e-4bbd-b7fc-dc7f588b701c_02-18-week2-PASSING_AND_PASSING,51,0,6,0,0,245,0,3,305
340786286,batfish/batfish,24/08/18 03:29,spirals-bears,d3ce7021-6f7e-4bbd-b7fc-dc7f588b701c_02-18-week2-PASSING_AND_PASSING,55,0,55
340617879,batfish/batfish,24/08/18 03:29,spirals-bears,d3ce7021-6f7e-4bbd-b7fc-dc7f588b701c_02-18-week2-PASSING_AND_PASSING,49,3,52
340617925,batfish/batfish,24/08/18 03:30,spirals-bears,d3ce7021-6f7e-4bbd-b7fc-dc7f588b701c_02-18-week2-PASSING_AND_PASSING,53,0,53
339635894,batfish/batfish,24/08/18 03:30,spirals-bears,d3ce7021-6f7e-4bbd-b7fc-dc7f588b701c_02-18-week2-PASSING_AND_PASSING,51,0,51
339635955,batfish/batfish,24/08/18 03:30,spirals-bears,d3ce7021-6f7e-4bbd-b7fc-dc7f588b701c_02-18-week2-PASSING_AND_PASSING,53,3,56
340686508,batfish/batfish,24/08/18 03:31,spirals-bears,d3ce7021-6f7e-4bbd-b7fc-dc7f588b701c_02-18-week2-PASSING_AND_PASSING,53,0,0,0,86,2,141
339297160,batfish/batfish,24/08/18 03:32,spirals-bears,d3ce7021-6f7e-4bbd-b7fc-dc7f588b701c_02-18-week2-PASSING_AND_PASSING,53,3,56
339975194,batfish/batfish,24/08/18 03:35,spirals-bears,d3ce7021-6f7e-4bbd-b7fc-dc7f588b701c_02-18-week2-PASSING_AND_PASSING,51,0,8,2,0,235,0,2,298
339915221,batfish/batfish,24/08/18 03:35,spirals-bears,d3ce7021-6f7e-4bbd-b7fc-dc7f588b701c_02-18-week2-PASSING_AND_PASSING,50,0,9,1,0,235,0,1,296
339731981,batfish/batfish,24/08/18 03:35,spirals-bears,d3ce7021-6f7e-4bbd-b7fc-dc7f588b701c_02-18-week2-PASSING_AND_PASSING,59,0,7,0,0,233,0,2,301
339291550,batfish/batfish,24/08/18 03:36,spirals-bears,d3ce7021-6f7e-4bbd-b7fc-dc7f588b701c_02-18-week2-PASSING_AND_PASSING,49,4,53
339290757,batfish/batfish,24/08/18 03:37,spirals-bears,d3ce7021-6f7e-4bbd-b7fc-dc7f588b701c_02-18-week2-PASSING_AND_PASSING,54,3,57
339275716,batfish/batfish,24/08/18 03:37,spirals-bears,d3ce7021-6f7e-4bbd-b7fc-dc7f588b701c_02-18-week2-PASSING_AND_PASSING,55,0,7,0,0,222,0,2,286
339289625,batfish/batfish,24/08/18 03:38,spirals-bears,d3ce7021-6f7e-4bbd-b7fc-dc7f588b701c_02-18-week2-PASSING_AND_PASSING,69,3,72
339118198,batfish/batfish,24/08/18 03:39,spirals-bears,d3ce7021-6f7e-4bbd-b7fc-dc7f588b701c_02-18-week2-PASSING_AND_PASSING,53,0,0,5,6,64
339129808,batfish/batfish,24/08/18 03:39,spirals-bears,d3ce7021-6f7e-4bbd-b7fc-dc7f588b701c_02-18-week2-PASSING_AND_PASSING,53,0,0,5,178,4,240
339166325,batfish/batfish,24/08/18 03:39,spirals-bears,d3ce7021-6f7e-4bbd-b7fc-dc7f588b701c_02-18-week2-PASSING_AND_PASSING,52,0,1,0,46,1,100
339118136,batfish/batfish,24/08/18 03:40,spirals-bears,d3ce7021-6f7e-4bbd-b7fc-dc7f588b701c_02-18-week2-PASSING_AND_PASSING,57,0,0,0,1,58
339081455,batfish/batfish,24/08/18 03:40,spirals-bears,d3ce7021-6f7e-4bbd-b7fc-dc7f588b701c_02-18-week2-PASSING_AND_PASSING,53,3,56
338846591,batfish/batfish,24/08/18 03:40,spirals-bears,d3ce7021-6f7e-4bbd-b7fc-dc7f588b701c_02-18-week2-PASSING_AND_PASSING,54,0,54
338846816,batfish/batfish,24/08/18 03:41,spirals-bears,d3ce7021-6f7e-4bbd-b7fc-dc7f588b701c_02-18-week2-PASSING_AND_PASSING,54,3,57
339199253,batfish/batfish,24/08/18 03:42,spirals-bears,d3ce7021-6f7e-4bbd-b7fc-dc7f588b701c_02-18-week2-PASSING_AND_PASSING,54,0,8,0,1,243,0,1,307
338745151,batfish/batfish,24/08/18 03:42,spirals-bears,d3ce7021-6f7e-4bbd-b7fc-dc7f588b701c_02-18-week2-PASSING_AND_PASSING,54,0,54
338745610,batfish/batfish,24/08/18 03:43,spirals-bears,d3ce7021-6f7e-4bbd-b7fc-dc7f588b701c_02-18-week2-PASSING_AND_PASSING,50,3,53
325675659,batfish/batfish,24/08/18 03:44,spirals-bears,d3ce7021-6f7e-4bbd-b7fc-dc7f588b701c_02-18-week2-PASSING_AND_PASSING,66,0,0,0,42,1,109
339080600,batfish/batfish,24/08/18 03:45,spirals-bears,d3ce7021-6f7e-4bbd-b7fc-dc7f588b701c_02-18-week2-PASSING_AND_PASSING,56,0,0,0,194,3,253
338802624,batfish/batfish,24/08/18 03:45,spirals-bears,d3ce7021-6f7e-4bbd-b7fc-dc7f588b701c_02-18-week2-PASSING_AND_PASSING,52,0,8,0,0,231,0,3,294
339307931,matsim-org/matsim,24/08/18 03:47,spirals-bears,d3ce7021-6f7e-4bbd-b7fc-dc7f588b701c_02-18-week2-PASSING_AND_PASSING,167,0,0,1,68,2,238
338379241,matsim-org/matsim,24/08/18 03:47,spirals-bears,d3ce7021-6f7e-4bbd-b7fc-dc7f588b701c_02-18-week2-PASSING_AND_PASSING,178,3,181
338377467,matsim-org/matsim,24/08/18 03:48,spirals-bears,d3ce7021-6f7e-4bbd-b7fc-dc7f588b701c_02-18-week2-PASSING_AND_PASSING,163,0,163
339144729,matsim-org/matsim,24/08/18 03:48,spirals-bears,d3ce7021-6f7e-4bbd-b7fc-dc7f588b701c_02-18-week2-PASSING_AND_PASSING,162,0,162
338499294,matsim-org/matsim,24/08/18 03:52,spirals-bears,d3ce7021-6f7e-4bbd-b7fc-dc7f588b701c_02-18-week2-PASSING_AND_PASSING,160,0,1,1,71,1,234
338574901,matsim-org/matsim,24/08/18 03:52,spirals-bears,d3ce7021-6f7e-4bbd-b7fc-dc7f588b701c_02-18-week2-PASSING_AND_PASSING,170,0,2,7,74,5,258
338036533,matsim-org/matsim,24/08/18 03:53,spirals-bears,d3ce7021-6f7e-4bbd-b7fc-dc7f588b701c_02-18-week2-PASSING_AND_PASSING,193,0,2,2,70,1,268
337991817,apache/incubator-servicecomb-java-chassis,24/08/18 03:53,spirals-bears,d3ce7021-6f7e-4bbd-b7fc-dc7f588b701c_02-18-week2-PASSING_AND_PASSING,8,3,11
340400455,apache/incubator-servicecomb-java-chassis,24/08/18 03:54,spirals-bears,d3ce7021-6f7e-4bbd-b7fc-dc7f588b701c_02-18-week2-PASSING_AND_PASSING,8,4,12
340355744,apache/incubator-servicecomb-java-chassis,24/08/18 03:54,spirals-bears,d3ce7021-6f7e-4bbd-b7fc-dc7f588b701c_02-18-week2-PASSING_AND_PASSING,9,3,12
340098054,apache/incubator-servicecomb-java-chassis,24/08/18 03:54,spirals-bears,d3ce7021-6f7e-4bbd-b7fc-dc7f588b701c_02-18-week2-PASSING_AND_PASSING,9,1,6,0,125,1,142
341230680,apache/incubator-servicecomb-java-chassis,24/08/18 03:54,spirals-bears,d3ce7021-6f7e-4bbd-b7fc-dc7f588b701c_02-18-week2-PASSING_AND_PASSING,9,1,6,0,130,1,147
340052420,apache/incubator-servicecomb-java-chassis,24/08/18 03:54,spirals-bears,d3ce7021-6f7e-4bbd-b7fc-dc7f588b701c_02-18-week2-PASSING_AND_PASSING,10,4,14
340044767,apache/incubator-servicecomb-java-chassis,24/08/18 03:55,spirals-bears,d3ce7021-6f7e-4bbd-b7fc-dc7f588b701c_02-18-week2-PASSING_AND_PASSING,11,3,14
340029638,apache/incubator-servicecomb-java-chassis,24/08/18 03:55,spirals-bears,d3ce7021-6f7e-4bbd-b7fc-dc7f588b701c_02-18-week2-PASSING_AND_PASSING,10,4,14
339305045,apache/incubator-servicecomb-java-chassis,24/08/18 03:55,spirals-bears,d3ce7021-6f7e-4bbd-b7fc-dc7f588b701c_02-18-week2-PASSING_AND_PASSING,10,4,14
338973271,apache/incubator-servicecomb-java-chassis,24/08/18 03:55,spirals-bears,d3ce7021-6f7e-4bbd-b7fc-dc7f588b701c_02-18-week2-PASSING_AND_PASSING,10,4,14
339267305,apache/incubator-servicecomb-java-chassis,24/08/18 03:55,spirals-bears,d3ce7021-6f7e-4bbd-b7fc-dc7f588b701c_02-18-week2-PASSING_AND_PASSING,10,4,14
338348564,apache/incubator-servicecomb-java-chassis,24/08/18 03:56,spirals-bears,d3ce7021-6f7e-4bbd-b7fc-dc7f588b701c_02-18-week2-PASSING_AND_PASSING,10,3,13
337985455,apache/incubator-servicecomb-java-chassis,24/08/18 03:56,spirals-bears,d3ce7021-6f7e-4bbd-b7fc-dc7f588b701c_02-18-week2-PASSING_AND_PASSING,10,4,14
336849431,apache/incubator-servicecomb-java-chassis,24/08/18 03:57,spirals-bears,d3ce7021-6f7e-4bbd-b7fc-dc7f588b701c_02-18-week2-PASSING_AND_PASSING,9,1,5,0,46,1,62
338388371,apache/incubator-servicecomb-java-chassis,24/08/18 03:57,spirals-bears,d3ce7021-6f7e-4bbd-b7fc-dc7f588b701c_02-18-week2-PASSING_AND_PASSING,10,2,5,5,48,4,74
338723748,runelite/runelite,24/08/18 03:57,spirals-bears,d3ce7021-6f7e-4bbd-b7fc-dc7f588b701c_02-18-week2-PASSING_AND_PASSING,10,0,10
340153193,runelite/runelite,24/08/18 03:57,spirals-bears,d3ce7021-6f7e-4bbd-b7fc-dc7f588b701c_02-18-week2-PASSING_AND_PASSING,10,0,10
338903082,matsim-org/matsim,24/08/18 03:58,spirals-bears,d3ce7021-6f7e-4bbd-b7fc-dc7f588b701c_02-18-week2-PASSING_AND_PASSING,166,0,2,1,438,2,609
339916173,runelite/runelite,24/08/18 03:58,spirals-bears,d3ce7021-6f7e-4bbd-b7fc-dc7f588b701c_02-18-week2-PASSING_AND_PASSING,11,0,11
339835641,runelite/runelite,24/08/18 03:58,spirals-bears,d3ce7021-6f7e-4bbd-b7fc-dc7f588b701c_02-18-week2-PASSING_AND_PASSING,11,0,11
339730096,runelite/runelite,24/08/18 03:58,spirals-bears,d3ce7021-6f7e-4bbd-b7fc-dc7f588b701c_02-18-week2-PASSING_AND_PASSING,11,0,11
339428576,runelite/runelite,24/08/18 03:58,spirals-bears,d3ce7021-6f7e-4bbd-b7fc-dc7f588b701c_02-18-week2-PASSING_AND_PASSING,11,0,11
339428118,runelite/runelite,24/08/18 03:58,spirals-bears,d3ce7021-6f7e-4bbd-b7fc-dc7f588b701c_02-18-week2-PASSING_AND_PASSING,10,0,10
334575900,runelite/runelite,24/08/18 03:58,spirals-bears,d3ce7021-6f7e-4bbd-b7fc-dc7f588b701c_02-18-week2-PASSING_AND_PASSING,11,15,26
338707203,runelite/runelite,24/08/18 03:59,spirals-bears,d3ce7021-6f7e-4bbd-b7fc-dc7f588b701c_02-18-week2-PASSING_AND_PASSING,10,15,25
339262871,runelite/runelite,24/08/18 03:59,spirals-bears,d3ce7021-6f7e-4bbd-b7fc-dc7f588b701c_02-18-week2-PASSING_AND_PASSING,10,0,10
339154777,runelite/runelite,24/08/18 03:59,spirals-bears,d3ce7021-6f7e-4bbd-b7fc-dc7f588b701c_02-18-week2-PASSING_AND_PASSING,11,0,11
339243801,runelite/runelite,24/08/18 03:59,spirals-bears,d3ce7021-6f7e-4bbd-b7fc-dc7f588b701c_02-18-week2-PASSING_AND_PASSING,11,0,11
338238784,runelite/runelite,24/08/18 03:59,spirals-bears,d3ce7021-6f7e-4bbd-b7fc-dc7f588b701c_02-18-week2-PASSING_AND_PASSING,10,0,10
339245216,runelite/runelite,24/08/18 03:59,spirals-bears,d3ce7021-6f7e-4bbd-b7fc-dc7f588b701c_02-18-week2-PASSING_AND_PASSING,10,0,10
337918145,runelite/runelite,24/08/18 03:59,spirals-bears,d3ce7021-6f7e-4bbd-b7fc-dc7f588b701c_02-18-week2-PASSING_AND_PASSING,12,0,12
339322121,terasolunaorg/tutorial-apps,24/08/18 03:59,spirals-bears,d3ce7021-6f7e-4bbd-b7fc-dc7f588b701c_02-18-week2-PASSING_AND_PASSING,3,0,0,3
339322196,terasolunaorg/tutorial-apps,24/08/18 03:59,spirals-bears,d3ce7021-6f7e-4bbd-b7fc-dc7f588b701c_02-18-week2-PASSING_AND_PASSING,3,0,0,3
338812800,terasolunaorg/tutorial-apps,24/08/18 04:00,spirals-bears,d3ce7021-6f7e-4bbd-b7fc-dc7f588b701c_02-18-week2-PASSING_AND_PASSING,4,0,0,4
339688412,CorfuDB/CorfuDB,24/08/18 04:04,spirals-bears,d3ce7021-6f7e-4bbd-b7fc-dc7f588b701c_02-18-week2-PASSING_AND_PASSING,256,0,256
339688416,CorfuDB/CorfuDB,24/08/18 04:04,spirals-bears,d3ce7021-6f7e-4bbd-b7fc-dc7f588b701c_02-18-week2-PASSING_AND_PASSING,252,4,256
338913752,apache/incubator-servicecomb-java-chassis,24/08/18 04:08,spirals-bears,d3ce7021-6f7e-4bbd-b7fc-dc7f588b701c_02-18-week2-PASSING_AND_PASSING,9,2,2,1,7,67,0,6,6,1,293,0,0,0,150,0,9,2,2,209,766
339629602,CorfuDB/CorfuDB,24/08/18 04:09,spirals-bears,d3ce7021-6f7e-4bbd-b7fc-dc7f588b701c_02-18-week2-PASSING_AND_PASSING,292,0,292
336221042,CorfuDB/CorfuDB,24/08/18 04:11,spirals-bears,d3ce7021-6f7e-4bbd-b7fc-dc7f588b701c_02-18-week2-PASSING_AND_PASSING,268,0,0,0,151,0,419
339629348,CorfuDB/CorfuDB,24/08/18 04:12,spirals-bears,d3ce7021-6f7e-4bbd-b7fc-dc7f588b701c_02-18-week2-PASSING_AND_PASSING,254,3,257
336760282,CorfuDB/CorfuDB,24/08/18 04:14,spirals-bears,d3ce7021-6f7e-4bbd-b7fc-dc7f588b701c_02-18-week2-PASSING_AND_PASSING,259,3,262
339630487,CorfuDB/CorfuDB,24/08/18 04:15,spirals-bears,d3ce7021-6f7e-4bbd-b7fc-dc7f588b701c_02-18-week2-PASSING_AND_PASSING,262,0,262
339626844,CorfuDB/CorfuDB,24/08/18 04:17,spirals-bears,d3ce7021-6f7e-4bbd-b7fc-dc7f588b701c_02-18-week2-PASSING_AND_PASSING,263,0,263
339262705,CorfuDB/CorfuDB,24/08/18 04:19,spirals-bears,d3ce7021-6f7e-4bbd-b7fc-dc7f588b701c_02-18-week2-PASSING_AND_PASSING,331,3,334
339176759,CorfuDB/CorfuDB,24/08/18 04:20,spirals-bears,d3ce7021-6f7e-4bbd-b7fc-dc7f588b701c_02-18-week2-PASSING_AND_PASSING,253,3,256
339152256,CorfuDB/CorfuDB,24/08/18 04:21,spirals-bears,d3ce7021-6f7e-4bbd-b7fc-dc7f588b701c_02-18-week2-PASSING_AND_PASSING,255,0,255
341258256,apache/storm,24/08/18 04:21,spirals-bears,d3ce7021-6f7e-4bbd-b7fc-dc7f588b701c_02-18-week2-PASSING_AND_PASSING,42,0,2,0,38,1,83
341394081,apache/storm,24/08/18 04:22,spirals-bears,d3ce7021-6f7e-4bbd-b7fc-dc7f588b701c_02-18-week2-PASSING_AND_PASSING,35,0,1,5,8,49
341223376,apache/storm,24/08/18 04:22,spirals-bears,d3ce7021-6f7e-4bbd-b7fc-dc7f588b701c_02-18-week2-PASSING_AND_PASSING,37,6,43
340978257,apache/storm,24/08/18 04:23,spirals-bears,d3ce7021-6f7e-4bbd-b7fc-dc7f588b701c_02-18-week2-PASSING_AND_PASSING,38,6,44
339153341,CorfuDB/CorfuDB,24/08/18 04:24,spirals-bears,d3ce7021-6f7e-4bbd-b7fc-dc7f588b701c_02-18-week2-PASSING_AND_PASSING,271,3,274
341131187,apache/storm,24/08/18 04:24,spirals-bears,d3ce7021-6f7e-4bbd-b7fc-dc7f588b701c_02-18-week2-PASSING_AND_PASSING,43,0,2,0,51,1,97
340853089,apache/storm,24/08/18 04:25,spirals-bears,d3ce7021-6f7e-4bbd-b7fc-dc7f588b701c_02-18-week2-PASSING_AND_PASSING,39,0,2,0,65,2,108
339281261,apache/storm,24/08/18 04:26,spirals-bears,d3ce7021-6f7e-4bbd-b7fc-dc7f588b701c_02-18-week2-PASSING_AND_PASSING,40,0,1,0,57,2,100
339206240,apache/storm,24/08/18 04:26,spirals-bears,d3ce7021-6f7e-4bbd-b7fc-dc7f588b701c_02-18-week2-PASSING_AND_PASSING,35,0,1,6,56,6,104
339488156,apache/storm,24/08/18 04:26,spirals-bears,d3ce7021-6f7e-4bbd-b7fc-dc7f588b701c_02-18-week2-PASSING_AND_PASSING,38,4,42
338282163,apache/storm,24/08/18 04:27,spirals-bears,d3ce7021-6f7e-4bbd-b7fc-dc7f588b701c_02-18-week2-PASSING_AND_PASSING,40,7,47
341464439,linkedin/pinot,24/08/18 04:27,spirals-bears,d3ce7021-6f7e-4bbd-b7fc-dc7f588b701c_02-18-week2-PASSING_AND_PASSING,37,4,41
339723137,linkedin/pinot,24/08/18 04:27,spirals-bears,d3ce7021-6f7e-4bbd-b7fc-dc7f588b701c_02-18-week2-PASSING_AND_PASSING,41,8,49
341275652,linkedin/pinot,24/08/18 04:28,spirals-bears,d3ce7021-6f7e-4bbd-b7fc-dc7f588b701c_02-18-week2-PASSING_AND_PASSING,36,7,43
341193282,linkedin/pinot,24/08/18 04:31,spirals-bears,d3ce7021-6f7e-4bbd-b7fc-dc7f588b701c_02-18-week2-PASSING_AND_PASSING,41,0,0,7,192,12,252
335392921,linkedin/pinot,24/08/18 04:32,spirals-bears,d3ce7021-6f7e-4bbd-b7fc-dc7f588b701c_02-18-week2-PASSING_AND_PASSING,39,0,1,7,188,9,244
339720517,CorfuDB/CorfuDB,24/08/18 04:33,spirals-bears,d3ce7021-6f7e-4bbd-b7fc-dc7f588b701c_02-18-week2-PASSING_AND_PASSING,9,4,0,0,5,734,0,0,2,0,703,0,0,0,95,0,264,4,3,189,2012
339722755,linkedin/pinot,24/08/18 04:34,spirals-bears,d3ce7021-6f7e-4bbd-b7fc-dc7f588b701c_02-18-week2-PASSING_AND_PASSING,43,4,47
339564740,linkedin/pinot,24/08/18 04:35,spirals-bears,d3ce7021-6f7e-4bbd-b7fc-dc7f588b701c_02-18-week2-PASSING_AND_PASSING,38,5,43
339733839,linkedin/pinot,24/08/18 04:36,spirals-bears,d3ce7021-6f7e-4bbd-b7fc-dc7f588b701c_02-18-week2-PASSING_AND_PASSING,38,0,1,1,221,1,262
339716383,linkedin/pinot,24/08/18 04:36,spirals-bears,d3ce7021-6f7e-4bbd-b7fc-dc7f588b701c_02-18-week2-PASSING_AND_PASSING,34,0,0,1,202,3,240
339621292,linkedin/pinot,24/08/18 04:37,spirals-bears,d3ce7021-6f7e-4bbd-b7fc-dc7f588b701c_02-18-week2-PASSING_AND_PASSING,41,4,45
339601078,linkedin/pinot,24/08/18 04:38,spirals-bears,d3ce7021-6f7e-4bbd-b7fc-dc7f588b701c_02-18-week2-PASSING_AND_PASSING,38,4,42
339603557,linkedin/pinot,24/08/18 04:39,spirals-bears,d3ce7021-6f7e-4bbd-b7fc-dc7f588b701c_02-18-week2-PASSING_AND_PASSING,38,3,41
339679352,linkedin/pinot,24/08/18 04:40,spirals-bears,d3ce7021-6f7e-4bbd-b7fc-dc7f588b701c_02-18-week2-PASSING_AND_PASSING,38,0,0,1,223,1,263
339301377,linkedin/pinot,24/08/18 04:40,spirals-bears,d3ce7021-6f7e-4bbd-b7fc-dc7f588b701c_02-18-week2-PASSING_AND_PASSING,45,0,0,1,189,2,237
339220482,linkedin/pinot,24/08/18 04:41,spirals-bears,d3ce7021-6f7e-4bbd-b7fc-dc7f588b701c_02-18-week2-PASSING_AND_PASSING,34,5,39
339196410,linkedin/pinot,24/08/18 04:42,spirals-bears,d3ce7021-6f7e-4bbd-b7fc-dc7f588b701c_02-18-week2-PASSING_AND_PASSING,43,4,47
339205784,linkedin/pinot,24/08/18 04:43,spirals-bears,d3ce7021-6f7e-4bbd-b7fc-dc7f588b701c_02-18-week2-PASSING_AND_PASSING,42,3,45
338751820,linkedin/pinot,24/08/18 04:44,spirals-bears,d3ce7021-6f7e-4bbd-b7fc-dc7f588b701c_02-18-week2-PASSING_AND_PASSING,35,5,40
338793131,linkedin/pinot,24/08/18 04:44,spirals-bears,d3ce7021-6f7e-4bbd-b7fc-dc7f588b701c_02-18-week2-PASSING_AND_PASSING,34,3,37
341166198,linkedin/pinot,24/08/18 05:32,spirals-bears,d3ce7021-6f7e-4bbd-b7fc-dc7f588b701c_02-18-week2-PASSING_AND_PASSING,37,0,3408,0,1,442,1,6,3895
339266862,linkedin/pinot,24/08/18 05:49,spirals-bears,d3ce7021-6f7e-4bbd-b7fc-dc7f588b701c_02-18-week2-PASSING_AND_PASSING,10,33,0,0,16,26,0,0,39,0,3404,0,1,0,86,0,38,50,31,431,4165
338790436,linkedin/pinot,24/08/18 05:52,spirals-bears,d3ce7021-6f7e-4bbd-b7fc-dc7f588b701c_02-18-week2-PASSING_AND_PASSING,36,0,718,0,1,418,1,1174
338785770,linkedin/pinot,24/08/18 05:53,spirals-bears,d3ce7021-6f7e-4bbd-b7fc-dc7f588b701c_02-18-week2-PASSING_AND_PASSING,43,7,50
338739681,linkedin/pinot,24/08/18 05:53,spirals-bears,d3ce7021-6f7e-4bbd-b7fc-dc7f588b701c_02-18-week2-PASSING_AND_PASSING,34,0,0,1,216,3,254
338723047,linkedin/pinot,24/08/18 05:54,spirals-bears,d3ce7021-6f7e-4bbd-b7fc-dc7f588b701c_02-18-week2-PASSING_AND_PASSING,35,7,42
338661680,linkedin/pinot,24/08/18 05:54,spirals-bears,d3ce7021-6f7e-4bbd-b7fc-dc7f588b701c_02-18-week2-PASSING_AND_PASSING,33,4,37
338729910,linkedin/pinot,24/08/18 05:55,spirals-bears,d3ce7021-6f7e-4bbd-b7fc-dc7f588b701c_02-18-week2-PASSING_AND_PASSING,46,3,49
338303557,Azure/azure-libraries-for-java,24/08/18 05:56,spirals-bears,d3ce7021-6f7e-4bbd-b7fc-dc7f588b701c_02-18-week2-PASSING_AND_PASSING,67,0,67
337863751,Azure/azure-libraries-for-java,24/08/18 05:59,spirals-bears,d3ce7021-6f7e-4bbd-b7fc-dc7f588b701c_02-18-week2-PASSING_AND_PASSING,64,0,1,6,79,8,158
337127054,Azure/azure-libraries-for-java,24/08/18 06:00,spirals-bears,d3ce7021-6f7e-4bbd-b7fc-dc7f588b701c_02-18-week2-PASSING_AND_PASSING,60,4,64
341327601,Azure/azure-libraries-for-java,24/08/18 06:03,spirals-bears,d3ce7021-6f7e-4bbd-b7fc-dc7f588b701c_02-18-week2-PASSING_AND_PASSING,12,0,2,98,0,1,20,0,98,7,0,73,4,64,17,93,489
340337414,graphhopper/graphhopper,24/08/18 06:03,spirals-bears,d3ce7021-6f7e-4bbd-b7fc-dc7f588b701c_02-18-week2-PASSING_AND_PASSING,21,6,27
332857066,graphhopper/graphhopper,24/08/18 06:04,spirals-bears,d3ce7021-6f7e-4bbd-b7fc-dc7f588b701c_02-18-week2-PASSING_AND_PASSING,19,4,23
341342957,graphhopper/graphhopper,24/08/18 06:05,spirals-bears,d3ce7021-6f7e-4bbd-b7fc-dc7f588b701c_02-18-week2-PASSING_AND_PASSING,19,0,90,0,0,133,0,0,242
339243764,linkedin/pinot,24/08/18 06:05,spirals-bears,d3ce7021-6f7e-4bbd-b7fc-dc7f588b701c_02-18-week2-PASSING_AND_PASSING,10,34,0,0,17,833,0,0,23,0,3514,0,0,0,93,0,42,47,41,426,5080
341490462,HubSpot/Singularity,24/08/18 06:07,spirals-bears,d3ce7021-6f7e-4bbd-b7fc-dc7f588b701c_02-18-week2-PASSING_AND_PASSING,17,0,2,0,142,0,161
338027476,HubSpot/Singularity,24/08/18 06:07,spirals-bears,d3ce7021-6f7e-4bbd-b7fc-dc7f588b701c_02-18-week2-PASSING_AND_PASSING,17,0,1,0,139,0,157
341518269,magefree/mage,24/08/18 06:21,spirals-bears,d3ce7021-6f7e-4bbd-b7fc-dc7f588b701c_02-18-week2-PASSING_AND_PASSING,8,0,0,198,0,1,28,0,166,2,1,31,1,162,22,311,931
340770405,magefree/mage,24/08/18 06:23,spirals-bears,d3ce7021-6f7e-4bbd-b7fc-dc7f588b701c_02-18-week2-PASSING_AND_PASSING,7,0,0,165,0,1,28,0,169,2,1,23,1,197,27,323,944
340535779,magefree/mage,24/08/18 06:24,spirals-bears,d3ce7021-6f7e-4bbd-b7fc-dc7f588b701c_02-18-week2-PASSING_AND_PASSING,11,0,0,189,0,1,27,0,167,1,1,24,0,171,25,316,933
341378518,molgenis/molgenis,24/08/18 06:24,spirals-bears,d3ce7021-6f7e-4bbd-b7fc-dc7f588b701c_02-18-week2-PASSING_AND_PASSING,39,8,47
341349987,molgenis/molgenis,24/08/18 06:25,spirals-bears,d3ce7021-6f7e-4bbd-b7fc-dc7f588b701c_02-18-week2-PASSING_AND_PASSING,46,0,1,1,36,1,85
340424370,magefree/mage,24/08/18 06:37,spirals-bears,d3ce7021-6f7e-4bbd-b7fc-dc7f588b701c_02-18-week2-PASSING_AND_PASSING,7,0,0,168,0,1,30,0,174,2,1,23,1,170,26,323,926
340739530,visallo/vertexium,24/08/18 06:40,spirals-bears,d3ce7021-6f7e-4bbd-b7fc-dc7f588b701c_02-18-week2-PASSING_AND_PASSING,7,0,13,0,0,164,0,0,184
338830540,linkedin/pinot,24/08/18 06:46,spirals-bears,d3ce7021-6f7e-4bbd-b7fc-dc7f588b701c_02-18-week2-PASSING_AND_PASSING,38,0,6788,1,1,448,1,1,7278
341072214,StuPro-TOSCAna/TOSCAna,24/08/18 06:46,spirals-bears,d3ce7021-6f7e-4bbd-b7fc-dc7f588b701c_02-18-week2-PASSING_AND_PASSING,14,2,16
341072196,StuPro-TOSCAna/TOSCAna,24/08/18 06:47,spirals-bears,d3ce7021-6f7e-4bbd-b7fc-dc7f588b701c_02-18-week2-PASSING_AND_PASSING,14,0,14
341593447,StuPro-TOSCAna/TOSCAna,24/08/18 06:47,spirals-bears,d3ce7021-6f7e-4bbd-b7fc-dc7f588b701c_02-18-week2-PASSING_AND_PASSING,22,0,2,0,351,0,375
340595005,StuPro-TOSCAna/TOSCAna,24/08/18 06:47,spirals-bears,d3ce7021-6f7e-4bbd-b7fc-dc7f588b701c_02-18-week2-PASSING_AND_PASSING,17,0,17
341332014,molgenis/molgenis,24/08/18 06:47,spirals-bears,d3ce7021-6f7e-4bbd-b7fc-dc7f588b701c_02-18-week2-PASSING_AND_PASSING,41,0,810,1,7,482,1,10,1352
340741768,StuPro-TOSCAna/TOSCAna,24/08/18 06:47,spirals-bears,d3ce7021-6f7e-4bbd-b7fc-dc7f588b701c_02-18-week2-PASSING_AND_PASSING,17,2,19
340741746,StuPro-TOSCAna/TOSCAna,24/08/18 06:47,spirals-bears,d3ce7021-6f7e-4bbd-b7fc-dc7f588b701c_02-18-week2-PASSING_AND_PASSING,13,0,13
341087119,StuPro-TOSCAna/TOSCAna,24/08/18 06:48,spirals-bears,d3ce7021-6f7e-4bbd-b7fc-dc7f588b701c_02-18-week2-PASSING_AND_PASSING,14,0,14
340855041,molgenis/molgenis,24/08/18 06:48,spirals-bears,d3ce7021-6f7e-4bbd-b7fc-dc7f588b701c_02-18-week2-PASSING_AND_PASSING,42,0,807,2,6,475,2,10,1344
340574705,StuPro-TOSCAna/TOSCAna,24/08/18 06:48,spirals-bears,d3ce7021-6f7e-4bbd-b7fc-dc7f588b701c_02-18-week2-PASSING_AND_PASSING,17,2,19
341087142,StuPro-TOSCAna/TOSCAna,24/08/18 06:48,spirals-bears,d3ce7021-6f7e-4bbd-b7fc-dc7f588b701c_02-18-week2-PASSING_AND_PASSING,25,2,27
340574651,StuPro-TOSCAna/TOSCAna,24/08/18 06:48,spirals-bears,d3ce7021-6f7e-4bbd-b7fc-dc7f588b701c_02-18-week2-PASSING_AND_PASSING,14,0,14
341071468,StuPro-TOSCAna/TOSCAna,24/08/18 06:49,spirals-bears,d3ce7021-6f7e-4bbd-b7fc-dc7f588b701c_02-18-week2-PASSING_AND_PASSING,18,3,21
341053981,StuPro-TOSCAna/TOSCAna,24/08/18 06:49,spirals-bears,d3ce7021-6f7e-4bbd-b7fc-dc7f588b701c_02-18-week2-PASSING_AND_PASSING,17,3,20
339693132,StuPro-TOSCAna/TOSCAna,24/08/18 06:49,spirals-bears,d3ce7021-6f7e-4bbd-b7fc-dc7f588b701c_02-18-week2-PASSING_AND_PASSING,16,2,18
339631823,StuPro-TOSCAna/TOSCAna,24/08/18 06:49,spirals-bears,d3ce7021-6f7e-4bbd-b7fc-dc7f588b701c_02-18-week2-PASSING_AND_PASSING,26,0,26
339631880,StuPro-TOSCAna/TOSCAna,24/08/18 06:49,spirals-bears,d3ce7021-6f7e-4bbd-b7fc-dc7f588b701c_02-18-week2-PASSING_AND_PASSING,16,4,20
340520321,StuPro-TOSCAna/TOSCAna,24/08/18 06:49,spirals-bears,d3ce7021-6f7e-4bbd-b7fc-dc7f588b701c_02-18-week2-PASSING_AND_PASSING,22,2,24
340520168,StuPro-TOSCAna/TOSCAna,24/08/18 06:50,spirals-bears,d3ce7021-6f7e-4bbd-b7fc-dc7f588b701c_02-18-week2-PASSING_AND_PASSING,21,0,21
340325670,StuPro-TOSCAna/TOSCAna,24/08/18 06:50,spirals-bears,d3ce7021-6f7e-4bbd-b7fc-dc7f588b701c_02-18-week2-PASSING_AND_PASSING,20,2,22
340558018,StuPro-TOSCAna/TOSCAna,24/08/18 06:50,spirals-bears,d3ce7021-6f7e-4bbd-b7fc-dc7f588b701c_02-18-week2-PASSING_AND_PASSING,23,0,23
340222568,StuPro-TOSCAna/TOSCAna,24/08/18 06:50,spirals-bears,d3ce7021-6f7e-4bbd-b7fc-dc7f588b701c_02-18-week2-PASSING_AND_PASSING,16,0,16
340297308,StuPro-TOSCAna/TOSCAna,24/08/18 06:50,spirals-bears,d3ce7021-6f7e-4bbd-b7fc-dc7f588b701c_02-18-week2-PASSING_AND_PASSING,21,0,21
340325668,StuPro-TOSCAna/TOSCAna,24/08/18 06:51,spirals-bears,d3ce7021-6f7e-4bbd-b7fc-dc7f588b701c_02-18-week2-PASSING_AND_PASSING,25,0,25
339834521,StuPro-TOSCAna/TOSCAna,24/08/18 06:51,spirals-bears,d3ce7021-6f7e-4bbd-b7fc-dc7f588b701c_02-18-week2-PASSING_AND_PASSING,20,2,22
339696402,StuPro-TOSCAna/TOSCAna,24/08/18 06:51,spirals-bears,d3ce7021-6f7e-4bbd-b7fc-dc7f588b701c_02-18-week2-PASSING_AND_PASSING,15,2,17
339822297,StuPro-TOSCAna/TOSCAna,24/08/18 06:51,spirals-bears,d3ce7021-6f7e-4bbd-b7fc-dc7f588b701c_02-18-week2-PASSING_AND_PASSING,18,0,18
339696370,StuPro-TOSCAna/TOSCAna,24/08/18 06:52,spirals-bears,d3ce7021-6f7e-4bbd-b7fc-dc7f588b701c_02-18-week2-PASSING_AND_PASSING,25,0,25
339830116,StuPro-TOSCAna/TOSCAna,24/08/18 06:52,spirals-bears,d3ce7021-6f7e-4bbd-b7fc-dc7f588b701c_02-18-week2-PASSING_AND_PASSING,16,2,18
339688790,StuPro-TOSCAna/TOSCAna,24/08/18 06:52,spirals-bears,d3ce7021-6f7e-4bbd-b7fc-dc7f588b701c_02-18-week2-PASSING_AND_PASSING,16,2,18
339829550,StuPro-TOSCAna/TOSCAna,24/08/18 06:53,spirals-bears,d3ce7021-6f7e-4bbd-b7fc-dc7f588b701c_02-18-week2-PASSING_AND_PASSING,18,0,3,0,95,0,116
340574095,StuPro-TOSCAna/TOSCAna,24/08/18 06:53,spirals-bears,d3ce7021-6f7e-4bbd-b7fc-dc7f588b701c_02-18-week2-PASSING_AND_PASSING,20,0,3,0,256,0,279
339688506,StuPro-TOSCAna/TOSCAna,24/08/18 06:53,spirals-bears,d3ce7021-6f7e-4bbd-b7fc-dc7f588b701c_02-18-week2-PASSING_AND_PASSING,19,0,19
339539411,StuPro-TOSCAna/TOSCAna,24/08/18 06:53,spirals-bears,d3ce7021-6f7e-4bbd-b7fc-dc7f588b701c_02-18-week2-PASSING_AND_PASSING,17,2,19
339399308,StuPro-TOSCAna/TOSCAna,24/08/18 06:53,spirals-bears,d3ce7021-6f7e-4bbd-b7fc-dc7f588b701c_02-18-week2-PASSING_AND_PASSING,19,2,21
339399208,StuPro-TOSCAna/TOSCAna,24/08/18 06:54,spirals-bears,d3ce7021-6f7e-4bbd-b7fc-dc7f588b701c_02-18-week2-PASSING_AND_PASSING,18,0,18
339416909,StuPro-TOSCAna/TOSCAna,24/08/18 06:54,spirals-bears,d3ce7021-6f7e-4bbd-b7fc-dc7f588b701c_02-18-week2-PASSING_AND_PASSING,18,2,20
339229992,StuPro-TOSCAna/TOSCAna,24/08/18 06:54,spirals-bears,d3ce7021-6f7e-4bbd-b7fc-dc7f588b701c_02-18-week2-PASSING_AND_PASSING,18,0,18
339230009,StuPro-TOSCAna/TOSCAna,24/08/18 06:54,spirals-bears,d3ce7021-6f7e-4bbd-b7fc-dc7f588b701c_02-18-week2-PASSING_AND_PASSING,16,2,18
339202005,StuPro-TOSCAna/TOSCAna,24/08/18 06:55,spirals-bears,d3ce7021-6f7e-4bbd-b7fc-dc7f588b701c_02-18-week2-PASSING_AND_PASSING,21,2,23
339494303,StuPro-TOSCAna/TOSCAna,24/08/18 06:55,spirals-bears,d3ce7021-6f7e-4bbd-b7fc-dc7f588b701c_02-18-week2-PASSING_AND_PASSING,19,0,2,1,93,1,116
339673358,StuPro-TOSCAna/TOSCAna,24/08/18 06:55,spirals-bears,d3ce7021-6f7e-4bbd-b7fc-dc7f588b701c_02-18-week2-PASSING_AND_PASSING,13,0,2,0,200,0,215
339223421,StuPro-TOSCAna/TOSCAna,24/08/18 06:56,spirals-bears,d3ce7021-6f7e-4bbd-b7fc-dc7f588b701c_02-18-week2-PASSING_AND_PASSING,14,2,16
339221968,StuPro-TOSCAna/TOSCAna,24/08/18 06:56,spirals-bears,d3ce7021-6f7e-4bbd-b7fc-dc7f588b701c_02-18-week2-PASSING_AND_PASSING,16,0,16
338961500,StuPro-TOSCAna/TOSCAna,24/08/18 06:56,spirals-bears,d3ce7021-6f7e-4bbd-b7fc-dc7f588b701c_02-18-week2-PASSING_AND_PASSING,14,0,14
338961663,StuPro-TOSCAna/TOSCAna,24/08/18 06:56,spirals-bears,d3ce7021-6f7e-4bbd-b7fc-dc7f588b701c_02-18-week2-PASSING_AND_PASSING,19,2,21
338993749,StuPro-TOSCAna/TOSCAna,24/08/18 06:56,spirals-bears,d3ce7021-6f7e-4bbd-b7fc-dc7f588b701c_02-18-week2-PASSING_AND_PASSING,13,0,13
338993759,StuPro-TOSCAna/TOSCAna,24/08/18 06:56,spirals-bears,d3ce7021-6f7e-4bbd-b7fc-dc7f588b701c_02-18-week2-PASSING_AND_PASSING,15,2,17
338956437,StuPro-TOSCAna/TOSCAna,24/08/18 06:57,spirals-bears,d3ce7021-6f7e-4bbd-b7fc-dc7f588b701c_02-18-week2-PASSING_AND_PASSING,14,0,14
338956444,StuPro-TOSCAna/TOSCAna,24/08/18 06:57,spirals-bears,d3ce7021-6f7e-4bbd-b7fc-dc7f588b701c_02-18-week2-PASSING_AND_PASSING,17,2,19
339075885,StuPro-TOSCAna/TOSCAna,24/08/18 06:58,spirals-bears,d3ce7021-6f7e-4bbd-b7fc-dc7f588b701c_02-18-week2-PASSING_AND_PASSING,15,0,2,1,96,1,115
339226831,StuPro-TOSCAna/TOSCAna,24/08/18 07:01,spirals-bears,d3ce7021-6f7e-4bbd-b7fc-dc7f588b701c_02-18-week2-PASSING_AND_PASSING,11,0,0,123,0,2,2,0,120,0,0,25,0,16,3,97,399
338163220,StuPro-TOSCAna/TOSCAna,24/08/18 07:01,spirals-bears,d3ce7021-6f7e-4bbd-b7fc-dc7f588b701c_02-18-week2-PASSING_AND_PASSING,18,0,2,0,202,1,223
338734099,StuPro-TOSCAna/TOSCAna,24/08/18 07:03,spirals-bears,d3ce7021-6f7e-4bbd-b7fc-dc7f588b701c_02-18-week2-PASSING_AND_PASSING,10,0,0,124,0,2,4,0,121,0,0,27,0,14,2,94,398
341145504,languagetool-org/languagetool,24/08/18 07:07,spirals-bears,d3ce7021-6f7e-4bbd-b7fc-dc7f588b701c_02-18-week2-PASSING_AND_PASSING,275,0,3,2,49,1,330
341436619,languagetool-org/languagetool,24/08/18 07:17,spirals-bears,d3ce7021-6f7e-4bbd-b7fc-dc7f588b701c_02-18-week2-PASSING_AND_PASSING,288,0,743,0,1,103,0,3,1138
341158088,languagetool-org/languagetool,24/08/18 07:21,spirals-bears,d3ce7021-6f7e-4bbd-b7fc-dc7f588b701c_02-18-week2-PASSING_AND_PASSING,291,0,762,1,1,105,0,3,1163
341060316,languagetool-org/languagetool,24/08/18 07:24,spirals-bears,d3ce7021-6f7e-4bbd-b7fc-dc7f588b701c_02-18-week2-PASSING_AND_PASSING,359,0,769,0,6,100,0,6,1240
339224368,languagetool-org/languagetool,24/08/18 07:29,spirals-bears,d3ce7021-6f7e-4bbd-b7fc-dc7f588b701c_02-18-week2-PASSING_AND_PASSING,278,0,1,1,24,3,307
340081033,languagetool-org/languagetool,24/08/18 07:34,spirals-bears,d3ce7021-6f7e-4bbd-b7fc-dc7f588b701c_02-18-week2-PASSING_AND_PASSING,9,37,0,0,29,196,0,0,36,0,749,0,0,0,67,0,286,34,34,105,1582
337937230,apache/incubator-dubbo,24/08/18 07:34,spirals-bears,d3ce7021-6f7e-4bbd-b7fc-dc7f588b701c_02-18-week2-PASSING_AND_PASSING,8,0,8
340466916,apache/incubator-dubbo,24/08/18 07:39,spirals-bears,d3ce7021-6f7e-4bbd-b7fc-dc7f588b701c_02-18-week2-PASSING_AND_PASSING,9,0,202,1,0,372,0,1,585
339537420,ga4gh/dockstore,24/08/18 07:40,spirals-bears,d3ce7021-6f7e-4bbd-b7fc-dc7f588b701c_02-18-week2-PASSING_AND_PASSING,10,0,10
339950589,languagetool-org/languagetool,24/08/18 07:40,spirals-bears,d3ce7021-6f7e-4bbd-b7fc-dc7f588b701c_02-18-week2-PASSING_AND_PASSING,272,0,776,0,1,104,0,3,1156
337430736,apache/incubator-dubbo,24/08/18 07:44,spirals-bears,d3ce7021-6f7e-4bbd-b7fc-dc7f588b701c_02-18-week2-PASSING_AND_PASSING,8,0,187,1,5,336,0,5,542
339652396,ga4gh/dockstore,24/08/18 07:44,spirals-bears,d3ce7021-6f7e-4bbd-b7fc-dc7f588b701c_02-18-week2-PASSING_AND_PASSING,8,0,8
339631088,ga4gh/dockstore,24/08/18 07:44,spirals-bears,d3ce7021-6f7e-4bbd-b7fc-dc7f588b701c_02-18-week2-PASSING_AND_PASSING,8,0,8
339209218,ga4gh/dockstore,24/08/18 07:44,spirals-bears,d3ce7021-6f7e-4bbd-b7fc-dc7f588b701c_02-18-week2-PASSING_AND_PASSING,9,0,9
339142505,ga4gh/dockstore,24/08/18 07:45,spirals-bears,d3ce7021-6f7e-4bbd-b7fc-dc7f588b701c_02-18-week2-PASSING_AND_PASSING,11,0,11
338723096,ga4gh/dockstore,24/08/18 07:45,spirals-bears,d3ce7021-6f7e-4bbd-b7fc-dc7f588b701c_02-18-week2-PASSING_AND_PASSING,9,0,9
338716830,ga4gh/dockstore,24/08/18 07:45,spirals-bears,d3ce7021-6f7e-4bbd-b7fc-dc7f588b701c_02-18-week2-PASSING_AND_PASSING,9,0,9
341495780,apache/jackrabbit-oak,24/08/18 07:48,spirals-bears,d3ce7021-6f7e-4bbd-b7fc-dc7f588b701c_02-18-week2-PASSING_AND_PASSING,38,0,2,1,107,2,150
340035055,languagetool-org/languagetool,24/08/18 07:51,spirals-bears,d3ce7021-6f7e-4bbd-b7fc-dc7f588b701c_02-18-week2-PASSING_AND_PASSING,10,39,0,0,26,576,0,1,35,0,780,0,0,0,65,0,296,36,35,108,2007
338703198,ga4gh/dockstore,24/08/18 07:53,spirals-bears,d3ce7021-6f7e-4bbd-b7fc-dc7f588b701c_02-18-week2-PASSING_AND_PASSING,8,0,0,0,755,0,763
339657068,apache/jackrabbit-oak,24/08/18 07:56,spirals-bears,d3ce7021-6f7e-4bbd-b7fc-dc7f588b701c_02-18-week2-PASSING_AND_PASSING,33,0,2,0,125,2,162
338637674,ga4gh/dockstore,24/08/18 08:04,spirals-bears,d3ce7021-6f7e-4bbd-b7fc-dc7f588b701c_02-18-week2-PASSING_AND_PASSING,9,0,0,0,1422,0,1431
339527931,apache/jackrabbit-oak,24/08/18 08:55,spirals-bears,d3ce7021-6f7e-4bbd-b7fc-dc7f588b701c_02-18-week2-PASSING_AND_PASSING,7,0,0,455,1,2,14,0,1649,1,1,377,0,34,15,449,3005
341320255,apache/jackrabbit-oak,24/08/18 09:00,spirals-bears,d3ce7021-6f7e-4bbd-b7fc-dc7f588b701c_02-18-week2-PASSING_AND_PASSING,10,0,0,1599,4,11,26,0,1715,4,2,374,0,36,18,472,4271
340197602,atomix/atomix,24/08/18 09:00,spirals-bears,d3ce7021-6f7e-4bbd-b7fc-dc7f588b701c_02-18-week2-PASSING_AND_PASSING,11,0,1,4,3,19
340953951,apache/jackrabbit-oak,24/08/18 09:02,spirals-bears,d3ce7021-6f7e-4bbd-b7fc-dc7f588b701c_02-18-week2-PASSING_AND_PASSING,10,0,0,1676,4,2,31,0,1661,0,1,380,0,38,20,448,4271
341382415,resteasy/Resteasy,24/08/18 09:03,spirals-bears,d3ce7021-6f7e-4bbd-b7fc-dc7f588b701c_02-18-week2-PASSING_AND_PASSING,21,2,2,25
341381593,resteasy/Resteasy,24/08/18 09:03,spirals-bears,d3ce7021-6f7e-4bbd-b7fc-dc7f588b701c_02-18-week2-PASSING_AND_PASSING,17,2,1,20
340301228,resteasy/Resteasy,24/08/18 09:04,spirals-bears,d3ce7021-6f7e-4bbd-b7fc-dc7f588b701c_02-18-week2-PASSING_AND_PASSING,19,2,1,22
330913634,resteasy/Resteasy,24/08/18 09:04,spirals-bears,d3ce7021-6f7e-4bbd-b7fc-dc7f588b701c_02-18-week2-PASSING_AND_PASSING,20,2,7,29
338435175,geoserver/geoserver,24/08/18 09:06,spirals-bears,d3ce7021-6f7e-4bbd-b7fc-dc7f588b701c_02-18-week2-PASSING_AND_PASSING,58,9,67
339537566,apache/jackrabbit-oak,24/08/18 09:07,spirals-bears,d3ce7021-6f7e-4bbd-b7fc-dc7f588b701c_02-18-week2-PASSING_AND_PASSING,9,0,0,1692,2,2,28,0,1660,0,1,372,0,35,19,442,4262
340480160,geoserver/geoserver,24/08/18 09:08,spirals-bears,d3ce7021-6f7e-4bbd-b7fc-dc7f588b701c_02-18-week2-PASSING_AND_PASSING,54,0,1,7,14,76
340441082,geoserver/geoserver,24/08/18 09:10,spirals-bears,d3ce7021-6f7e-4bbd-b7fc-dc7f588b701c_02-18-week2-PASSING_AND_PASSING,53,10,63
339627616,atomix/atomix,24/08/18 09:10,spirals-bears,d3ce7021-6f7e-4bbd-b7fc-dc7f588b701c_02-18-week2-PASSING_AND_PASSING,11,0,455,0,0,105,0,0,571
337210346,geoserver/geoserver,24/08/18 09:12,spirals-bears,d3ce7021-6f7e-4bbd-b7fc-dc7f588b701c_02-18-week2-PASSING_AND_PASSING,74,0,1,8,16,99
340854440,geoserver/geoserver,24/08/18 09:14,spirals-bears,d3ce7021-6f7e-4bbd-b7fc-dc7f588b701c_02-18-week2-PASSING_AND_PASSING,56,0,1,4,440,6,507
338451139,geoserver/geoserver,24/08/18 09:19,spirals-bears,d3ce7021-6f7e-4bbd-b7fc-dc7f588b701c_02-18-week2-PASSING_AND_PASSING,54,0,1,2,379,5,441
338279019,geoserver/geoserver,24/08/18 09:36,spirals-bears,d3ce7021-6f7e-4bbd-b7fc-dc7f588b701c_02-18-week2-PASSING_AND_PASSING,9,0,0,411,0,1,29,0,410,1,0,41,1,50,25,548,1526
341356621,aicis/fresco,24/08/18 09:41,spirals-bears,d3ce7021-6f7e-4bbd-b7fc-dc7f588b701c_02-18-week2-PASSING_AND_PASSING,9,0,1453,0,0,104,0,0,1566
338948287,aicis/fresco,24/08/18 09:43,spirals-bears,d3ce7021-6f7e-4bbd-b7fc-dc7f588b701c_02-18-week2-PASSING_AND_PASSING,9,0,0,0,123,0,132
340464840,aicis/fresco,24/08/18 09:52,spirals-bears,d3ce7021-6f7e-4bbd-b7fc-dc7f588b701c_02-18-week2-PASSING_AND_PASSING,8,0,891,0,0,75,0,0,974
341016167,aicis/fresco,24/08/18 09:52,spirals-bears,d3ce7021-6f7e-4bbd-b7fc-dc7f588b701c_02-18-week2-PASSING_AND_PASSING,8,6,0,0,7,282,0,0,4,0,1522,0,0,0,37,0,8,5,5,91,1975
338911513,aicis/fresco,24/08/18 09:53,spirals-bears,d3ce7021-6f7e-4bbd-b7fc-dc7f588b701c_02-18-week2-PASSING_AND_PASSING,9,0,0,0,30,0,39
338538638,aicis/fresco,24/08/18 09:54,spirals-bears,d3ce7021-6f7e-4bbd-b7fc-dc7f588b701c_02-18-week2-PASSING_AND_PASSING,9,0,0,0,29,0,38
340877768,swagger-api/swagger-codegen,24/08/18 09:55,spirals-bears,d3ce7021-6f7e-4bbd-b7fc-dc7f588b701c_02-18-week2-PASSING_AND_PASSING,33,0,0,7,7,47
337364959,swagger-api/swagger-codegen,24/08/18 09:57,spirals-bears,d3ce7021-6f7e-4bbd-b7fc-dc7f588b701c_02-18-week2-PASSING_AND_PASSING,31,0,0,9,105,8,153
339591260,swagger-api/swagger-codegen,24/08/18 10:00,spirals-bears,d3ce7021-6f7e-4bbd-b7fc-dc7f588b701c_02-18-week2-PASSING_AND_PASSING,33,0,0,8,71,7,119
338550041,apache/jackrabbit-oak,24/08/18 10:05,spirals-bears,d3ce7021-6f7e-4bbd-b7fc-dc7f588b701c_02-18-week2-PASSING_AND_PASSING,8,0,0,1687,0,2,18,0,1637,0,1,355,0,37,20,461,4226
340349659,swagger-api/swagger-codegen,24/08/18 10:06,spirals-bears,d3ce7021-6f7e-4bbd-b7fc-dc7f588b701c_02-18-week2-PASSING_AND_PASSING,32,0,48,0,1,267,0,1,349
338719125,swagger-api/swagger-codegen,24/08/18 10:06,spirals-bears,d3ce7021-6f7e-4bbd-b7fc-dc7f588b701c_02-18-week2-PASSING_AND_PASSING,31,0,31
338586479,swagger-api/swagger-codegen,24/08/18 10:06,spirals-bears,d3ce7021-6f7e-4bbd-b7fc-dc7f588b701c_02-18-week2-PASSING_AND_PASSING,31,4,35
338498946,swagger-api/swagger-codegen,24/08/18 10:08,spirals-bears,d3ce7021-6f7e-4bbd-b7fc-dc7f588b701c_02-18-week2-PASSING_AND_PASSING,31,0,0,8,70,6,115
338852566,swagger-api/swagger-codegen,24/08/18 10:08,spirals-bears,d3ce7021-6f7e-4bbd-b7fc-dc7f588b701c_02-18-week2-PASSING_AND_PASSING,30,0,0,1,69,1,101
341163765,spring-cloud/spring-cloud-gcp,24/08/18 10:09,spirals-bears,d3ce7021-6f7e-4bbd-b7fc-dc7f588b701c_02-18-week2-PASSING_AND_PASSING,4,2,6
341581034,spring-cloud/spring-cloud-gcp,24/08/18 10:09,spirals-bears,d3ce7021-6f7e-4bbd-b7fc-dc7f588b701c_02-18-week2-PASSING_AND_PASSING,3,2,5
341523830,spring-cloud/spring-cloud-gcp,24/08/18 10:09,spirals-bears,d3ce7021-6f7e-4bbd-b7fc-dc7f588b701c_02-18-week2-PASSING_AND_PASSING,3,1,4
341521187,spring-cloud/spring-cloud-gcp,24/08/18 10:09,spirals-bears,d3ce7021-6f7e-4bbd-b7fc-dc7f588b701c_02-18-week2-PASSING_AND_PASSING,4,2,6
340718538,spring-cloud/spring-cloud-gcp,24/08/18 10:10,spirals-bears,d3ce7021-6f7e-4bbd-b7fc-dc7f588b701c_02-18-week2-PASSING_AND_PASSING,4,3,7
341151031,spring-cloud/spring-cloud-gcp,24/08/18 10:10,spirals-bears,d3ce7021-6f7e-4bbd-b7fc-dc7f588b701c_02-18-week2-PASSING_AND_PASSING,4,2,6
341107237,spring-cloud/spring-cloud-gcp,24/08/18 10:10,spirals-bears,d3ce7021-6f7e-4bbd-b7fc-dc7f588b701c_02-18-week2-PASSING_AND_PASSING,4,2,6
341060720,spring-cloud/spring-cloud-gcp,24/08/18 10:10,spirals-bears,d3ce7021-6f7e-4bbd-b7fc-dc7f588b701c_02-18-week2-PASSING_AND_PASSING,4,1,5
340993830,spring-cloud/spring-cloud-gcp,24/08/18 10:10,spirals-bears,d3ce7021-6f7e-4bbd-b7fc-dc7f588b701c_02-18-week2-PASSING_AND_PASSING,4,2,6
340683317,spring-cloud/spring-cloud-gcp,24/08/18 10:11,spirals-bears,d3ce7021-6f7e-4bbd-b7fc-dc7f588b701c_02-18-week2-PASSING_AND_PASSING,4,2,6
340712255,spring-cloud/spring-cloud-gcp,24/08/18 10:11,spirals-bears,d3ce7021-6f7e-4bbd-b7fc-dc7f588b701c_02-18-week2-PASSING_AND_PASSING,4,1,5
340706392,spring-cloud/spring-cloud-gcp,24/08/18 10:11,spirals-bears,d3ce7021-6f7e-4bbd-b7fc-dc7f588b701c_02-18-week2-PASSING_AND_PASSING,4,2,6
340674124,spring-cloud/spring-cloud-gcp,24/08/18 10:11,spirals-bears,d3ce7021-6f7e-4bbd-b7fc-dc7f588b701c_02-18-week2-PASSING_AND_PASSING,4,2,6
340257216,spring-cloud/spring-cloud-gcp,24/08/18 10:12,spirals-bears,d3ce7021-6f7e-4bbd-b7fc-dc7f588b701c_02-18-week2-PASSING_AND_PASSING,4,2,6
338911397,aicis/fresco,24/08/18 10:12,spirals-bears,d3ce7021-6f7e-4bbd-b7fc-dc7f588b701c_02-18-week2-PASSING_AND_PASSING,8,0,1597,0,0,119,0,0,1724
339118709,spring-cloud/spring-cloud-gcp,24/08/18 10:19,spirals-bears,d3ce7021-6f7e-4bbd-b7fc-dc7f588b701c_02-18-week2-PASSING_AND_PASSING,4,105,118,0,219,0,446
339574224,spring-cloud/spring-cloud-gcp,24/08/18 10:19,spirals-bears,d3ce7021-6f7e-4bbd-b7fc-dc7f588b701c_02-18-week2-PASSING_AND_PASSING,4,2,6
336771240,spring-cloud/spring-cloud-gcp,24/08/18 10:20,spirals-bears,d3ce7021-6f7e-4bbd-b7fc-dc7f588b701c_02-18-week2-PASSING_AND_PASSING,4,96,108,4,220,3,435
339556422,spring-cloud/spring-cloud-gcp,24/08/18 10:20,spirals-bears,d3ce7021-6f7e-4bbd-b7fc-dc7f588b701c_02-18-week2-PASSING_AND_PASSING,5,2,7
339229062,spring-cloud/spring-cloud-gcp,24/08/18 10:20,spirals-bears,d3ce7021-6f7e-4bbd-b7fc-dc7f588b701c_02-18-week2-PASSING_AND_PASSING,4,2,6
340669825,spring-cloud/spring-cloud-gcp,24/08/18 10:20,spirals-bears,d3ce7021-6f7e-4bbd-b7fc-dc7f588b701c_02-18-week2-PASSING_AND_PASSING,5,106,67,98,0,407,0,0,683
338572097,spring-cloud/spring-cloud-gcp,24/08/18 10:20,spirals-bears,d3ce7021-6f7e-4bbd-b7fc-dc7f588b701c_02-18-week2-PASSING_AND_PASSING,4,2,6
339054167,spring-cloud/spring-cloud-gcp,24/08/18 10:20,spirals-bears,d3ce7021-6f7e-4bbd-b7fc-dc7f588b701c_02-18-week2-PASSING_AND_PASSING,4,3,7
338910584,spring-cloud/spring-cloud-gcp,24/08/18 10:21,spirals-bears,d3ce7021-6f7e-4bbd-b7fc-dc7f588b701c_02-18-week2-PASSING_AND_PASSING,4,3,7
338424047,aicis/fresco,24/08/18 10:22,spirals-bears,d3ce7021-6f7e-4bbd-b7fc-dc7f588b701c_02-18-week2-PASSING_AND_PASSING,8,0,1643,0,0,127,0,0,1778
337761969,spring-cloud/spring-cloud-gcp,24/08/18 10:22,spirals-bears,d3ce7021-6f7e-4bbd-b7fc-dc7f588b701c_02-18-week2-PASSING_AND_PASSING,4,2,6
339029173,spring-cloud/spring-cloud-gcp,24/08/18 10:31,spirals-bears,d3ce7021-6f7e-4bbd-b7fc-dc7f588b701c_02-18-week2-PASSING_AND_PASSING,5,137,242,0,260,0,644
339062561,spring-cloud/spring-cloud-gcp,24/08/18 10:31,spirals-bears,d3ce7021-6f7e-4bbd-b7fc-dc7f588b701c_02-18-week2-PASSING_AND_PASSING,6,106,330,0,223,0,665
338087377,spring-cloud/spring-cloud-gcp,24/08/18 10:34,spirals-bears,d3ce7021-6f7e-4bbd-b7fc-dc7f588b701c_02-18-week2-PASSING_AND_PASSING,4,97,293,0,413,0,807
340838036,apache/incubator-servicecomb-saga,24/08/18 10:41,spirals-bears,d3ce7021-6f7e-4bbd-b7fc-dc7f588b701c_02-18-week2-PASSING_AND_PASSING,5,0,239,4,0,159,0,0,407
339325019,apache/incubator-servicecomb-saga,24/08/18 10:44,spirals-bears,d3ce7021-6f7e-4bbd-b7fc-dc7f588b701c_02-18-week2-PASSING_AND_PASSING,4,0,4,0,120,0,128
340783300,apache/incubator-servicecomb-saga,24/08/18 10:44,spirals-bears,d3ce7021-6f7e-4bbd-b7fc-dc7f588b701c_02-18-week2-PASSING_AND_PASSING,5,3,8
339501434,apache/incubator-servicecomb-saga,24/08/18 10:44,spirals-bears,d3ce7021-6f7e-4bbd-b7fc-dc7f588b701c_02-18-week2-PASSING_AND_PASSING,5,3,8
340152431,RipMeApp/ripme,24/08/18 10:45,spirals-bears,d3ce7021-6f7e-4bbd-b7fc-dc7f588b701c_02-18-week2-PASSING_AND_PASSING,9,0,0,441,0,0,0,857,0,0,9,0,5,0,21,1342
335982047,apache/incubator-servicecomb-saga,24/08/18 10:46,spirals-bears,d3ce7021-6f7e-4bbd-b7fc-dc7f588b701c_02-18-week2-PASSING_AND_PASSING,5,0,4,0,116,0,125
339567996,RipMeApp/ripme,24/08/18 10:47,spirals-bears,d3ce7021-6f7e-4bbd-b7fc-dc7f588b701c_02-18-week2-PASSING_AND_PASSING,4,0,901,0,0,22,0,927
340644026,datastax/java-driver,24/08/18 10:47,spirals-bears,d3ce7021-6f7e-4bbd-b7fc-dc7f588b701c_02-18-week2-PASSING_AND_PASSING,17,2,19
339673985,datastax/java-driver,24/08/18 10:47,spirals-bears,d3ce7021-6f7e-4bbd-b7fc-dc7f588b701c_02-18-week2-PASSING_AND_PASSING,16,0,0,0,0,16
341061372,datastax/java-driver,24/08/18 10:48,spirals-bears,d3ce7021-6f7e-4bbd-b7fc-dc7f588b701c_02-18-week2-PASSING_AND_PASSING,17,0,69,0,0,95,0,0,181
339675574,datastax/java-driver,24/08/18 10:50,spirals-bears,d3ce7021-6f7e-4bbd-b7fc-dc7f588b701c_02-18-week2-PASSING_AND_PASSING,17,0,67,0,0,99,0,0,183
339573719,RipMeApp/ripme,24/08/18 10:51,spirals-bears,d3ce7021-6f7e-4bbd-b7fc-dc7f588b701c_02-18-week2-PASSING_AND_PASSING,9,0,0,308,0,0,0,831,0,0,12,0,5,0,23,1188
339602992,vaadin/vaadin-components-testbench,24/08/18 11:05,spirals-bears,d3ce7021-6f7e-4bbd-b7fc-dc7f588b701c_02-18-week2-PASSING_AND_PASSING,2,0,1,0,904,0,907
339810262,vaadin/vaadin-components-testbench,24/08/18 11:06,spirals-bears,d3ce7021-6f7e-4bbd-b7fc-dc7f588b701c_02-18-week2-PASSING_AND_PASSING,2,0,91,1,0,935,0,0,1029
339823054,vaadin/vaadin-components-testbench,24/08/18 11:06,spirals-bears,d3ce7021-6f7e-4bbd-b7fc-dc7f588b701c_02-18-week2-PASSING_AND_PASSING,2,0,92,1,0,1002,0,0,1097
339409071,vaadin/vaadin-components-testbench,24/08/18 11:06,spirals-bears,d3ce7021-6f7e-4bbd-b7fc-dc7f588b701c_02-18-week2-PASSING_AND_PASSING,2,2,4
339415381,vaadin/vaadin-components-testbench,24/08/18 11:06,spirals-bears,d3ce7021-6f7e-4bbd-b7fc-dc7f588b701c_02-18-week2-PASSING_AND_PASSING,2,2,4
339411708,vaadin/vaadin-components-testbench,24/08/18 11:06,spirals-bears,d3ce7021-6f7e-4bbd-b7fc-dc7f588b701c_02-18-week2-PASSING_AND_PASSING,2,2,4
339408293,vaadin/vaadin-components-testbench,24/08/18 11:07,spirals-bears,d3ce7021-6f7e-4bbd-b7fc-dc7f588b701c_02-18-week2-PASSING_AND_PASSING,2,2,4
339479209,vaadin/vaadin-components-testbench,24/08/18 11:09,spirals-bears,d3ce7021-6f7e-4bbd-b7fc-dc7f588b701c_02-18-week2-PASSING_AND_PASSING,2,0,99,1,0,969,0,0,1071
339439559,vaadin/vaadin-components-testbench,24/08/18 11:24,spirals-bears,d3ce7021-6f7e-4bbd-b7fc-dc7f588b701c_02-18-week2-PASSING_AND_PASSING,2,0,91,1,0,1028,0,0,1122
338971877,vaadin/vaadin-components-testbench,24/08/18 11:25,spirals-bears,d3ce7021-6f7e-4bbd-b7fc-dc7f588b701c_02-18-week2-PASSING_AND_PASSING,3,0,1,3,2,9
339452430,vaadin/vaadin-components-testbench,24/08/18 11:26,spirals-bears,d3ce7021-6f7e-4bbd-b7fc-dc7f588b701c_02-18-week2-PASSING_AND_PASSING,2,0,96,1,0,1161,0,0,1260
338968547,vaadin/vaadin-components-testbench,24/08/18 11:28,spirals-bears,d3ce7021-6f7e-4bbd-b7fc-dc7f588b701c_02-18-week2-PASSING_AND_PASSING,2,0,97,1,0,1013,0,0,1113
341385056,Activiti/activiti-cloud-service-common,24/08/18 11:28,spirals-bears,d3ce7021-6f7e-4bbd-b7fc-dc7f588b701c_02-18-week2-PASSING_AND_PASSING,3,12,15,4,33,2,69
338978868,vaadin/vaadin-components-testbench,24/08/18 11:28,spirals-bears,d3ce7021-6f7e-4bbd-b7fc-dc7f588b701c_02-18-week2-PASSING_AND_PASSING,2,0,99,1,0,1187,0,0,1289
341369139,Activiti/activiti-cloud-service-common,24/08/18 11:29,spirals-bears,d3ce7021-6f7e-4bbd-b7fc-dc7f588b701c_02-18-week2-PASSING_AND_PASSING,2,12,14,0,27,0,55
340686164,cpesch/RouteConverter,24/08/18 11:32,spirals-bears,d3ce7021-6f7e-4bbd-b7fc-dc7f588b701c_02-18-week2-PASSING_AND_PASSING,20,0,52,0,0,170,0,0,242
341356261,dhis2/dhis2-core,24/08/18 11:34,spirals-bears,d3ce7021-6f7e-4bbd-b7fc-dc7f588b701c_02-18-week2-PASSING_AND_PASSING,26,0,0,1,82,2,111
341416286,dhis2/dhis2-core,24/08/18 11:36,spirals-bears,d3ce7021-6f7e-4bbd-b7fc-dc7f588b701c_02-18-week2-PASSING_AND_PASSING,23,0,0,6,88,7,124
341388750,dhis2/dhis2-core,24/08/18 11:39,spirals-bears,d3ce7021-6f7e-4bbd-b7fc-dc7f588b701c_02-18-week2-PASSING_AND_PASSING,25,0,1,6,81,5,118
340995039,dhis2/dhis2-core,24/08/18 11:41,spirals-bears,d3ce7021-6f7e-4bbd-b7fc-dc7f588b701c_02-18-week2-PASSING_AND_PASSING,24,0,1,7,79,6,117
340032284,dhis2/dhis2-core,24/08/18 11:42,spirals-bears,d3ce7021-6f7e-4bbd-b7fc-dc7f588b701c_02-18-week2-PASSING_AND_PASSING,23,0,0,6,10,39
340531016,dhis2/dhis2-core,24/08/18 11:42,spirals-bears,d3ce7021-6f7e-4bbd-b7fc-dc7f588b701c_02-18-week2-PASSING_AND_PASSING,24,0,1,5,10,40
337934049,vaadin/vaadin-components-testbench,24/08/18 11:43,spirals-bears,d3ce7021-6f7e-4bbd-b7fc-dc7f588b701c_02-18-week2-PASSING_AND_PASSING,2,0,92,1,0,988,0,0,1083
340925198,dhis2/dhis2-core,24/08/18 11:45,spirals-bears,d3ce7021-6f7e-4bbd-b7fc-dc7f588b701c_02-18-week2-PASSING_AND_PASSING,24,0,0,7,39,10,80
340601960,dhis2/dhis2-core,24/08/18 11:45,spirals-bears,d3ce7021-6f7e-4bbd-b7fc-dc7f588b701c_02-18-week2-PASSING_AND_PASSING,26,0,0,6,94,6,132
340910448,dhis2/dhis2-core,24/08/18 11:46,spirals-bears,d3ce7021-6f7e-4bbd-b7fc-dc7f588b701c_02-18-week2-PASSING_AND_PASSING,22,0,0,6,40,10,78
339457656,dhis2/dhis2-core,24/08/18 11:46,spirals-bears,d3ce7021-6f7e-4bbd-b7fc-dc7f588b701c_02-18-week2-PASSING_AND_PASSING,23,0,0,8,40,9,80
340522407,dhis2/dhis2-core,24/08/18 11:47,spirals-bears,d3ce7021-6f7e-4bbd-b7fc-dc7f588b701c_02-18-week2-PASSING_AND_PASSING,23,3,26
339002990,dhis2/dhis2-core,24/08/18 11:48,spirals-bears,d3ce7021-6f7e-4bbd-b7fc-dc7f588b701c_02-18-week2-PASSING_AND_PASSING,25,5,30
340894252,dhis2/dhis2-core,24/08/18 11:48,spirals-bears,d3ce7021-6f7e-4bbd-b7fc-dc7f588b701c_02-18-week2-PASSING_AND_PASSING,22,0,1,1,82,2,108
340527582,dhis2/dhis2-core,24/08/18 11:48,spirals-bears,d3ce7021-6f7e-4bbd-b7fc-dc7f588b701c_02-18-week2-PASSING_AND_PASSING,24,7,31
340220064,dhis2/dhis2-core,24/08/18 11:49,spirals-bears,d3ce7021-6f7e-4bbd-b7fc-dc7f588b701c_02-18-week2-PASSING_AND_PASSING,22,8,30
340271350,dhis2/dhis2-core,24/08/18 11:49,spirals-bears,d3ce7021-6f7e-4bbd-b7fc-dc7f588b701c_02-18-week2-PASSING_AND_PASSING,23,3,26
335078874,dhis2/dhis2-core,24/08/18 11:49,spirals-bears,d3ce7021-6f7e-4bbd-b7fc-dc7f588b701c_02-18-week2-PASSING_AND_PASSING,24,5,29
340355420,dhis2/dhis2-core,24/08/18 11:51,spirals-bears,d3ce7021-6f7e-4bbd-b7fc-dc7f588b701c_02-18-week2-PASSING_AND_PASSING,25,0,1,1,82,1,110
340365961,dhis2/dhis2-core,24/08/18 11:52,spirals-bears,d3ce7021-6f7e-4bbd-b7fc-dc7f588b701c_02-18-week2-PASSING_AND_PASSING,26,0,0,5,81,6,118
340355063,dhis2/dhis2-core,24/08/18 11:53,spirals-bears,d3ce7021-6f7e-4bbd-b7fc-dc7f588b701c_02-18-week2-PASSING_AND_PASSING,23,0,0,1,83,2,109
340326525,dhis2/dhis2-core,24/08/18 11:53,spirals-bears,d3ce7021-6f7e-4bbd-b7fc-dc7f588b701c_02-18-week2-PASSING_AND_PASSING,23,0,0,1,79,2,105
339040793,dhis2/dhis2-core,24/08/18 11:54,spirals-bears,d3ce7021-6f7e-4bbd-b7fc-dc7f588b701c_02-18-week2-PASSING_AND_PASSING,25,4,29
337495517,dhis2/dhis2-core,24/08/18 11:55,spirals-bears,d3ce7021-6f7e-4bbd-b7fc-dc7f588b701c_02-18-week2-PASSING_AND_PASSING,25,0,0,7,38,10,80
340138985,dhis2/dhis2-core,24/08/18 11:56,spirals-bears,d3ce7021-6f7e-4bbd-b7fc-dc7f588b701c_02-18-week2-PASSING_AND_PASSING,24,0,1,1,82,3,111
337913186,dhis2/dhis2-core,24/08/18 11:56,spirals-bears,d3ce7021-6f7e-4bbd-b7fc-dc7f588b701c_02-18-week2-PASSING_AND_PASSING,22,3,25
338996444,dhis2/dhis2-core,24/08/18 11:57,spirals-bears,d3ce7021-6f7e-4bbd-b7fc-dc7f588b701c_02-18-week2-PASSING_AND_PASSING,23,0,0,0,81,2,106
338818370,dhis2/dhis2-core,24/08/18 11:58,spirals-bears,d3ce7021-6f7e-4bbd-b7fc-dc7f588b701c_02-18-week2-PASSING_AND_PASSING,23,0,0,1,80,3,107
338328381,dhis2/dhis2-core,24/08/18 11:59,spirals-bears,d3ce7021-6f7e-4bbd-b7fc-dc7f588b701c_02-18-week2-PASSING_AND_PASSING,23,3,26
341378311,debezium/debezium,24/08/18 11:59,spirals-bears,d3ce7021-6f7e-4bbd-b7fc-dc7f588b701c_02-18-week2-PASSING_AND_PASSING,7,0,7
338815864,dhis2/dhis2-core,24/08/18 11:59,spirals-bears,d3ce7021-6f7e-4bbd-b7fc-dc7f588b701c_02-18-week2-PASSING_AND_PASSING,22,0,1,1,79,3,106
341004537,debezium/debezium,24/08/18 12:01,spirals-bears,d3ce7021-6f7e-4bbd-b7fc-dc7f588b701c_02-18-week2-PASSING_AND_PASSING,7,0,1,0,96,0,104
340956148,debezium/debezium,24/08/18 12:02,spirals-bears,d3ce7021-6f7e-4bbd-b7fc-dc7f588b701c_02-18-week2-PASSING_AND_PASSING,7,0,0,0,145,0,152
340944387,debezium/debezium,24/08/18 12:03,spirals-bears,d3ce7021-6f7e-4bbd-b7fc-dc7f588b701c_02-18-week2-PASSING_AND_PASSING,7,0,1,0,100,0,108
340916211,debezium/debezium,24/08/18 12:03,spirals-bears,d3ce7021-6f7e-4bbd-b7fc-dc7f588b701c_02-18-week2-PASSING_AND_PASSING,7,5,12
340077512,debezium/debezium,24/08/18 12:04,spirals-bears,d3ce7021-6f7e-4bbd-b7fc-dc7f588b701c_02-18-week2-PASSING_AND_PASSING,6,4,10
340906791,debezium/debezium,24/08/18 12:04,spirals-bears,d3ce7021-6f7e-4bbd-b7fc-dc7f588b701c_02-18-week2-PASSING_AND_PASSING,6,0,1,3,5,15
340066754,debezium/debezium,24/08/18 12:04,spirals-bears,d3ce7021-6f7e-4bbd-b7fc-dc7f588b701c_02-18-week2-PASSING_AND_PASSING,7,5,12
340862212,debezium/debezium,24/08/18 12:04,spirals-bears,d3ce7021-6f7e-4bbd-b7fc-dc7f588b701c_02-18-week2-PASSING_AND_PASSING,6,0,47,0,0,95,0,0,148
340499985,debezium/debezium,24/08/18 12:05,spirals-bears,d3ce7021-6f7e-4bbd-b7fc-dc7f588b701c_02-18-week2-PASSING_AND_PASSING,7,7,14
340439294,debezium/debezium,24/08/18 12:06,spirals-bears,d3ce7021-6f7e-4bbd-b7fc-dc7f588b701c_02-18-week2-PASSING_AND_PASSING,6,0,0,4,60,5,75
340078035,debezium/debezium,24/08/18 12:06,spirals-bears,d3ce7021-6f7e-4bbd-b7fc-dc7f588b701c_02-18-week2-PASSING_AND_PASSING,7,0,0,5,70,4,86
333262167,debezium/debezium,24/08/18 12:07,spirals-bears,d3ce7021-6f7e-4bbd-b7fc-dc7f588b701c_02-18-week2-PASSING_AND_PASSING,6,0,0,5,5,16
336110410,debezium/debezium,24/08/18 12:07,spirals-bears,d3ce7021-6f7e-4bbd-b7fc-dc7f588b701c_02-18-week2-PASSING_AND_PASSING,6,0,0,4,5,15
340403844,debezium/debezium,24/08/18 12:08,spirals-bears,d3ce7021-6f7e-4bbd-b7fc-dc7f588b701c_02-18-week2-PASSING_AND_PASSING,7,0,0,5,55,6,73
339502405,debezium/debezium,24/08/18 12:08,spirals-bears,d3ce7021-6f7e-4bbd-b7fc-dc7f588b701c_02-18-week2-PASSING_AND_PASSING,6,4,10
335205654,debezium/debezium,24/08/18 12:08,spirals-bears,d3ce7021-6f7e-4bbd-b7fc-dc7f588b701c_02-18-week2-PASSING_AND_PASSING,7,3,10
339486553,debezium/debezium,24/08/18 12:09,spirals-bears,d3ce7021-6f7e-4bbd-b7fc-dc7f588b701c_02-18-week2-PASSING_AND_PASSING,6,0,0,0,125,0,131
340923774,MyCoRe-Org/mycore,24/08/18 12:10,spirals-bears,d3ce7021-6f7e-4bbd-b7fc-dc7f588b701c_02-18-week2-PASSING_AND_PASSING,80,0,80
340923782,MyCoRe-Org/mycore,24/08/18 12:11,spirals-bears,d3ce7021-6f7e-4bbd-b7fc-dc7f588b701c_02-18-week2-PASSING_AND_PASSING,57,3,60
340333653,fabric8io/fabric8-maven-plugin,24/08/18 12:18,spirals-bears,d3ce7021-6f7e-4bbd-b7fc-dc7f588b701c_02-18-week2-PASSING_AND_PASSING,31,0,120,2,0,283,0,0,436
338921277,fabric8io/fabric8-maven-plugin,24/08/18 12:18,spirals-bears,d3ce7021-6f7e-4bbd-b7fc-dc7f588b701c_02-18-week2-PASSING_AND_PASSING,33,0,121,2,6,321,0,7,490
338957442,fabric8io/fabric8-maven-plugin,24/08/18 12:19,spirals-bears,d3ce7021-6f7e-4bbd-b7fc-dc7f588b701c_02-18-week2-PASSING_AND_PASSING,31,0,2,5,7,45
337642528,Activiti/Activiti,24/08/18 12:20,spirals-bears,d3ce7021-6f7e-4bbd-b7fc-dc7f588b701c_02-18-week2-PASSING_AND_PASSING,43,0,2,1,17,4,67
337707633,Activiti/Activiti,24/08/18 12:21,spirals-bears,d3ce7021-6f7e-4bbd-b7fc-dc7f588b701c_02-18-week2-PASSING_AND_PASSING,31,0,2,1,15,4,53
339829949,zalando/zalenium,24/08/18 12:24,spirals-bears,d3ce7021-6f7e-4bbd-b7fc-dc7f588b701c_02-18-week2-PASSING_AND_PASSING,5,0,118,0,0,34,0,0,157
340966727,B3Partners/brmo,24/08/18 12:26,spirals-bears,d3ce7021-6f7e-4bbd-b7fc-dc7f588b701c_02-18-week2-PASSING_AND_PASSING,76,3,79
337910492,fabric8io/fabric8-maven-plugin,24/08/18 12:26,spirals-bears,d3ce7021-6f7e-4bbd-b7fc-dc7f588b701c_02-18-week2-PASSING_AND_PASSING,52,0,123,2,0,283,0,0,460
340966684,B3Partners/brmo,24/08/18 12:27,spirals-bears,d3ce7021-6f7e-4bbd-b7fc-dc7f588b701c_02-18-week2-PASSING_AND_PASSING,73,0,73
337650062,B3Partners/brmo,24/08/18 12:27,spirals-bears,d3ce7021-6f7e-4bbd-b7fc-dc7f588b701c_02-18-week2-PASSING_AND_PASSING,74,0,0,0,3,77
340638467,B3Partners/brmo,24/08/18 12:28,spirals-bears,d3ce7021-6f7e-4bbd-b7fc-dc7f588b701c_02-18-week2-PASSING_AND_PASSING,74,0,74
340638419,B3Partners/brmo,24/08/18 12:29,spirals-bears,d3ce7021-6f7e-4bbd-b7fc-dc7f588b701c_02-18-week2-PASSING_AND_PASSING,73,3,76
340994272,jnidzwetzki/bboxdb,24/08/18 12:30,spirals-bears,d3ce7021-6f7e-4bbd-b7fc-dc7f588b701c_02-18-week2-PASSING_AND_PASSING,9,0,0,0,31,0,40
341440053,MariaDB/mariadb-connector-j,24/08/18 12:30,spirals-bears,d3ce7021-6f7e-4bbd-b7fc-dc7f588b701c_02-18-week2-PASSING_AND_PASSING,10,0,0,1788,0,0,1,0,1788,0,0,30,0,10,1,59,3687
340687699,jnidzwetzki/bboxdb,24/08/18 12:30,spirals-bears,d3ce7021-6f7e-4bbd-b7fc-dc7f588b701c_02-18-week2-PASSING_AND_PASSING,9,0,0,0,24,0,33
339002157,MariaDB/mariadb-connector-j,24/08/18 12:30,spirals-bears,d3ce7021-6f7e-4bbd-b7fc-dc7f588b701c_02-18-week2-PASSING_AND_PASSING,9,0,0,1788,0,0,1,0,1789,0,0,32,0,9,1,56,3685
340555291,jnidzwetzki/bboxdb,24/08/18 12:31,spirals-bears,d3ce7021-6f7e-4bbd-b7fc-dc7f588b701c_02-18-week2-PASSING_AND_PASSING,9,0,1,0,31,0,41
281201149,jacoco/jacoco,24/08/18 12:31,spirals-bears,d3ce7021-6f7e-4bbd-b7fc-dc7f588b701c_02-18-week2-PASSING_AND_PASSING,6,0,6
340514357,jnidzwetzki/bboxdb,24/08/18 12:31,spirals-bears,d3ce7021-6f7e-4bbd-b7fc-dc7f588b701c_02-18-week2-PASSING_AND_PASSING,9,0,0,0,33,0,42
340104358,jnidzwetzki/bboxdb,24/08/18 12:31,spirals-bears,d3ce7021-6f7e-4bbd-b7fc-dc7f588b701c_02-18-week2-PASSING_AND_PASSING,8,0,0,0,34,0,42
281201170,jacoco/jacoco,24/08/18 12:32,spirals-bears,d3ce7021-6f7e-4bbd-b7fc-dc7f588b701c_02-18-week2-PASSING_AND_PASSING,7,3,10
340031559,jacoco/jacoco,24/08/18 12:32,spirals-bears,d3ce7021-6f7e-4bbd-b7fc-dc7f588b701c_02-18-week2-PASSING_AND_PASSING,6,0,1,0,7
340031683,jacoco/jacoco,24/08/18 12:32,spirals-bears,d3ce7021-6f7e-4bbd-b7fc-dc7f588b701c_02-18-week2-PASSING_AND_PASSING,7,2,9
340031669,jacoco/jacoco,24/08/18 12:32,spirals-bears,d3ce7021-6f7e-4bbd-b7fc-dc7f588b701c_02-18-week2-PASSING_AND_PASSING,6,0,6
340001974,jacoco/jacoco,24/08/18 12:32,spirals-bears,d3ce7021-6f7e-4bbd-b7fc-dc7f588b701c_02-18-week2-PASSING_AND_PASSING,6,2,8
340001958,jacoco/jacoco,24/08/18 12:32,spirals-bears,d3ce7021-6f7e-4bbd-b7fc-dc7f588b701c_02-18-week2-PASSING_AND_PASSING,8,0,8
339974750,jacoco/jacoco,24/08/18 12:32,spirals-bears,d3ce7021-6f7e-4bbd-b7fc-dc7f588b701c_02-18-week2-PASSING_AND_PASSING,6,0,6
339996541,jacoco/jacoco,24/08/18 12:32,spirals-bears,d3ce7021-6f7e-4bbd-b7fc-dc7f588b701c_02-18-week2-PASSING_AND_PASSING,8,2,10
339996523,jacoco/jacoco,24/08/18 12:32,spirals-bears,d3ce7021-6f7e-4bbd-b7fc-dc7f588b701c_02-18-week2-PASSING_AND_PASSING,10,0,10
339974767,jacoco/jacoco,24/08/18 12:33,spirals-bears,d3ce7021-6f7e-4bbd-b7fc-dc7f588b701c_02-18-week2-PASSING_AND_PASSING,6,2,8
339965361,jacoco/jacoco,24/08/18 12:33,spirals-bears,d3ce7021-6f7e-4bbd-b7fc-dc7f588b701c_02-18-week2-PASSING_AND_PASSING,6,0,6
339965489,jacoco/jacoco,24/08/18 12:33,spirals-bears,d3ce7021-6f7e-4bbd-b7fc-dc7f588b701c_02-18-week2-PASSING_AND_PASSING,6,2,8
339954788,jacoco/jacoco,24/08/18 12:33,spirals-bears,d3ce7021-6f7e-4bbd-b7fc-dc7f588b701c_02-18-week2-PASSING_AND_PASSING,5,0,5
330364530,4Science/DSpace,24/08/18 12:34,spirals-bears,d3ce7021-6f7e-4bbd-b7fc-dc7f588b701c_02-18-week2-PASSING_AND_PASSING,63,0,3,66
341119298,jnidzwetzki/bboxdb,24/08/18 12:34,spirals-bears,d3ce7021-6f7e-4bbd-b7fc-dc7f588b701c_02-18-week2-PASSING_AND_PASSING,6,0,0,40,0,0,1,0,38,0,0,75,0,10,2,143,315
