338083205,apache/flink,22/08/18 13:52,spirals-bears,115b89a2-5f2f-4a9f-a894-a9ee1a0dcd59_02-18-week1-PASSING_AND_PASSING,71,6,77
337131360,apache/flink,22/08/18 13:52,spirals-bears,115b89a2-5f2f-4a9f-a894-a9ee1a0dcd59_02-18-week1-PASSING_AND_PASSING,64,0,2,6,9,81
335251261,apache/flink,22/08/18 13:54,spirals-bears,115b89a2-5f2f-4a9f-a894-a9ee1a0dcd59_02-18-week1-PASSING_AND_PASSING,61,6,67
338098975,apache/flink,22/08/18 13:54,spirals-bears,115b89a2-5f2f-4a9f-a894-a9ee1a0dcd59_02-18-week1-PASSING_AND_PASSING,63,0,2,1,124,3,193
337956401,apache/flink,22/08/18 13:55,spirals-bears,115b89a2-5f2f-4a9f-a894-a9ee1a0dcd59_02-18-week1-PASSING_AND_PASSING,71,0,2,1,156,2,232
334645686,apache/flink,22/08/18 13:55,spirals-bears,115b89a2-5f2f-4a9f-a894-a9ee1a0dcd59_02-18-week1-PASSING_AND_PASSING,60,8,68
334645090,apache/flink,22/08/18 13:56,spirals-bears,115b89a2-5f2f-4a9f-a894-a9ee1a0dcd59_02-18-week1-PASSING_AND_PASSING,63,8,71
337922857,apache/flink,22/08/18 13:56,spirals-bears,115b89a2-5f2f-4a9f-a894-a9ee1a0dcd59_02-18-week1-PASSING_AND_PASSING,60,0,3,1,159,2,225
334644021,apache/flink,22/08/18 13:57,spirals-bears,115b89a2-5f2f-4a9f-a894-a9ee1a0dcd59_02-18-week1-PASSING_AND_PASSING,71,6,77
337214453,apache/flink,22/08/18 14:00,spirals-bears,115b89a2-5f2f-4a9f-a894-a9ee1a0dcd59_02-18-week1-PASSING_AND_PASSING,61,0,1,8,125,8,203
336431214,apache/flink,22/08/18 14:01,spirals-bears,115b89a2-5f2f-4a9f-a894-a9ee1a0dcd59_02-18-week1-PASSING_AND_PASSING,61,4,65
336854229,apache/flink,22/08/18 14:03,spirals-bears,115b89a2-5f2f-4a9f-a894-a9ee1a0dcd59_02-18-week1-PASSING_AND_PASSING,62,5,67
335618436,apache/flink,22/08/18 14:04,spirals-bears,115b89a2-5f2f-4a9f-a894-a9ee1a0dcd59_02-18-week1-PASSING_AND_PASSING,62,0,1,5,9,77
336460616,apache/flink,22/08/18 14:06,spirals-bears,115b89a2-5f2f-4a9f-a894-a9ee1a0dcd59_02-18-week1-PASSING_AND_PASSING,60,0,1,6,10,77
336590188,apache/flink,22/08/18 14:11,spirals-bears,115b89a2-5f2f-4a9f-a894-a9ee1a0dcd59_02-18-week1-PASSING_AND_PASSING,65,0,2,1,813,2,883
337608432,apache/flink,22/08/18 14:12,spirals-bears,115b89a2-5f2f-4a9f-a894-a9ee1a0dcd59_02-18-week1-PASSING_AND_PASSING,69,0,1,2,889,2,963
336431101,apache/flink,22/08/18 14:13,spirals-bears,115b89a2-5f2f-4a9f-a894-a9ee1a0dcd59_02-18-week1-PASSING_AND_PASSING,68,4,72
335552463,apache/flink,22/08/18 14:17,spirals-bears,115b89a2-5f2f-4a9f-a894-a9ee1a0dcd59_02-18-week1-PASSING_AND_PASSING,63,0,2,8,124,12,209
335707630,apache/flink,22/08/18 14:22,spirals-bears,115b89a2-5f2f-4a9f-a894-a9ee1a0dcd59_02-18-week1-PASSING_AND_PASSING,62,0,2,8,200,8,280
336139252,apache/flink,22/08/18 14:24,spirals-bears,115b89a2-5f2f-4a9f-a894-a9ee1a0dcd59_02-18-week1-PASSING_AND_PASSING,66,0,4,7,11,88
335061187,apache/flink,22/08/18 14:25,spirals-bears,115b89a2-5f2f-4a9f-a894-a9ee1a0dcd59_02-18-week1-PASSING_AND_PASSING,62,7,69
333193040,apache/flink,22/08/18 14:26,spirals-bears,115b89a2-5f2f-4a9f-a894-a9ee1a0dcd59_02-18-week1-PASSING_AND_PASSING,60,4,64
338638523,prestodb/presto,22/08/18 14:27,spirals-bears,115b89a2-5f2f-4a9f-a894-a9ee1a0dcd59_02-18-week1-PASSING_AND_PASSING,42,6,48
338255271,prestodb/presto,22/08/18 14:32,spirals-bears,115b89a2-5f2f-4a9f-a894-a9ee1a0dcd59_02-18-week1-PASSING_AND_PASSING,45,0,1,0,202,1,249
337891396,apache/flink,22/08/18 14:37,spirals-bears,115b89a2-5f2f-4a9f-a894-a9ee1a0dcd59_02-18-week1-PASSING_AND_PASSING,9,0,1,52,0,1,53,0,42,1,1,746,1,61,34,1508,2510
338208210,prestodb/presto,22/08/18 14:39,spirals-bears,115b89a2-5f2f-4a9f-a894-a9ee1a0dcd59_02-18-week1-PASSING_AND_PASSING,49,0,2,5,7,63
335662881,apache/flink,22/08/18 14:46,spirals-bears,115b89a2-5f2f-4a9f-a894-a9ee1a0dcd59_02-18-week1-PASSING_AND_PASSING,10,0,1,45,0,1,75,4,56,2,1,611,1,80,35,1476,2398
337628481,prestodb/presto,22/08/18 14:47,spirals-bears,115b89a2-5f2f-4a9f-a894-a9ee1a0dcd59_02-18-week1-PASSING_AND_PASSING,43,9,52
336451149,apache/flink,22/08/18 14:54,spirals-bears,115b89a2-5f2f-4a9f-a894-a9ee1a0dcd59_02-18-week1-PASSING_AND_PASSING,8,0,1,50,1,1,101,0,44,2,1,681,1,71,37,1537,2536
336604085,prestodb/presto,22/08/18 14:57,spirals-bears,115b89a2-5f2f-4a9f-a894-a9ee1a0dcd59_02-18-week1-PASSING_AND_PASSING,42,0,1,1,103,5,152
335928943,prestodb/presto,22/08/18 15:01,spirals-bears,115b89a2-5f2f-4a9f-a894-a9ee1a0dcd59_02-18-week1-PASSING_AND_PASSING,43,0,1,1,178,1,224
338255081,prestodb/presto,22/08/18 15:01,spirals-bears,115b89a2-5f2f-4a9f-a894-a9ee1a0dcd59_02-18-week1-PASSING_AND_PASSING,43,0,789,2,1,931,2,1768
335440934,prestodb/presto,22/08/18 15:02,spirals-bears,115b89a2-5f2f-4a9f-a894-a9ee1a0dcd59_02-18-week1-PASSING_AND_PASSING,46,5,51
336329653,prestodb/presto,22/08/18 15:03,spirals-bears,115b89a2-5f2f-4a9f-a894-a9ee1a0dcd59_02-18-week1-PASSING_AND_PASSING,48,9,57
336660241,prestodb/presto,22/08/18 15:03,spirals-bears,115b89a2-5f2f-4a9f-a894-a9ee1a0dcd59_02-18-week1-PASSING_AND_PASSING,45,4,49
335994850,prestodb/presto,22/08/18 15:04,spirals-bears,115b89a2-5f2f-4a9f-a894-a9ee1a0dcd59_02-18-week1-PASSING_AND_PASSING,45,6,51
337941348,prestodb/presto,22/08/18 15:08,spirals-bears,115b89a2-5f2f-4a9f-a894-a9ee1a0dcd59_02-18-week1-PASSING_AND_PASSING,45,0,780,2,1,932,2,1762
335856472,prestodb/presto,22/08/18 15:16,spirals-bears,115b89a2-5f2f-4a9f-a894-a9ee1a0dcd59_02-18-week1-PASSING_AND_PASSING,59,0,1,0,716,2,778
337908842,prestodb/presto,22/08/18 15:16,spirals-bears,115b89a2-5f2f-4a9f-a894-a9ee1a0dcd59_02-18-week1-PASSING_AND_PASSING,47,0,777,2,1,902,1,1730
335631034,apache/incubator-druid,22/08/18 15:18,spirals-bears,115b89a2-5f2f-4a9f-a894-a9ee1a0dcd59_02-18-week1-PASSING_AND_PASSING,80,4,84
334856101,apache/incubator-druid,22/08/18 15:19,spirals-bears,115b89a2-5f2f-4a9f-a894-a9ee1a0dcd59_02-18-week1-PASSING_AND_PASSING,37,0,1,8,96,10,152
335403443,apache/incubator-druid,22/08/18 15:20,spirals-bears,115b89a2-5f2f-4a9f-a894-a9ee1a0dcd59_02-18-week1-PASSING_AND_PASSING,48,0,1,9,94,14,166
338147904,apache/incubator-druid,22/08/18 15:23,spirals-bears,115b89a2-5f2f-4a9f-a894-a9ee1a0dcd59_02-18-week1-PASSING_AND_PASSING,38,0,1,0,148,2,189
331390161,apache/incubator-druid,22/08/18 15:23,spirals-bears,115b89a2-5f2f-4a9f-a894-a9ee1a0dcd59_02-18-week1-PASSING_AND_PASSING,37,0,1,7,93,8,146
338106814,apache/incubator-druid,22/08/18 15:24,spirals-bears,115b89a2-5f2f-4a9f-a894-a9ee1a0dcd59_02-18-week1-PASSING_AND_PASSING,41,21,62
337704265,apache/incubator-druid,22/08/18 15:26,spirals-bears,115b89a2-5f2f-4a9f-a894-a9ee1a0dcd59_02-18-week1-PASSING_AND_PASSING,64,8,72
336491400,apache/incubator-druid,22/08/18 15:27,spirals-bears,115b89a2-5f2f-4a9f-a894-a9ee1a0dcd59_02-18-week1-PASSING_AND_PASSING,38,8,46
337819592,apache/incubator-druid,22/08/18 15:29,spirals-bears,115b89a2-5f2f-4a9f-a894-a9ee1a0dcd59_02-18-week1-PASSING_AND_PASSING,56,0,1,7,142,12,218
336813194,apache/incubator-druid,22/08/18 15:31,spirals-bears,115b89a2-5f2f-4a9f-a894-a9ee1a0dcd59_02-18-week1-PASSING_AND_PASSING,44,0,4,11,137,36,232
333992603,apache/incubator-druid,22/08/18 15:32,spirals-bears,115b89a2-5f2f-4a9f-a894-a9ee1a0dcd59_02-18-week1-PASSING_AND_PASSING,55,0,1,8,92,11,167
337532858,apache/incubator-druid,22/08/18 15:32,spirals-bears,115b89a2-5f2f-4a9f-a894-a9ee1a0dcd59_02-18-week1-PASSING_AND_PASSING,34,11,45
336373417,apache/incubator-druid,22/08/18 15:35,spirals-bears,115b89a2-5f2f-4a9f-a894-a9ee1a0dcd59_02-18-week1-PASSING_AND_PASSING,44,0,1,6,94,8,153
336668230,apache/incubator-druid,22/08/18 15:36,spirals-bears,115b89a2-5f2f-4a9f-a894-a9ee1a0dcd59_02-18-week1-PASSING_AND_PASSING,37,0,1,1,153,2,194
336387107,apache/incubator-druid,22/08/18 15:38,spirals-bears,115b89a2-5f2f-4a9f-a894-a9ee1a0dcd59_02-18-week1-PASSING_AND_PASSING,56,0,0,0,150,2,208
336192156,apache/incubator-druid,22/08/18 15:39,spirals-bears,115b89a2-5f2f-4a9f-a894-a9ee1a0dcd59_02-18-week1-PASSING_AND_PASSING,35,0,0,1,151,2,189
336304935,apache/incubator-druid,22/08/18 15:40,spirals-bears,115b89a2-5f2f-4a9f-a894-a9ee1a0dcd59_02-18-week1-PASSING_AND_PASSING,47,0,1,6,12,66
335931361,apache/incubator-druid,22/08/18 15:41,spirals-bears,115b89a2-5f2f-4a9f-a894-a9ee1a0dcd59_02-18-week1-PASSING_AND_PASSING,36,9,45
333927252,apache/incubator-druid,22/08/18 15:41,spirals-bears,115b89a2-5f2f-4a9f-a894-a9ee1a0dcd59_02-18-week1-PASSING_AND_PASSING,43,0,1,13,100,8,165
335834615,apache/incubator-druid,22/08/18 15:44,spirals-bears,115b89a2-5f2f-4a9f-a894-a9ee1a0dcd59_02-18-week1-PASSING_AND_PASSING,47,0,1,6,94,13,161
336679030,thelastpickle/cassandra-reaper,22/08/18 15:44,spirals-bears,115b89a2-5f2f-4a9f-a894-a9ee1a0dcd59_02-18-week1-PASSING_AND_PASSING,6,0,6
335822079,thelastpickle/cassandra-reaper,22/08/18 15:46,spirals-bears,115b89a2-5f2f-4a9f-a894-a9ee1a0dcd59_02-18-week1-PASSING_AND_PASSING,8,0,0,0,49,1,58
336578108,thelastpickle/cassandra-reaper,22/08/18 15:46,spirals-bears,115b89a2-5f2f-4a9f-a894-a9ee1a0dcd59_02-18-week1-PASSING_AND_PASSING,10,0,10
336578145,thelastpickle/cassandra-reaper,22/08/18 15:46,spirals-bears,115b89a2-5f2f-4a9f-a894-a9ee1a0dcd59_02-18-week1-PASSING_AND_PASSING,7,2,9
338705374,apache/incubator-druid,22/08/18 16:13,spirals-bears,115b89a2-5f2f-4a9f-a894-a9ee1a0dcd59_02-18-week1-PASSING_AND_PASSING,9,0,2,1491,2,1,20,0,1601,1,1,356,5,49,16,535,4089
338281419,apache/incubator-druid,22/08/18 16:16,spirals-bears,115b89a2-5f2f-4a9f-a894-a9ee1a0dcd59_02-18-week1-PASSING_AND_PASSING,8,0,0,1400,4,1,17,0,1685,5,1,304,0,35,18,544,4022
336370830,JMRI/JMRI,22/08/18 16:25,spirals-bears,115b89a2-5f2f-4a9f-a894-a9ee1a0dcd59_02-18-week1-PASSING_AND_PASSING,362,0,0,12,160,13,547
338545829,JMRI/JMRI,22/08/18 16:27,spirals-bears,115b89a2-5f2f-4a9f-a894-a9ee1a0dcd59_02-18-week1-PASSING_AND_PASSING,18,0,1,1689,1,87,0,2,4,85,1,260,71,227,2446
332831045,JMRI/JMRI,22/08/18 16:33,spirals-bears,115b89a2-5f2f-4a9f-a894-a9ee1a0dcd59_02-18-week1-PASSING_AND_PASSING,268,0,2,13,171,20,474
335355086,apache/incubator-druid,22/08/18 16:48,spirals-bears,115b89a2-5f2f-4a9f-a894-a9ee1a0dcd59_02-18-week1-PASSING_AND_PASSING,8,0,0,1601,2,1,45,0,1379,1,5,335,0,36,16,549,3978
338503889,JMRI/JMRI,22/08/18 16:53,spirals-bears,115b89a2-5f2f-4a9f-a894-a9ee1a0dcd59_02-18-week1-PASSING_AND_PASSING,728,0,1505,0,6,185,2,10,2436
337030677,JMRI/JMRI,22/08/18 17:03,spirals-bears,115b89a2-5f2f-4a9f-a894-a9ee1a0dcd59_02-18-week1-PASSING_AND_PASSING,287,0,1507,0,21,275,10,32,2132
337092358,JMRI/JMRI,22/08/18 17:10,spirals-bears,115b89a2-5f2f-4a9f-a894-a9ee1a0dcd59_02-18-week1-PASSING_AND_PASSING,453,0,1458,1,5,168,9,5,2099
337002097,JMRI/JMRI,22/08/18 17:22,spirals-bears,115b89a2-5f2f-4a9f-a894-a9ee1a0dcd59_02-18-week1-PASSING_AND_PASSING,282,0,1536,1,12,174,8,31,2044
334441546,JMRI/JMRI,22/08/18 17:31,spirals-bears,115b89a2-5f2f-4a9f-a894-a9ee1a0dcd59_02-18-week1-PASSING_AND_PASSING,11,0,4,1461,0,129,0,11,5,88,6,273,71,169,2228
336803510,JMRI/JMRI,22/08/18 17:37,spirals-bears,115b89a2-5f2f-4a9f-a894-a9ee1a0dcd59_02-18-week1-PASSING_AND_PASSING,259,0,1492,0,13,165,8,34,1971
333969731,apache/nifi,22/08/18 17:37,spirals-bears,115b89a2-5f2f-4a9f-a894-a9ee1a0dcd59_02-18-week1-PASSING_AND_PASSING,35,5,40
333521104,JMRI/JMRI,22/08/18 17:55,spirals-bears,115b89a2-5f2f-4a9f-a894-a9ee1a0dcd59_02-18-week1-PASSING_AND_PASSING,16,0,4,1450,0,165,0,10,16,167,5,603,85,168,2689
338681864,apache/nifi,22/08/18 17:57,spirals-bears,115b89a2-5f2f-4a9f-a894-a9ee1a0dcd59_02-18-week1-PASSING_AND_PASSING,33,2,4,1,1456,2,1498
335276102,JMRI/JMRI,22/08/18 18:03,spirals-bears,115b89a2-5f2f-4a9f-a894-a9ee1a0dcd59_02-18-week1-PASSING_AND_PASSING,12,0,9,1568,0,135,0,16,20,88,6,310,58,177,2399
336590491,apache/nifi,22/08/18 18:05,spirals-bears,115b89a2-5f2f-4a9f-a894-a9ee1a0dcd59_02-18-week1-PASSING_AND_PASSING,37,2,4,1,1606,2,1652
338491591,EnMasseProject/enmasse,22/08/18 18:08,spirals-bears,115b89a2-5f2f-4a9f-a894-a9ee1a0dcd59_02-18-week1-PASSING_AND_PASSING,31,0,130,1,1,78,0,1,242
338469547,EnMasseProject/enmasse,22/08/18 18:09,spirals-bears,115b89a2-5f2f-4a9f-a894-a9ee1a0dcd59_02-18-week1-PASSING_AND_PASSING,27,0,122,1,1,72,0,0,223
337976233,EnMasseProject/enmasse,22/08/18 18:12,spirals-bears,115b89a2-5f2f-4a9f-a894-a9ee1a0dcd59_02-18-week1-PASSING_AND_PASSING,27,0,129,1,1,76,0,0,234
338017435,INRIA/spoon,22/08/18 18:13,spirals-bears,115b89a2-5f2f-4a9f-a894-a9ee1a0dcd59_02-18-week1-PASSING_AND_PASSING,11,0,0,417,0,0,5,0,412,0,0,32,0,10,5,60,952
338452566,EnMasseProject/enmasse,22/08/18 18:14,spirals-bears,115b89a2-5f2f-4a9f-a894-a9ee1a0dcd59_02-18-week1-PASSING_AND_PASSING,29,0,130,1,1,73,1,0,235
338397369,EnMasseProject/enmasse,22/08/18 18:16,spirals-bears,115b89a2-5f2f-4a9f-a894-a9ee1a0dcd59_02-18-week1-PASSING_AND_PASSING,27,0,133,1,7,81,0,4,253
338397352,EnMasseProject/enmasse,22/08/18 18:17,spirals-bears,115b89a2-5f2f-4a9f-a894-a9ee1a0dcd59_02-18-week1-PASSING_AND_PASSING,27,0,129,2,1,79,0,0,238
338343030,EnMasseProject/enmasse,22/08/18 18:18,spirals-bears,115b89a2-5f2f-4a9f-a894-a9ee1a0dcd59_02-18-week1-PASSING_AND_PASSING,29,0,128,1,1,76,0,0,235
338342846,EnMasseProject/enmasse,22/08/18 18:18,spirals-bears,115b89a2-5f2f-4a9f-a894-a9ee1a0dcd59_02-18-week1-PASSING_AND_PASSING,29,0,1,5,3,38
338342842,EnMasseProject/enmasse,22/08/18 18:18,spirals-bears,115b89a2-5f2f-4a9f-a894-a9ee1a0dcd59_02-18-week1-PASSING_AND_PASSING,28,0,2,0,0,30
337939571,EnMasseProject/enmasse,22/08/18 18:19,spirals-bears,115b89a2-5f2f-4a9f-a894-a9ee1a0dcd59_02-18-week1-PASSING_AND_PASSING,31,3,34
337939559,EnMasseProject/enmasse,22/08/18 18:19,spirals-bears,115b89a2-5f2f-4a9f-a894-a9ee1a0dcd59_02-18-week1-PASSING_AND_PASSING,26,0,26
337664739,EnMasseProject/enmasse,22/08/18 18:20,spirals-bears,115b89a2-5f2f-4a9f-a894-a9ee1a0dcd59_02-18-week1-PASSING_AND_PASSING,37,3,40
337664640,EnMasseProject/enmasse,22/08/18 18:20,spirals-bears,115b89a2-5f2f-4a9f-a894-a9ee1a0dcd59_02-18-week1-PASSING_AND_PASSING,29,0,29
338343034,EnMasseProject/enmasse,22/08/18 18:21,spirals-bears,115b89a2-5f2f-4a9f-a894-a9ee1a0dcd59_02-18-week1-PASSING_AND_PASSING,48,0,127,2,6,80,0,4,267
337542158,EnMasseProject/enmasse,22/08/18 18:22,spirals-bears,115b89a2-5f2f-4a9f-a894-a9ee1a0dcd59_02-18-week1-PASSING_AND_PASSING,28,3,31
337541240,EnMasseProject/enmasse,22/08/18 18:22,spirals-bears,115b89a2-5f2f-4a9f-a894-a9ee1a0dcd59_02-18-week1-PASSING_AND_PASSING,28,0,28
335819280,apache/nifi,22/08/18 18:24,spirals-bears,115b89a2-5f2f-4a9f-a894-a9ee1a0dcd59_02-18-week1-PASSING_AND_PASSING,39,2,6,1,1622,3,1673
337904290,EnMasseProject/enmasse,22/08/18 18:24,spirals-bears,115b89a2-5f2f-4a9f-a894-a9ee1a0dcd59_02-18-week1-PASSING_AND_PASSING,29,0,128,2,1,81,1,1,243
337963664,EnMasseProject/enmasse,22/08/18 18:24,spirals-bears,115b89a2-5f2f-4a9f-a894-a9ee1a0dcd59_02-18-week1-PASSING_AND_PASSING,32,0,130,1,1,79,0,0,243
337921817,EnMasseProject/enmasse,22/08/18 18:27,spirals-bears,115b89a2-5f2f-4a9f-a894-a9ee1a0dcd59_02-18-week1-PASSING_AND_PASSING,25,0,134,2,7,103,0,6,277
337921815,EnMasseProject/enmasse,22/08/18 18:28,spirals-bears,115b89a2-5f2f-4a9f-a894-a9ee1a0dcd59_02-18-week1-PASSING_AND_PASSING,28,0,132,1,1,84,0,0,246
337898337,EnMasseProject/enmasse,22/08/18 18:28,spirals-bears,115b89a2-5f2f-4a9f-a894-a9ee1a0dcd59_02-18-week1-PASSING_AND_PASSING,30,0,131,1,1,81,0,1,245
337919434,EnMasseProject/enmasse,22/08/18 18:28,spirals-bears,115b89a2-5f2f-4a9f-a894-a9ee1a0dcd59_02-18-week1-PASSING_AND_PASSING,30,0,133,2,1,80,0,1,247
336989529,EnMasseProject/enmasse,22/08/18 18:29,spirals-bears,115b89a2-5f2f-4a9f-a894-a9ee1a0dcd59_02-18-week1-PASSING_AND_PASSING,30,0,30
336989531,EnMasseProject/enmasse,22/08/18 18:29,spirals-bears,115b89a2-5f2f-4a9f-a894-a9ee1a0dcd59_02-18-week1-PASSING_AND_PASSING,32,3,35
337673156,EnMasseProject/enmasse,22/08/18 18:31,spirals-bears,115b89a2-5f2f-4a9f-a894-a9ee1a0dcd59_02-18-week1-PASSING_AND_PASSING,29,0,131,2,1,83,0,1,247
337660275,EnMasseProject/enmasse,22/08/18 18:33,spirals-bears,115b89a2-5f2f-4a9f-a894-a9ee1a0dcd59_02-18-week1-PASSING_AND_PASSING,29,0,131,2,1,83,0,1,247
337545554,EnMasseProject/enmasse,22/08/18 18:34,spirals-bears,115b89a2-5f2f-4a9f-a894-a9ee1a0dcd59_02-18-week1-PASSING_AND_PASSING,28,0,132,2,1,118,0,0,281
337444533,EnMasseProject/enmasse,22/08/18 18:34,spirals-bears,115b89a2-5f2f-4a9f-a894-a9ee1a0dcd59_02-18-week1-PASSING_AND_PASSING,35,0,129,1,6,114,0,4,289
337231726,EnMasseProject/enmasse,22/08/18 18:35,spirals-bears,115b89a2-5f2f-4a9f-a894-a9ee1a0dcd59_02-18-week1-PASSING_AND_PASSING,27,0,2,5,4,38
337232148,EnMasseProject/enmasse,22/08/18 18:35,spirals-bears,115b89a2-5f2f-4a9f-a894-a9ee1a0dcd59_02-18-week1-PASSING_AND_PASSING,29,0,29
337230729,EnMasseProject/enmasse,22/08/18 18:36,spirals-bears,115b89a2-5f2f-4a9f-a894-a9ee1a0dcd59_02-18-week1-PASSING_AND_PASSING,27,0,2,0,1,30
337029893,EnMasseProject/enmasse,22/08/18 18:36,spirals-bears,115b89a2-5f2f-4a9f-a894-a9ee1a0dcd59_02-18-week1-PASSING_AND_PASSING,30,3,33
337441131,EnMasseProject/enmasse,22/08/18 18:36,spirals-bears,115b89a2-5f2f-4a9f-a894-a9ee1a0dcd59_02-18-week1-PASSING_AND_PASSING,29,0,130,2,6,91,0,4,262
337029881,EnMasseProject/enmasse,22/08/18 18:36,spirals-bears,115b89a2-5f2f-4a9f-a894-a9ee1a0dcd59_02-18-week1-PASSING_AND_PASSING,28,0,28
337002528,EnMasseProject/enmasse,22/08/18 18:36,spirals-bears,115b89a2-5f2f-4a9f-a894-a9ee1a0dcd59_02-18-week1-PASSING_AND_PASSING,29,0,29
337006013,EnMasseProject/enmasse,22/08/18 18:37,spirals-bears,115b89a2-5f2f-4a9f-a894-a9ee1a0dcd59_02-18-week1-PASSING_AND_PASSING,30,4,34
317984792,EnMasseProject/enmasse,22/08/18 18:37,spirals-bears,115b89a2-5f2f-4a9f-a894-a9ee1a0dcd59_02-18-week1-PASSING_AND_PASSING,29,0,29
337002533,EnMasseProject/enmasse,22/08/18 18:37,spirals-bears,115b89a2-5f2f-4a9f-a894-a9ee1a0dcd59_02-18-week1-PASSING_AND_PASSING,31,4,35
337232152,EnMasseProject/enmasse,22/08/18 18:37,spirals-bears,115b89a2-5f2f-4a9f-a894-a9ee1a0dcd59_02-18-week1-PASSING_AND_PASSING,29,0,134,2,6,78,0,3,252
317993977,EnMasseProject/enmasse,22/08/18 18:37,spirals-bears,115b89a2-5f2f-4a9f-a894-a9ee1a0dcd59_02-18-week1-PASSING_AND_PASSING,33,3,36
336655070,EnMasseProject/enmasse,22/08/18 18:38,spirals-bears,115b89a2-5f2f-4a9f-a894-a9ee1a0dcd59_02-18-week1-PASSING_AND_PASSING,31,0,31
336069667,EnMasseProject/enmasse,22/08/18 18:38,spirals-bears,115b89a2-5f2f-4a9f-a894-a9ee1a0dcd59_02-18-week1-PASSING_AND_PASSING,32,3,35
336196359,EnMasseProject/enmasse,22/08/18 18:38,spirals-bears,115b89a2-5f2f-4a9f-a894-a9ee1a0dcd59_02-18-week1-PASSING_AND_PASSING,29,3,32
335602581,EnMasseProject/enmasse,22/08/18 18:38,spirals-bears,115b89a2-5f2f-4a9f-a894-a9ee1a0dcd59_02-18-week1-PASSING_AND_PASSING,30,0,30
336106458,EnMasseProject/enmasse,22/08/18 18:39,spirals-bears,115b89a2-5f2f-4a9f-a894-a9ee1a0dcd59_02-18-week1-PASSING_AND_PASSING,31,0,31
336099863,EnMasseProject/enmasse,22/08/18 18:39,spirals-bears,115b89a2-5f2f-4a9f-a894-a9ee1a0dcd59_02-18-week1-PASSING_AND_PASSING,32,0,32
336044251,EnMasseProject/enmasse,22/08/18 18:39,spirals-bears,115b89a2-5f2f-4a9f-a894-a9ee1a0dcd59_02-18-week1-PASSING_AND_PASSING,36,0,36
336051762,EnMasseProject/enmasse,22/08/18 18:40,spirals-bears,115b89a2-5f2f-4a9f-a894-a9ee1a0dcd59_02-18-week1-PASSING_AND_PASSING,29,5,34
336500948,EnMasseProject/enmasse,22/08/18 18:41,spirals-bears,115b89a2-5f2f-4a9f-a894-a9ee1a0dcd59_02-18-week1-PASSING_AND_PASSING,32,0,132,2,1,86,0,1,254
336044611,EnMasseProject/enmasse,22/08/18 18:42,spirals-bears,115b89a2-5f2f-4a9f-a894-a9ee1a0dcd59_02-18-week1-PASSING_AND_PASSING,27,3,30
336049923,EnMasseProject/enmasse,22/08/18 18:43,spirals-bears,115b89a2-5f2f-4a9f-a894-a9ee1a0dcd59_02-18-week1-PASSING_AND_PASSING,28,3,31
336046004,EnMasseProject/enmasse,22/08/18 18:43,spirals-bears,115b89a2-5f2f-4a9f-a894-a9ee1a0dcd59_02-18-week1-PASSING_AND_PASSING,31,0,125,1,2,88,0,1,248
336051086,EnMasseProject/enmasse,22/08/18 18:44,spirals-bears,115b89a2-5f2f-4a9f-a894-a9ee1a0dcd59_02-18-week1-PASSING_AND_PASSING,27,0,130,1,6,79,0,4,247
336044590,EnMasseProject/enmasse,22/08/18 18:44,spirals-bears,115b89a2-5f2f-4a9f-a894-a9ee1a0dcd59_02-18-week1-PASSING_AND_PASSING,33,0,33
336050944,EnMasseProject/enmasse,22/08/18 18:44,spirals-bears,115b89a2-5f2f-4a9f-a894-a9ee1a0dcd59_02-18-week1-PASSING_AND_PASSING,29,0,127,1,1,79,0,0,237
336033713,EnMasseProject/enmasse,22/08/18 18:47,spirals-bears,115b89a2-5f2f-4a9f-a894-a9ee1a0dcd59_02-18-week1-PASSING_AND_PASSING,27,0,134,2,6,83,0,5,257
335652478,EnMasseProject/enmasse,22/08/18 18:48,spirals-bears,115b89a2-5f2f-4a9f-a894-a9ee1a0dcd59_02-18-week1-PASSING_AND_PASSING,27,0,1,0,0,28
335648595,EnMasseProject/enmasse,22/08/18 18:48,spirals-bears,115b89a2-5f2f-4a9f-a894-a9ee1a0dcd59_02-18-week1-PASSING_AND_PASSING,33,0,130,2,1,105,0,1,272
335993153,EnMasseProject/enmasse,22/08/18 18:48,spirals-bears,115b89a2-5f2f-4a9f-a894-a9ee1a0dcd59_02-18-week1-PASSING_AND_PASSING,30,0,130,1,1,99,0,1,262
336033719,EnMasseProject/enmasse,22/08/18 18:48,spirals-bears,115b89a2-5f2f-4a9f-a894-a9ee1a0dcd59_02-18-week1-PASSING_AND_PASSING,30,0,135,2,1,106,1,1,276
335987057,EnMasseProject/enmasse,22/08/18 18:49,spirals-bears,115b89a2-5f2f-4a9f-a894-a9ee1a0dcd59_02-18-week1-PASSING_AND_PASSING,27,0,27
335984327,EnMasseProject/enmasse,22/08/18 18:49,spirals-bears,115b89a2-5f2f-4a9f-a894-a9ee1a0dcd59_02-18-week1-PASSING_AND_PASSING,32,0,32
335783241,EnMasseProject/enmasse,22/08/18 18:49,spirals-bears,115b89a2-5f2f-4a9f-a894-a9ee1a0dcd59_02-18-week1-PASSING_AND_PASSING,33,3,36
335968688,EnMasseProject/enmasse,22/08/18 18:49,spirals-bears,115b89a2-5f2f-4a9f-a894-a9ee1a0dcd59_02-18-week1-PASSING_AND_PASSING,44,3,47
337873800,batfish/batfish,22/08/18 18:50,spirals-bears,115b89a2-5f2f-4a9f-a894-a9ee1a0dcd59_02-18-week1-PASSING_AND_PASSING,55,0,0,0,2,57
337873811,batfish/batfish,22/08/18 18:50,spirals-bears,115b89a2-5f2f-4a9f-a894-a9ee1a0dcd59_02-18-week1-PASSING_AND_PASSING,49,0,0,6,4,59
338293438,batfish/batfish,22/08/18 18:50,spirals-bears,115b89a2-5f2f-4a9f-a894-a9ee1a0dcd59_02-18-week1-PASSING_AND_PASSING,58,0,58
338269705,batfish/batfish,22/08/18 18:51,spirals-bears,115b89a2-5f2f-4a9f-a894-a9ee1a0dcd59_02-18-week1-PASSING_AND_PASSING,49,0,49
337856416,batfish/batfish,22/08/18 18:52,spirals-bears,115b89a2-5f2f-4a9f-a894-a9ee1a0dcd59_02-18-week1-PASSING_AND_PASSING,55,3,58
337878661,batfish/batfish,22/08/18 18:53,spirals-bears,115b89a2-5f2f-4a9f-a894-a9ee1a0dcd59_02-18-week1-PASSING_AND_PASSING,56,0,56
338280254,batfish/batfish,22/08/18 18:54,spirals-bears,115b89a2-5f2f-4a9f-a894-a9ee1a0dcd59_02-18-week1-PASSING_AND_PASSING,57,0,0,0,206,2,265
337826271,batfish/batfish,22/08/18 18:55,spirals-bears,115b89a2-5f2f-4a9f-a894-a9ee1a0dcd59_02-18-week1-PASSING_AND_PASSING,56,0,1,0,44,1,102
338128700,batfish/batfish,22/08/18 18:55,spirals-bears,115b89a2-5f2f-4a9f-a894-a9ee1a0dcd59_02-18-week1-PASSING_AND_PASSING,52,0,0,0,212,1,265
337855439,batfish/batfish,22/08/18 18:55,spirals-bears,115b89a2-5f2f-4a9f-a894-a9ee1a0dcd59_02-18-week1-PASSING_AND_PASSING,54,3,57
337885070,batfish/batfish,22/08/18 18:55,spirals-bears,115b89a2-5f2f-4a9f-a894-a9ee1a0dcd59_02-18-week1-PASSING_AND_PASSING,59,0,1,0,217,2,279
337855186,batfish/batfish,22/08/18 18:56,spirals-bears,115b89a2-5f2f-4a9f-a894-a9ee1a0dcd59_02-18-week1-PASSING_AND_PASSING,71,0,71
337827952,batfish/batfish,22/08/18 18:56,spirals-bears,115b89a2-5f2f-4a9f-a894-a9ee1a0dcd59_02-18-week1-PASSING_AND_PASSING,66,3,69
337827642,batfish/batfish,22/08/18 18:56,spirals-bears,115b89a2-5f2f-4a9f-a894-a9ee1a0dcd59_02-18-week1-PASSING_AND_PASSING,57,3,60
337827926,batfish/batfish,22/08/18 18:56,spirals-bears,115b89a2-5f2f-4a9f-a894-a9ee1a0dcd59_02-18-week1-PASSING_AND_PASSING,70,0,70
337734579,batfish/batfish,22/08/18 18:58,spirals-bears,115b89a2-5f2f-4a9f-a894-a9ee1a0dcd59_02-18-week1-PASSING_AND_PASSING,56,0,56
337827630,batfish/batfish,22/08/18 18:58,spirals-bears,115b89a2-5f2f-4a9f-a894-a9ee1a0dcd59_02-18-week1-PASSING_AND_PASSING,61,0,61
337734615,batfish/batfish,22/08/18 18:58,spirals-bears,115b89a2-5f2f-4a9f-a894-a9ee1a0dcd59_02-18-week1-PASSING_AND_PASSING,53,4,57
336241760,batfish/batfish,22/08/18 19:01,spirals-bears,115b89a2-5f2f-4a9f-a894-a9ee1a0dcd59_02-18-week1-PASSING_AND_PASSING,58,0,0,6,218,6,288
335988308,batfish/batfish,22/08/18 19:03,spirals-bears,115b89a2-5f2f-4a9f-a894-a9ee1a0dcd59_02-18-week1-PASSING_AND_PASSING,58,0,1,0,231,1,291
336241729,batfish/batfish,22/08/18 19:03,spirals-bears,115b89a2-5f2f-4a9f-a894-a9ee1a0dcd59_02-18-week1-PASSING_AND_PASSING,64,0,0,0,228,2,294
335990317,batfish/batfish,22/08/18 19:03,spirals-bears,115b89a2-5f2f-4a9f-a894-a9ee1a0dcd59_02-18-week1-PASSING_AND_PASSING,50,0,0,5,237,5,297
335524075,batfish/batfish,22/08/18 19:04,spirals-bears,115b89a2-5f2f-4a9f-a894-a9ee1a0dcd59_02-18-week1-PASSING_AND_PASSING,55,3,58
335523756,batfish/batfish,22/08/18 19:05,spirals-bears,115b89a2-5f2f-4a9f-a894-a9ee1a0dcd59_02-18-week1-PASSING_AND_PASSING,53,0,53
335850146,batfish/batfish,22/08/18 19:06,spirals-bears,115b89a2-5f2f-4a9f-a894-a9ee1a0dcd59_02-18-week1-PASSING_AND_PASSING,50,0,0,6,198,4,258
335486663,batfish/batfish,22/08/18 19:06,spirals-bears,115b89a2-5f2f-4a9f-a894-a9ee1a0dcd59_02-18-week1-PASSING_AND_PASSING,51,0,51
335486673,batfish/batfish,22/08/18 19:07,spirals-bears,115b89a2-5f2f-4a9f-a894-a9ee1a0dcd59_02-18-week1-PASSING_AND_PASSING,58,3,61
335837651,batfish/batfish,22/08/18 19:07,spirals-bears,115b89a2-5f2f-4a9f-a894-a9ee1a0dcd59_02-18-week1-PASSING_AND_PASSING,68,0,0,0,193,1,262
335873990,batfish/batfish,22/08/18 19:07,spirals-bears,115b89a2-5f2f-4a9f-a894-a9ee1a0dcd59_02-18-week1-PASSING_AND_PASSING,64,0,0,0,197,2,263
335855991,batfish/batfish,22/08/18 19:10,spirals-bears,115b89a2-5f2f-4a9f-a894-a9ee1a0dcd59_02-18-week1-PASSING_AND_PASSING,54,0,0,0,177,2,233
337655864,matsim-org/matsim,22/08/18 19:11,spirals-bears,115b89a2-5f2f-4a9f-a894-a9ee1a0dcd59_02-18-week1-PASSING_AND_PASSING,172,0,0,1,16,2,191
336287993,matsim-org/matsim,22/08/18 19:22,spirals-bears,115b89a2-5f2f-4a9f-a894-a9ee1a0dcd59_02-18-week1-PASSING_AND_PASSING,263,0,1,1,432,1,698
335985569,matsim-org/matsim,22/08/18 19:26,spirals-bears,115b89a2-5f2f-4a9f-a894-a9ee1a0dcd59_02-18-week1-PASSING_AND_PASSING,172,0,0,2,67,2,243
338589951,matsim-org/matsim,22/08/18 19:29,spirals-bears,115b89a2-5f2f-4a9f-a894-a9ee1a0dcd59_02-18-week1-PASSING_AND_PASSING,170,0,0,1,1139,2,1312
335821104,matsim-org/matsim,22/08/18 19:32,spirals-bears,115b89a2-5f2f-4a9f-a894-a9ee1a0dcd59_02-18-week1-PASSING_AND_PASSING,226,0,0,1,71,4,302
335731568,matsim-org/matsim,22/08/18 19:36,spirals-bears,115b89a2-5f2f-4a9f-a894-a9ee1a0dcd59_02-18-week1-PASSING_AND_PASSING,152,0,0,7,222,5,386
336441643,apache/incubator-servicecomb-java-chassis,22/08/18 19:36,spirals-bears,115b89a2-5f2f-4a9f-a894-a9ee1a0dcd59_02-18-week1-PASSING_AND_PASSING,9,4,13
337918355,apache/incubator-servicecomb-java-chassis,22/08/18 19:37,spirals-bears,115b89a2-5f2f-4a9f-a894-a9ee1a0dcd59_02-18-week1-PASSING_AND_PASSING,10,4,14
336380345,apache/incubator-servicecomb-java-chassis,22/08/18 19:37,spirals-bears,115b89a2-5f2f-4a9f-a894-a9ee1a0dcd59_02-18-week1-PASSING_AND_PASSING,9,0,9
336546860,matsim-org/matsim,22/08/18 19:37,spirals-bears,115b89a2-5f2f-4a9f-a894-a9ee1a0dcd59_02-18-week1-PASSING_AND_PASSING,177,0,1,1,1594,1,1774
335731662,matsim-org/matsim,22/08/18 19:38,spirals-bears,115b89a2-5f2f-4a9f-a894-a9ee1a0dcd59_02-18-week1-PASSING_AND_PASSING,151,0,1,2,220,1,375
336471051,apache/incubator-servicecomb-java-chassis,22/08/18 19:38,spirals-bears,115b89a2-5f2f-4a9f-a894-a9ee1a0dcd59_02-18-week1-PASSING_AND_PASSING,9,1,5,0,43,1,59
336495327,apache/incubator-servicecomb-java-chassis,22/08/18 19:40,spirals-bears,115b89a2-5f2f-4a9f-a894-a9ee1a0dcd59_02-18-week1-PASSING_AND_PASSING,10,1,5,4,40,5,65
336849208,apache/incubator-servicecomb-java-chassis,22/08/18 19:41,spirals-bears,115b89a2-5f2f-4a9f-a894-a9ee1a0dcd59_02-18-week1-PASSING_AND_PASSING,9,2,5,0,188,1,205
335492735,apache/incubator-servicecomb-java-chassis,22/08/18 19:41,spirals-bears,115b89a2-5f2f-4a9f-a894-a9ee1a0dcd59_02-18-week1-PASSING_AND_PASSING,8,1,5,5,38,5,62
336158063,apache/incubator-servicecomb-java-chassis,22/08/18 19:41,spirals-bears,115b89a2-5f2f-4a9f-a894-a9ee1a0dcd59_02-18-week1-PASSING_AND_PASSING,9,3,12
336023607,matsim-org/matsim,22/08/18 19:41,spirals-bears,115b89a2-5f2f-4a9f-a894-a9ee1a0dcd59_02-18-week1-PASSING_AND_PASSING,157,0,1,2,1642,1,1803
335535820,apache/incubator-servicecomb-java-chassis,22/08/18 19:41,spirals-bears,115b89a2-5f2f-4a9f-a894-a9ee1a0dcd59_02-18-week1-PASSING_AND_PASSING,9,3,12
336823279,runelite/runelite,22/08/18 19:42,spirals-bears,115b89a2-5f2f-4a9f-a894-a9ee1a0dcd59_02-18-week1-PASSING_AND_PASSING,10,14,24
338218651,runelite/runelite,22/08/18 19:42,spirals-bears,115b89a2-5f2f-4a9f-a894-a9ee1a0dcd59_02-18-week1-PASSING_AND_PASSING,11,0,11
337690272,runelite/runelite,22/08/18 19:42,spirals-bears,115b89a2-5f2f-4a9f-a894-a9ee1a0dcd59_02-18-week1-PASSING_AND_PASSING,11,0,11
337672727,runelite/runelite,22/08/18 19:42,spirals-bears,115b89a2-5f2f-4a9f-a894-a9ee1a0dcd59_02-18-week1-PASSING_AND_PASSING,10,0,10
337074602,runelite/runelite,22/08/18 19:42,spirals-bears,115b89a2-5f2f-4a9f-a894-a9ee1a0dcd59_02-18-week1-PASSING_AND_PASSING,11,13,24
335685709,runelite/runelite,22/08/18 19:43,spirals-bears,115b89a2-5f2f-4a9f-a894-a9ee1a0dcd59_02-18-week1-PASSING_AND_PASSING,10,0,10
337188374,runelite/runelite,22/08/18 19:43,spirals-bears,115b89a2-5f2f-4a9f-a894-a9ee1a0dcd59_02-18-week1-PASSING_AND_PASSING,10,0,10
337073706,runelite/runelite,22/08/18 19:43,spirals-bears,115b89a2-5f2f-4a9f-a894-a9ee1a0dcd59_02-18-week1-PASSING_AND_PASSING,10,0,0,4,19,33
333519924,runelite/runelite,22/08/18 19:43,spirals-bears,115b89a2-5f2f-4a9f-a894-a9ee1a0dcd59_02-18-week1-PASSING_AND_PASSING,10,0,10
335525216,apache/incubator-servicecomb-java-chassis,22/08/18 19:44,spirals-bears,115b89a2-5f2f-4a9f-a894-a9ee1a0dcd59_02-18-week1-PASSING_AND_PASSING,9,1,5,0,130,1,146
337094132,runelite/runelite,22/08/18 19:44,spirals-bears,115b89a2-5f2f-4a9f-a894-a9ee1a0dcd59_02-18-week1-PASSING_AND_PASSING,10,0,0,4,14,28
336532571,runelite/runelite,22/08/18 19:44,spirals-bears,115b89a2-5f2f-4a9f-a894-a9ee1a0dcd59_02-18-week1-PASSING_AND_PASSING,12,0,12
336707313,runelite/runelite,22/08/18 19:44,spirals-bears,115b89a2-5f2f-4a9f-a894-a9ee1a0dcd59_02-18-week1-PASSING_AND_PASSING,10,0,10
336792943,runelite/runelite,22/08/18 19:44,spirals-bears,115b89a2-5f2f-4a9f-a894-a9ee1a0dcd59_02-18-week1-PASSING_AND_PASSING,11,0,11
336792245,runelite/runelite,22/08/18 19:44,spirals-bears,115b89a2-5f2f-4a9f-a894-a9ee1a0dcd59_02-18-week1-PASSING_AND_PASSING,10,0,10
336081774,runelite/runelite,22/08/18 19:44,spirals-bears,115b89a2-5f2f-4a9f-a894-a9ee1a0dcd59_02-18-week1-PASSING_AND_PASSING,10,0,10
335465329,runelite/runelite,22/08/18 19:44,spirals-bears,115b89a2-5f2f-4a9f-a894-a9ee1a0dcd59_02-18-week1-PASSING_AND_PASSING,11,0,11
335906463,runelite/runelite,22/08/18 19:44,spirals-bears,115b89a2-5f2f-4a9f-a894-a9ee1a0dcd59_02-18-week1-PASSING_AND_PASSING,10,0,10
335891338,runelite/runelite,22/08/18 19:45,spirals-bears,115b89a2-5f2f-4a9f-a894-a9ee1a0dcd59_02-18-week1-PASSING_AND_PASSING,12,1,13
335179598,runelite/runelite,22/08/18 19:45,spirals-bears,115b89a2-5f2f-4a9f-a894-a9ee1a0dcd59_02-18-week1-PASSING_AND_PASSING,11,0,1,4,18,34
336001813,runelite/runelite,22/08/18 19:45,spirals-bears,115b89a2-5f2f-4a9f-a894-a9ee1a0dcd59_02-18-week1-PASSING_AND_PASSING,11,13,24
335760233,runelite/runelite,22/08/18 19:45,spirals-bears,115b89a2-5f2f-4a9f-a894-a9ee1a0dcd59_02-18-week1-PASSING_AND_PASSING,10,0,10
335711155,runelite/runelite,22/08/18 19:45,spirals-bears,115b89a2-5f2f-4a9f-a894-a9ee1a0dcd59_02-18-week1-PASSING_AND_PASSING,11,0,11
335904965,runelite/runelite,22/08/18 19:45,spirals-bears,115b89a2-5f2f-4a9f-a894-a9ee1a0dcd59_02-18-week1-PASSING_AND_PASSING,11,0,1,4,14,30
335874618,runelite/runelite,22/08/18 19:46,spirals-bears,115b89a2-5f2f-4a9f-a894-a9ee1a0dcd59_02-18-week1-PASSING_AND_PASSING,12,0,12
335343020,runelite/runelite,22/08/18 19:46,spirals-bears,115b89a2-5f2f-4a9f-a894-a9ee1a0dcd59_02-18-week1-PASSING_AND_PASSING,11,14,25
336811395,apache/incubator-servicecomb-java-chassis,22/08/18 19:47,spirals-bears,115b89a2-5f2f-4a9f-a894-a9ee1a0dcd59_02-18-week1-PASSING_AND_PASSING,10,1,2,53,0,6,4,2,51,7,0,163,3,9,2,190,503
333635465,CorfuDB/CorfuDB,22/08/18 19:50,spirals-bears,115b89a2-5f2f-4a9f-a894-a9ee1a0dcd59_02-18-week1-PASSING_AND_PASSING,240,0,240
333636818,CorfuDB/CorfuDB,22/08/18 19:50,spirals-bears,115b89a2-5f2f-4a9f-a894-a9ee1a0dcd59_02-18-week1-PASSING_AND_PASSING,267,3,270
336341000,CorfuDB/CorfuDB,22/08/18 19:50,spirals-bears,115b89a2-5f2f-4a9f-a894-a9ee1a0dcd59_02-18-week1-PASSING_AND_PASSING,267,0,267
336341783,CorfuDB/CorfuDB,22/08/18 19:51,spirals-bears,115b89a2-5f2f-4a9f-a894-a9ee1a0dcd59_02-18-week1-PASSING_AND_PASSING,257,4,261
336011205,CorfuDB/CorfuDB,22/08/18 19:54,spirals-bears,115b89a2-5f2f-4a9f-a894-a9ee1a0dcd59_02-18-week1-PASSING_AND_PASSING,243,0,243
336204280,CorfuDB/CorfuDB,22/08/18 19:55,spirals-bears,115b89a2-5f2f-4a9f-a894-a9ee1a0dcd59_02-18-week1-PASSING_AND_PASSING,274,3,277
336198373,CorfuDB/CorfuDB,22/08/18 19:57,spirals-bears,115b89a2-5f2f-4a9f-a894-a9ee1a0dcd59_02-18-week1-PASSING_AND_PASSING,302,4,306
335941990,CorfuDB/CorfuDB,22/08/18 19:59,spirals-bears,115b89a2-5f2f-4a9f-a894-a9ee1a0dcd59_02-18-week1-PASSING_AND_PASSING,302,0,302
335919530,CorfuDB/CorfuDB,22/08/18 20:00,spirals-bears,115b89a2-5f2f-4a9f-a894-a9ee1a0dcd59_02-18-week1-PASSING_AND_PASSING,284,0,284
335910525,CorfuDB/CorfuDB,22/08/18 20:02,spirals-bears,115b89a2-5f2f-4a9f-a894-a9ee1a0dcd59_02-18-week1-PASSING_AND_PASSING,302,0,302
335037627,CorfuDB/CorfuDB,22/08/18 20:03,spirals-bears,115b89a2-5f2f-4a9f-a894-a9ee1a0dcd59_02-18-week1-PASSING_AND_PASSING,246,3,249
335036386,CorfuDB/CorfuDB,22/08/18 20:05,spirals-bears,115b89a2-5f2f-4a9f-a894-a9ee1a0dcd59_02-18-week1-PASSING_AND_PASSING,264,0,264
335894127,CorfuDB/CorfuDB,22/08/18 20:06,spirals-bears,115b89a2-5f2f-4a9f-a894-a9ee1a0dcd59_02-18-week1-PASSING_AND_PASSING,256,3,259
335884060,CorfuDB/CorfuDB,22/08/18 20:07,spirals-bears,115b89a2-5f2f-4a9f-a894-a9ee1a0dcd59_02-18-week1-PASSING_AND_PASSING,239,0,239
337270201,apache/storm,22/08/18 20:09,spirals-bears,115b89a2-5f2f-4a9f-a894-a9ee1a0dcd59_02-18-week1-PASSING_AND_PASSING,43,0,1,5,6,55
335884123,CorfuDB/CorfuDB,22/08/18 20:09,spirals-bears,115b89a2-5f2f-4a9f-a894-a9ee1a0dcd59_02-18-week1-PASSING_AND_PASSING,246,3,249
337251370,apache/storm,22/08/18 20:09,spirals-bears,115b89a2-5f2f-4a9f-a894-a9ee1a0dcd59_02-18-week1-PASSING_AND_PASSING,38,5,43
337248757,apache/storm,22/08/18 20:10,spirals-bears,115b89a2-5f2f-4a9f-a894-a9ee1a0dcd59_02-18-week1-PASSING_AND_PASSING,39,5,44
336986868,apache/storm,22/08/18 20:10,spirals-bears,115b89a2-5f2f-4a9f-a894-a9ee1a0dcd59_02-18-week1-PASSING_AND_PASSING,35,6,41
338131027,linkedin/pinot,22/08/18 20:11,spirals-bears,115b89a2-5f2f-4a9f-a894-a9ee1a0dcd59_02-18-week1-PASSING_AND_PASSING,35,3,38
338291610,linkedin/pinot,22/08/18 20:14,spirals-bears,115b89a2-5f2f-4a9f-a894-a9ee1a0dcd59_02-18-week1-PASSING_AND_PASSING,34,0,0,1,219,1,255
338241441,linkedin/pinot,22/08/18 20:15,spirals-bears,115b89a2-5f2f-4a9f-a894-a9ee1a0dcd59_02-18-week1-PASSING_AND_PASSING,39,3,42
337837647,linkedin/pinot,22/08/18 20:16,spirals-bears,115b89a2-5f2f-4a9f-a894-a9ee1a0dcd59_02-18-week1-PASSING_AND_PASSING,34,4,38
337806265,linkedin/pinot,22/08/18 20:17,spirals-bears,115b89a2-5f2f-4a9f-a894-a9ee1a0dcd59_02-18-week1-PASSING_AND_PASSING,35,4,39
338196552,linkedin/pinot,22/08/18 20:17,spirals-bears,115b89a2-5f2f-4a9f-a894-a9ee1a0dcd59_02-18-week1-PASSING_AND_PASSING,46,0,0,1,323,3,373
336784627,linkedin/pinot,22/08/18 20:18,spirals-bears,115b89a2-5f2f-4a9f-a894-a9ee1a0dcd59_02-18-week1-PASSING_AND_PASSING,34,4,38
337747644,linkedin/pinot,22/08/18 20:19,spirals-bears,115b89a2-5f2f-4a9f-a894-a9ee1a0dcd59_02-18-week1-PASSING_AND_PASSING,37,3,40
337817101,linkedin/pinot,22/08/18 20:21,spirals-bears,115b89a2-5f2f-4a9f-a894-a9ee1a0dcd59_02-18-week1-PASSING_AND_PASSING,35,0,0,1,217,2,255
335910410,CorfuDB/CorfuDB,22/08/18 20:22,spirals-bears,115b89a2-5f2f-4a9f-a894-a9ee1a0dcd59_02-18-week1-PASSING_AND_PASSING,8,0,0,662,0,0,2,0,709,0,0,90,0,258,2,182,1913
337712836,linkedin/pinot,22/08/18 20:23,spirals-bears,115b89a2-5f2f-4a9f-a894-a9ee1a0dcd59_02-18-week1-PASSING_AND_PASSING,39,3,42
332923777,linkedin/pinot,22/08/18 20:24,spirals-bears,115b89a2-5f2f-4a9f-a894-a9ee1a0dcd59_02-18-week1-PASSING_AND_PASSING,45,4,49
336782183,linkedin/pinot,22/08/18 20:25,spirals-bears,115b89a2-5f2f-4a9f-a894-a9ee1a0dcd59_02-18-week1-PASSING_AND_PASSING,42,4,46
336780462,linkedin/pinot,22/08/18 20:26,spirals-bears,115b89a2-5f2f-4a9f-a894-a9ee1a0dcd59_02-18-week1-PASSING_AND_PASSING,34,5,39
336747187,linkedin/pinot,22/08/18 20:27,spirals-bears,115b89a2-5f2f-4a9f-a894-a9ee1a0dcd59_02-18-week1-PASSING_AND_PASSING,35,4,39
336252573,linkedin/pinot,22/08/18 20:28,spirals-bears,115b89a2-5f2f-4a9f-a894-a9ee1a0dcd59_02-18-week1-PASSING_AND_PASSING,38,3,41
336399716,linkedin/pinot,22/08/18 20:28,spirals-bears,115b89a2-5f2f-4a9f-a894-a9ee1a0dcd59_02-18-week1-PASSING_AND_PASSING,32,3,35
336770456,linkedin/pinot,22/08/18 20:29,spirals-bears,115b89a2-5f2f-4a9f-a894-a9ee1a0dcd59_02-18-week1-PASSING_AND_PASSING,35,4,39
336685140,linkedin/pinot,22/08/18 20:30,spirals-bears,115b89a2-5f2f-4a9f-a894-a9ee1a0dcd59_02-18-week1-PASSING_AND_PASSING,31,4,35
335874641,CorfuDB/CorfuDB,22/08/18 20:41,spirals-bears,115b89a2-5f2f-4a9f-a894-a9ee1a0dcd59_02-18-week1-PASSING_AND_PASSING,12,4,0,0,6,762,0,0,2,0,754,0,0,0,103,0,247,4,4,197,2095
336742965,linkedin/pinot,22/08/18 20:46,spirals-bears,115b89a2-5f2f-4a9f-a894-a9ee1a0dcd59_02-18-week1-PASSING_AND_PASSING,36,0,0,1,233,1,271
336691951,linkedin/pinot,22/08/18 20:47,spirals-bears,115b89a2-5f2f-4a9f-a894-a9ee1a0dcd59_02-18-week1-PASSING_AND_PASSING,34,5,39
336684332,linkedin/pinot,22/08/18 20:48,spirals-bears,115b89a2-5f2f-4a9f-a894-a9ee1a0dcd59_02-18-week1-PASSING_AND_PASSING,33,3,36
337776399,linkedin/pinot,22/08/18 21:22,spirals-bears,115b89a2-5f2f-4a9f-a894-a9ee1a0dcd59_02-18-week1-PASSING_AND_PASSING,37,0,3276,0,1,427,0,2,3743
336376544,linkedin/pinot,22/08/18 21:23,spirals-bears,115b89a2-5f2f-4a9f-a894-a9ee1a0dcd59_02-18-week1-PASSING_AND_PASSING,35,4,39
336437856,linkedin/pinot,22/08/18 21:23,spirals-bears,115b89a2-5f2f-4a9f-a894-a9ee1a0dcd59_02-18-week1-PASSING_AND_PASSING,32,3,35
336376719,linkedin/pinot,22/08/18 21:24,spirals-bears,115b89a2-5f2f-4a9f-a894-a9ee1a0dcd59_02-18-week1-PASSING_AND_PASSING,36,3,39
335884717,linkedin/pinot,22/08/18 21:25,spirals-bears,115b89a2-5f2f-4a9f-a894-a9ee1a0dcd59_02-18-week1-PASSING_AND_PASSING,34,3,37
336369939,linkedin/pinot,22/08/18 21:26,spirals-bears,115b89a2-5f2f-4a9f-a894-a9ee1a0dcd59_02-18-week1-PASSING_AND_PASSING,35,5,40
336340714,linkedin/pinot,22/08/18 21:27,spirals-bears,115b89a2-5f2f-4a9f-a894-a9ee1a0dcd59_02-18-week1-PASSING_AND_PASSING,37,4,41
336365070,linkedin/pinot,22/08/18 21:27,spirals-bears,115b89a2-5f2f-4a9f-a894-a9ee1a0dcd59_02-18-week1-PASSING_AND_PASSING,32,3,35
336315496,linkedin/pinot,22/08/18 21:34,spirals-bears,115b89a2-5f2f-4a9f-a894-a9ee1a0dcd59_02-18-week1-PASSING_AND_PASSING,36,0,0,1,343,1,381
336755232,linkedin/pinot,22/08/18 21:34,spirals-bears,115b89a2-5f2f-4a9f-a894-a9ee1a0dcd59_02-18-week1-PASSING_AND_PASSING,36,0,3406,0,1,411,0,2,3856
334965621,linkedin/pinot,22/08/18 21:35,spirals-bears,115b89a2-5f2f-4a9f-a894-a9ee1a0dcd59_02-18-week1-PASSING_AND_PASSING,37,3,40
333513250,linkedin/pinot,22/08/18 21:35,spirals-bears,115b89a2-5f2f-4a9f-a894-a9ee1a0dcd59_02-18-week1-PASSING_AND_PASSING,51,3,54
336295724,linkedin/pinot,22/08/18 21:36,spirals-bears,115b89a2-5f2f-4a9f-a894-a9ee1a0dcd59_02-18-week1-PASSING_AND_PASSING,45,4,49
335447091,linkedin/pinot,22/08/18 21:37,spirals-bears,115b89a2-5f2f-4a9f-a894-a9ee1a0dcd59_02-18-week1-PASSING_AND_PASSING,36,0,0,5,10,51
335910852,linkedin/pinot,22/08/18 21:37,spirals-bears,115b89a2-5f2f-4a9f-a894-a9ee1a0dcd59_02-18-week1-PASSING_AND_PASSING,39,4,43
335891049,linkedin/pinot,22/08/18 21:37,spirals-bears,115b89a2-5f2f-4a9f-a894-a9ee1a0dcd59_02-18-week1-PASSING_AND_PASSING,41,3,44
335853478,linkedin/pinot,22/08/18 21:42,spirals-bears,115b89a2-5f2f-4a9f-a894-a9ee1a0dcd59_02-18-week1-PASSING_AND_PASSING,33,0,0,1,207,2,243
333052245,linkedin/pinot,22/08/18 21:43,spirals-bears,115b89a2-5f2f-4a9f-a894-a9ee1a0dcd59_02-18-week1-PASSING_AND_PASSING,38,4,42
337755835,linkedin/pinot,22/08/18 21:45,spirals-bears,115b89a2-5f2f-4a9f-a894-a9ee1a0dcd59_02-18-week1-PASSING_AND_PASSING,9,40,0,0,23,814,0,0,30,0,3459,0,0,0,88,0,38,37,32,429,4999
336839386,Azure/azure-libraries-for-java,22/08/18 21:46,spirals-bears,115b89a2-5f2f-4a9f-a894-a9ee1a0dcd59_02-18-week1-PASSING_AND_PASSING,63,0,1,6,81,15,166
335900942,Azure/azure-libraries-for-java,22/08/18 21:46,spirals-bears,115b89a2-5f2f-4a9f-a894-a9ee1a0dcd59_02-18-week1-PASSING_AND_PASSING,60,4,64
335111180,lettuce-io/lettuce-core,22/08/18 21:48,spirals-bears,115b89a2-5f2f-4a9f-a894-a9ee1a0dcd59_02-18-week1-PASSING_AND_PASSING,8,0,18,1,0,48,0,0,75
338212748,HubSpot/Singularity,22/08/18 21:49,spirals-bears,115b89a2-5f2f-4a9f-a894-a9ee1a0dcd59_02-18-week1-PASSING_AND_PASSING,17,0,1,0,154,0,172
336663149,linkedin/pinot,22/08/18 21:54,spirals-bears,115b89a2-5f2f-4a9f-a894-a9ee1a0dcd59_02-18-week1-PASSING_AND_PASSING,34,0,3512,0,1,417,0,1,3965
338522312,magefree/mage,22/08/18 22:04,spirals-bears,115b89a2-5f2f-4a9f-a894-a9ee1a0dcd59_02-18-week1-PASSING_AND_PASSING,8,0,0,192,0,1,25,0,173,3,1,34,1,170,26,327,961
337289557,magefree/mage,22/08/18 22:05,spirals-bears,115b89a2-5f2f-4a9f-a894-a9ee1a0dcd59_02-18-week1-PASSING_AND_PASSING,10,0,0,168,1,1,35,0,172,2,1,23,1,169,27,325,935
337283082,magefree/mage,22/08/18 22:11,spirals-bears,115b89a2-5f2f-4a9f-a894-a9ee1a0dcd59_02-18-week1-PASSING_AND_PASSING,7,0,0,194,0,1,29,0,173,1,1,31,1,168,23,331,960
338381706,molgenis/molgenis,22/08/18 22:12,spirals-bears,115b89a2-5f2f-4a9f-a894-a9ee1a0dcd59_02-18-week1-PASSING_AND_PASSING,53,0,2,0,33,1,89
337948547,molgenis/molgenis,22/08/18 22:15,spirals-bears,115b89a2-5f2f-4a9f-a894-a9ee1a0dcd59_02-18-week1-PASSING_AND_PASSING,45,0,1,6,59,8,119
337467427,molgenis/molgenis,22/08/18 22:17,spirals-bears,115b89a2-5f2f-4a9f-a894-a9ee1a0dcd59_02-18-week1-PASSING_AND_PASSING,40,0,1,5,52,12,110
337886838,molgenis/molgenis,22/08/18 22:19,spirals-bears,115b89a2-5f2f-4a9f-a894-a9ee1a0dcd59_02-18-week1-PASSING_AND_PASSING,41,0,1,5,61,9,117
337594572,molgenis/molgenis,22/08/18 22:21,spirals-bears,115b89a2-5f2f-4a9f-a894-a9ee1a0dcd59_02-18-week1-PASSING_AND_PASSING,41,0,1,6,39,9,96
337149081,magefree/mage,22/08/18 22:21,spirals-bears,115b89a2-5f2f-4a9f-a894-a9ee1a0dcd59_02-18-week1-PASSING_AND_PASSING,8,0,0,203,1,0,29,0,178,1,1,43,1,174,26,320,985
337574782,molgenis/molgenis,22/08/18 22:22,spirals-bears,115b89a2-5f2f-4a9f-a894-a9ee1a0dcd59_02-18-week1-PASSING_AND_PASSING,40,0,1,5,10,56
336865810,magefree/mage,22/08/18 22:22,spirals-bears,115b89a2-5f2f-4a9f-a894-a9ee1a0dcd59_02-18-week1-PASSING_AND_PASSING,10,0,0,213,1,0,29,0,179,1,1,30,1,189,29,312,995
337573069,molgenis/molgenis,22/08/18 22:24,spirals-bears,115b89a2-5f2f-4a9f-a894-a9ee1a0dcd59_02-18-week1-PASSING_AND_PASSING,42,0,2,7,53,10,114
337437395,molgenis/molgenis,22/08/18 22:24,spirals-bears,115b89a2-5f2f-4a9f-a894-a9ee1a0dcd59_02-18-week1-PASSING_AND_PASSING,46,0,1,6,35,9,97
337465579,molgenis/molgenis,22/08/18 22:25,spirals-bears,115b89a2-5f2f-4a9f-a894-a9ee1a0dcd59_02-18-week1-PASSING_AND_PASSING,40,0,1,6,10,57
337445574,molgenis/molgenis,22/08/18 22:25,spirals-bears,115b89a2-5f2f-4a9f-a894-a9ee1a0dcd59_02-18-week1-PASSING_AND_PASSING,42,10,52
336489448,molgenis/molgenis,22/08/18 22:27,spirals-bears,115b89a2-5f2f-4a9f-a894-a9ee1a0dcd59_02-18-week1-PASSING_AND_PASSING,65,0,1,0,41,2,109
335882032,linkedin/pinot,22/08/18 22:40,spirals-bears,115b89a2-5f2f-4a9f-a894-a9ee1a0dcd59_02-18-week1-PASSING_AND_PASSING,36,0,3275,0,1,449,1,2,3764
337213390,molgenis/molgenis,22/08/18 22:46,spirals-bears,115b89a2-5f2f-4a9f-a894-a9ee1a0dcd59_02-18-week1-PASSING_AND_PASSING,41,0,800,1,1,545,2,1,1391
336162190,molgenis/molgenis,22/08/18 22:47,spirals-bears,115b89a2-5f2f-4a9f-a894-a9ee1a0dcd59_02-18-week1-PASSING_AND_PASSING,42,0,781,2,0,524,1,1,1351
336133832,molgenis/molgenis,22/08/18 23:07,spirals-bears,115b89a2-5f2f-4a9f-a894-a9ee1a0dcd59_02-18-week1-PASSING_AND_PASSING,9,81,0,0,19,503,1,4,53,0,760,0,2,1,237,1,45,79,56,517,2368
337679196,StuPro-TOSCAna/TOSCAna,22/08/18 23:07,spirals-bears,115b89a2-5f2f-4a9f-a894-a9ee1a0dcd59_02-18-week1-PASSING_AND_PASSING,15,0,15
336028815,molgenis/molgenis,22/08/18 23:11,spirals-bears,115b89a2-5f2f-4a9f-a894-a9ee1a0dcd59_02-18-week1-PASSING_AND_PASSING,40,0,830,1,0,500,2,2,1375
337982423,StuPro-TOSCAna/TOSCAna,22/08/18 23:11,spirals-bears,115b89a2-5f2f-4a9f-a894-a9ee1a0dcd59_02-18-week1-PASSING_AND_PASSING,14,2,16
336983539,StuPro-TOSCAna/TOSCAna,22/08/18 23:12,spirals-bears,115b89a2-5f2f-4a9f-a894-a9ee1a0dcd59_02-18-week1-PASSING_AND_PASSING,14,0,14
337368130,StuPro-TOSCAna/TOSCAna,22/08/18 23:12,spirals-bears,115b89a2-5f2f-4a9f-a894-a9ee1a0dcd59_02-18-week1-PASSING_AND_PASSING,17,0,2,0,269,0,288
337238343,StuPro-TOSCAna/TOSCAna,22/08/18 23:13,spirals-bears,115b89a2-5f2f-4a9f-a894-a9ee1a0dcd59_02-18-week1-PASSING_AND_PASSING,18,2,20
337225951,StuPro-TOSCAna/TOSCAna,22/08/18 23:13,spirals-bears,115b89a2-5f2f-4a9f-a894-a9ee1a0dcd59_02-18-week1-PASSING_AND_PASSING,15,0,15
337094551,StuPro-TOSCAna/TOSCAna,22/08/18 23:15,spirals-bears,115b89a2-5f2f-4a9f-a894-a9ee1a0dcd59_02-18-week1-PASSING_AND_PASSING,20,0,2,0,96,1,119
337017739,StuPro-TOSCAna/TOSCAna,22/08/18 23:16,spirals-bears,115b89a2-5f2f-4a9f-a894-a9ee1a0dcd59_02-18-week1-PASSING_AND_PASSING,16,0,16
337017579,StuPro-TOSCAna/TOSCAna,22/08/18 23:16,spirals-bears,115b89a2-5f2f-4a9f-a894-a9ee1a0dcd59_02-18-week1-PASSING_AND_PASSING,19,2,21
337246314,StuPro-TOSCAna/TOSCAna,22/08/18 23:19,spirals-bears,115b89a2-5f2f-4a9f-a894-a9ee1a0dcd59_02-18-week1-PASSING_AND_PASSING,11,0,0,124,0,2,2,0,122,0,0,28,0,17,2,106,414
337092030,StuPro-TOSCAna/TOSCAna,22/08/18 23:19,spirals-bears,115b89a2-5f2f-4a9f-a894-a9ee1a0dcd59_02-18-week1-PASSING_AND_PASSING,20,0,2,0,129,0,151
337023281,StuPro-TOSCAna/TOSCAna,22/08/18 23:20,spirals-bears,115b89a2-5f2f-4a9f-a894-a9ee1a0dcd59_02-18-week1-PASSING_AND_PASSING,15,4,19
337023024,StuPro-TOSCAna/TOSCAna,22/08/18 23:20,spirals-bears,115b89a2-5f2f-4a9f-a894-a9ee1a0dcd59_02-18-week1-PASSING_AND_PASSING,18,0,18
336061745,molgenis/molgenis,22/08/18 23:20,spirals-bears,115b89a2-5f2f-4a9f-a894-a9ee1a0dcd59_02-18-week1-PASSING_AND_PASSING,12,53,0,3,16,518,1,1,53,0,765,0,7,1,256,4,72,61,63,519,2405
337054767,StuPro-TOSCAna/TOSCAna,22/08/18 23:21,spirals-bears,115b89a2-5f2f-4a9f-a894-a9ee1a0dcd59_02-18-week1-PASSING_AND_PASSING,13,2,15
337054086,StuPro-TOSCAna/TOSCAna,22/08/18 23:21,spirals-bears,115b89a2-5f2f-4a9f-a894-a9ee1a0dcd59_02-18-week1-PASSING_AND_PASSING,17,0,17
337017747,StuPro-TOSCAna/TOSCAna,22/08/18 23:21,spirals-bears,115b89a2-5f2f-4a9f-a894-a9ee1a0dcd59_02-18-week1-PASSING_AND_PASSING,19,2,21
336953427,StuPro-TOSCAna/TOSCAna,22/08/18 23:21,spirals-bears,115b89a2-5f2f-4a9f-a894-a9ee1a0dcd59_02-18-week1-PASSING_AND_PASSING,17,2,19
336994581,StuPro-TOSCAna/TOSCAna,22/08/18 23:22,spirals-bears,115b89a2-5f2f-4a9f-a894-a9ee1a0dcd59_02-18-week1-PASSING_AND_PASSING,17,2,19
336993811,StuPro-TOSCAna/TOSCAna,22/08/18 23:23,spirals-bears,115b89a2-5f2f-4a9f-a894-a9ee1a0dcd59_02-18-week1-PASSING_AND_PASSING,18,0,2,0,29,0,49
337009539,StuPro-TOSCAna/TOSCAna,22/08/18 23:23,spirals-bears,115b89a2-5f2f-4a9f-a894-a9ee1a0dcd59_02-18-week1-PASSING_AND_PASSING,17,0,2,0,107,0,126
336994576,StuPro-TOSCAna/TOSCAna,22/08/18 23:23,spirals-bears,115b89a2-5f2f-4a9f-a894-a9ee1a0dcd59_02-18-week1-PASSING_AND_PASSING,14,0,14
336978514,StuPro-TOSCAna/TOSCAna,22/08/18 23:24,spirals-bears,115b89a2-5f2f-4a9f-a894-a9ee1a0dcd59_02-18-week1-PASSING_AND_PASSING,14,2,16
336979157,StuPro-TOSCAna/TOSCAna,22/08/18 23:24,spirals-bears,115b89a2-5f2f-4a9f-a894-a9ee1a0dcd59_02-18-week1-PASSING_AND_PASSING,25,0,25
336978501,StuPro-TOSCAna/TOSCAna,22/08/18 23:24,spirals-bears,115b89a2-5f2f-4a9f-a894-a9ee1a0dcd59_02-18-week1-PASSING_AND_PASSING,17,0,17
336943902,StuPro-TOSCAna/TOSCAna,22/08/18 23:25,spirals-bears,115b89a2-5f2f-4a9f-a894-a9ee1a0dcd59_02-18-week1-PASSING_AND_PASSING,32,0,32
336943906,StuPro-TOSCAna/TOSCAna,22/08/18 23:26,spirals-bears,115b89a2-5f2f-4a9f-a894-a9ee1a0dcd59_02-18-week1-PASSING_AND_PASSING,17,2,19
336943615,StuPro-TOSCAna/TOSCAna,22/08/18 23:26,spirals-bears,115b89a2-5f2f-4a9f-a894-a9ee1a0dcd59_02-18-week1-PASSING_AND_PASSING,16,2,18
336943609,StuPro-TOSCAna/TOSCAna,22/08/18 23:27,spirals-bears,115b89a2-5f2f-4a9f-a894-a9ee1a0dcd59_02-18-week1-PASSING_AND_PASSING,19,0,19
336061452,molgenis/molgenis,22/08/18 23:27,spirals-bears,115b89a2-5f2f-4a9f-a894-a9ee1a0dcd59_02-18-week1-PASSING_AND_PASSING,13,56,0,0,13,541,1,1,118,0,766,0,2,2,239,1,48,58,100,497,2456
336034119,StuPro-TOSCAna/TOSCAna,22/08/18 23:28,spirals-bears,115b89a2-5f2f-4a9f-a894-a9ee1a0dcd59_02-18-week1-PASSING_AND_PASSING,13,0,13
336684853,StuPro-TOSCAna/TOSCAna,22/08/18 23:28,spirals-bears,115b89a2-5f2f-4a9f-a894-a9ee1a0dcd59_02-18-week1-PASSING_AND_PASSING,16,0,16
337014835,StuPro-TOSCAna/TOSCAna,22/08/18 23:28,spirals-bears,115b89a2-5f2f-4a9f-a894-a9ee1a0dcd59_02-18-week1-PASSING_AND_PASSING,15,0,0,123,0,2,4,0,122,0,0,30,0,22,4,222,544
336629946,StuPro-TOSCAna/TOSCAna,22/08/18 23:29,spirals-bears,115b89a2-5f2f-4a9f-a894-a9ee1a0dcd59_02-18-week1-PASSING_AND_PASSING,17,0,17
336631829,StuPro-TOSCAna/TOSCAna,22/08/18 23:29,spirals-bears,115b89a2-5f2f-4a9f-a894-a9ee1a0dcd59_02-18-week1-PASSING_AND_PASSING,23,2,25
336629953,StuPro-TOSCAna/TOSCAna,22/08/18 23:29,spirals-bears,115b89a2-5f2f-4a9f-a894-a9ee1a0dcd59_02-18-week1-PASSING_AND_PASSING,20,2,22
336302635,StuPro-TOSCAna/TOSCAna,22/08/18 23:30,spirals-bears,115b89a2-5f2f-4a9f-a894-a9ee1a0dcd59_02-18-week1-PASSING_AND_PASSING,19,2,21
336299840,StuPro-TOSCAna/TOSCAna,22/08/18 23:30,spirals-bears,115b89a2-5f2f-4a9f-a894-a9ee1a0dcd59_02-18-week1-PASSING_AND_PASSING,16,0,16
336620857,StuPro-TOSCAna/TOSCAna,22/08/18 23:31,spirals-bears,115b89a2-5f2f-4a9f-a894-a9ee1a0dcd59_02-18-week1-PASSING_AND_PASSING,16,0,16
336620931,StuPro-TOSCAna/TOSCAna,22/08/18 23:31,spirals-bears,115b89a2-5f2f-4a9f-a894-a9ee1a0dcd59_02-18-week1-PASSING_AND_PASSING,17,2,19
336603065,StuPro-TOSCAna/TOSCAna,22/08/18 23:32,spirals-bears,115b89a2-5f2f-4a9f-a894-a9ee1a0dcd59_02-18-week1-PASSING_AND_PASSING,16,2,18
336597248,StuPro-TOSCAna/TOSCAna,22/08/18 23:32,spirals-bears,115b89a2-5f2f-4a9f-a894-a9ee1a0dcd59_02-18-week1-PASSING_AND_PASSING,22,4,26
336597146,StuPro-TOSCAna/TOSCAna,22/08/18 23:33,spirals-bears,115b89a2-5f2f-4a9f-a894-a9ee1a0dcd59_02-18-week1-PASSING_AND_PASSING,14,0,14
336952625,StuPro-TOSCAna/TOSCAna,22/08/18 23:33,spirals-bears,115b89a2-5f2f-4a9f-a894-a9ee1a0dcd59_02-18-week1-PASSING_AND_PASSING,11,0,0,122,0,2,3,0,123,0,0,29,0,17,3,217,527
336292666,StuPro-TOSCAna/TOSCAna,22/08/18 23:33,spirals-bears,115b89a2-5f2f-4a9f-a894-a9ee1a0dcd59_02-18-week1-PASSING_AND_PASSING,14,3,17
336292651,StuPro-TOSCAna/TOSCAna,22/08/18 23:34,spirals-bears,115b89a2-5f2f-4a9f-a894-a9ee1a0dcd59_02-18-week1-PASSING_AND_PASSING,17,0,17
336718946,StuPro-TOSCAna/TOSCAna,22/08/18 23:37,spirals-bears,115b89a2-5f2f-4a9f-a894-a9ee1a0dcd59_02-18-week1-PASSING_AND_PASSING,10,0,0,124,0,2,3,0,122,0,0,26,0,16,4,317,624
336554725,StuPro-TOSCAna/TOSCAna,22/08/18 23:38,spirals-bears,115b89a2-5f2f-4a9f-a894-a9ee1a0dcd59_02-18-week1-PASSING_AND_PASSING,17,0,17
336605150,StuPro-TOSCAna/TOSCAna,22/08/18 23:38,spirals-bears,115b89a2-5f2f-4a9f-a894-a9ee1a0dcd59_02-18-week1-PASSING_AND_PASSING,9,0,0,124,0,3,2,0,121,0,0,26,0,16,6,217,524
336358552,StuPro-TOSCAna/TOSCAna,22/08/18 23:38,spirals-bears,115b89a2-5f2f-4a9f-a894-a9ee1a0dcd59_02-18-week1-PASSING_AND_PASSING,17,2,19
336554757,StuPro-TOSCAna/TOSCAna,22/08/18 23:38,spirals-bears,115b89a2-5f2f-4a9f-a894-a9ee1a0dcd59_02-18-week1-PASSING_AND_PASSING,22,2,24
336266639,StuPro-TOSCAna/TOSCAna,22/08/18 23:39,spirals-bears,115b89a2-5f2f-4a9f-a894-a9ee1a0dcd59_02-18-week1-PASSING_AND_PASSING,17,2,19
336358546,StuPro-TOSCAna/TOSCAna,22/08/18 23:39,spirals-bears,115b89a2-5f2f-4a9f-a894-a9ee1a0dcd59_02-18-week1-PASSING_AND_PASSING,29,0,29
336571647,StuPro-TOSCAna/TOSCAna,22/08/18 23:39,spirals-bears,115b89a2-5f2f-4a9f-a894-a9ee1a0dcd59_02-18-week1-PASSING_AND_PASSING,13,0,2,0,316,0,331
336282382,StuPro-TOSCAna/TOSCAna,22/08/18 23:39,spirals-bears,115b89a2-5f2f-4a9f-a894-a9ee1a0dcd59_02-18-week1-PASSING_AND_PASSING,20,0,20
336595244,StuPro-TOSCAna/TOSCAna,22/08/18 23:40,spirals-bears,115b89a2-5f2f-4a9f-a894-a9ee1a0dcd59_02-18-week1-PASSING_AND_PASSING,10,0,0,123,0,5,3,0,123,0,0,26,0,18,2,103,413
336242020,StuPro-TOSCAna/TOSCAna,22/08/18 23:40,spirals-bears,115b89a2-5f2f-4a9f-a894-a9ee1a0dcd59_02-18-week1-PASSING_AND_PASSING,23,0,23
336242064,StuPro-TOSCAna/TOSCAna,22/08/18 23:40,spirals-bears,115b89a2-5f2f-4a9f-a894-a9ee1a0dcd59_02-18-week1-PASSING_AND_PASSING,24,2,26
336237095,StuPro-TOSCAna/TOSCAna,22/08/18 23:41,spirals-bears,115b89a2-5f2f-4a9f-a894-a9ee1a0dcd59_02-18-week1-PASSING_AND_PASSING,18,0,18
336237050,StuPro-TOSCAna/TOSCAna,22/08/18 23:41,spirals-bears,115b89a2-5f2f-4a9f-a894-a9ee1a0dcd59_02-18-week1-PASSING_AND_PASSING,18,3,21
336235077,StuPro-TOSCAna/TOSCAna,22/08/18 23:41,spirals-bears,115b89a2-5f2f-4a9f-a894-a9ee1a0dcd59_02-18-week1-PASSING_AND_PASSING,14,0,14
336235113,StuPro-TOSCAna/TOSCAna,22/08/18 23:41,spirals-bears,115b89a2-5f2f-4a9f-a894-a9ee1a0dcd59_02-18-week1-PASSING_AND_PASSING,16,2,18
336146669,StuPro-TOSCAna/TOSCAna,22/08/18 23:42,spirals-bears,115b89a2-5f2f-4a9f-a894-a9ee1a0dcd59_02-18-week1-PASSING_AND_PASSING,14,2,16
336175615,StuPro-TOSCAna/TOSCAna,22/08/18 23:42,spirals-bears,115b89a2-5f2f-4a9f-a894-a9ee1a0dcd59_02-18-week1-PASSING_AND_PASSING,14,2,16
335339849,StuPro-TOSCAna/TOSCAna,22/08/18 23:42,spirals-bears,115b89a2-5f2f-4a9f-a894-a9ee1a0dcd59_02-18-week1-PASSING_AND_PASSING,17,0,17
335339859,StuPro-TOSCAna/TOSCAna,22/08/18 23:43,spirals-bears,115b89a2-5f2f-4a9f-a894-a9ee1a0dcd59_02-18-week1-PASSING_AND_PASSING,18,2,20
336255782,StuPro-TOSCAna/TOSCAna,22/08/18 23:48,spirals-bears,115b89a2-5f2f-4a9f-a894-a9ee1a0dcd59_02-18-week1-PASSING_AND_PASSING,10,0,0,123,0,2,2,0,121,0,0,25,0,18,3,222,526
338195164,languagetool-org/languagetool,22/08/18 23:49,spirals-bears,115b89a2-5f2f-4a9f-a894-a9ee1a0dcd59_02-18-week1-PASSING_AND_PASSING,292,0,1,2,57,2,354
336156466,StuPro-TOSCAna/TOSCAna,22/08/18 23:49,spirals-bears,115b89a2-5f2f-4a9f-a894-a9ee1a0dcd59_02-18-week1-PASSING_AND_PASSING,11,0,0,123,0,2,3,0,123,0,0,27,0,27,4,212,532
335851168,StuPro-TOSCAna/TOSCAna,22/08/18 23:49,spirals-bears,115b89a2-5f2f-4a9f-a894-a9ee1a0dcd59_02-18-week1-PASSING_AND_PASSING,10,0,0,122,0,2,4,0,121,0,0,27,0,25,3,141,455
337840312,apache/incubator-dubbo,22/08/18 23:50,spirals-bears,115b89a2-5f2f-4a9f-a894-a9ee1a0dcd59_02-18-week1-PASSING_AND_PASSING,10,0,10
338400994,apache/incubator-dubbo,22/08/18 23:58,spirals-bears,115b89a2-5f2f-4a9f-a894-a9ee1a0dcd59_02-18-week1-PASSING_AND_PASSING,11,0,194,2,0,281,0,1,489
338559535,ga4gh/dockstore,22/08/18 23:58,spirals-bears,115b89a2-5f2f-4a9f-a894-a9ee1a0dcd59_02-18-week1-PASSING_AND_PASSING,8,2,10
338601439,ga4gh/dockstore,23/08/18 00:03,spirals-bears,115b89a2-5f2f-4a9f-a894-a9ee1a0dcd59_02-18-week1-PASSING_AND_PASSING,9,0,0,0,753,0,762
338559497,ga4gh/dockstore,23/08/18 00:03,spirals-bears,115b89a2-5f2f-4a9f-a894-a9ee1a0dcd59_02-18-week1-PASSING_AND_PASSING,8,0,8
338091132,ga4gh/dockstore,23/08/18 00:03,spirals-bears,115b89a2-5f2f-4a9f-a894-a9ee1a0dcd59_02-18-week1-PASSING_AND_PASSING,8,2,10
336293410,ga4gh/dockstore,23/08/18 00:03,spirals-bears,115b89a2-5f2f-4a9f-a894-a9ee1a0dcd59_02-18-week1-PASSING_AND_PASSING,8,0,8
338514173,apache/jackrabbit-oak,23/08/18 00:07,spirals-bears,115b89a2-5f2f-4a9f-a894-a9ee1a0dcd59_02-18-week1-PASSING_AND_PASSING,36,0,2,1,153,2,194
337600071,apache/jackrabbit-oak,23/08/18 00:08,spirals-bears,115b89a2-5f2f-4a9f-a894-a9ee1a0dcd59_02-18-week1-PASSING_AND_PASSING,42,0,2,1,33,4,82
336966226,languagetool-org/languagetool,23/08/18 00:09,spirals-bears,115b89a2-5f2f-4a9f-a894-a9ee1a0dcd59_02-18-week1-PASSING_AND_PASSING,295,0,796,1,1,121,0,3,1217
333304752,ga4gh/dockstore,23/08/18 00:10,spirals-bears,115b89a2-5f2f-4a9f-a894-a9ee1a0dcd59_02-18-week1-PASSING_AND_PASSING,9,0,0,0,728,0,737
336746566,languagetool-org/languagetool,23/08/18 00:22,spirals-bears,115b89a2-5f2f-4a9f-a894-a9ee1a0dcd59_02-18-week1-PASSING_AND_PASSING,9,37,0,0,26,583,0,1,32,0,752,0,0,0,65,0,300,47,35,118,2005
336566229,apache/jackrabbit-oak,23/08/18 00:30,spirals-bears,115b89a2-5f2f-4a9f-a894-a9ee1a0dcd59_02-18-week1-PASSING_AND_PASSING,34,0,669,2,1,451,2,1159
337449536,apache/jackrabbit-oak,23/08/18 01:05,spirals-bears,115b89a2-5f2f-4a9f-a894-a9ee1a0dcd59_02-18-week1-PASSING_AND_PASSING,6,0,0,695,1,2,26,0,1695,0,1,396,0,40,24,480,3366
337446706,apache/jackrabbit-oak,23/08/18 01:05,spirals-bears,115b89a2-5f2f-4a9f-a894-a9ee1a0dcd59_02-18-week1-PASSING_AND_PASSING,6,0,0,699,1,2,28,0,1711,0,1,383,0,37,24,459,3351
335778832,apache/jackrabbit-oak,23/08/18 01:06,spirals-bears,115b89a2-5f2f-4a9f-a894-a9ee1a0dcd59_02-18-week1-PASSING_AND_PASSING,36,0,2,1,34,1,74
336505630,apache/jackrabbit-oak,23/08/18 01:21,spirals-bears,115b89a2-5f2f-4a9f-a894-a9ee1a0dcd59_02-18-week1-PASSING_AND_PASSING,10,0,0,439,1,2,9,0,1688,0,1,385,0,37,14,450,3036
337936553,atomix/atomix,23/08/18 01:23,spirals-bears,115b89a2-5f2f-4a9f-a894-a9ee1a0dcd59_02-18-week1-PASSING_AND_PASSING,10,4,0,2,9,284,0,0,2,0,470,0,5,0,80,2,11,4,2,102,987
336176859,dropwizard/metrics,23/08/18 01:24,spirals-bears,115b89a2-5f2f-4a9f-a894-a9ee1a0dcd59_02-18-week1-PASSING_AND_PASSING,6,3,9
336176839,dropwizard/metrics,23/08/18 01:24,spirals-bears,115b89a2-5f2f-4a9f-a894-a9ee1a0dcd59_02-18-week1-PASSING_AND_PASSING,6,0,6
336172602,dropwizard/metrics,23/08/18 01:24,spirals-bears,115b89a2-5f2f-4a9f-a894-a9ee1a0dcd59_02-18-week1-PASSING_AND_PASSING,6,0,6
336170160,dropwizard/metrics,23/08/18 01:24,spirals-bears,115b89a2-5f2f-4a9f-a894-a9ee1a0dcd59_02-18-week1-PASSING_AND_PASSING,6,0,6
336059284,dropwizard/metrics,23/08/18 01:25,spirals-bears,115b89a2-5f2f-4a9f-a894-a9ee1a0dcd59_02-18-week1-PASSING_AND_PASSING,6,2,8
337468206,dropwizard/metrics,23/08/18 01:25,spirals-bears,115b89a2-5f2f-4a9f-a894-a9ee1a0dcd59_02-18-week1-PASSING_AND_PASSING,6,3,68,5,4,133,0,3,222
336059277,dropwizard/metrics,23/08/18 01:25,spirals-bears,115b89a2-5f2f-4a9f-a894-a9ee1a0dcd59_02-18-week1-PASSING_AND_PASSING,7,0,7
336092015,apache/jackrabbit-oak,23/08/18 01:25,spirals-bears,115b89a2-5f2f-4a9f-a894-a9ee1a0dcd59_02-18-week1-PASSING_AND_PASSING,36,0,666,2,1,483,1,1189
336043524,dropwizard/metrics,23/08/18 01:25,spirals-bears,115b89a2-5f2f-4a9f-a894-a9ee1a0dcd59_02-18-week1-PASSING_AND_PASSING,8,0,8
336043482,dropwizard/metrics,23/08/18 01:25,spirals-bears,115b89a2-5f2f-4a9f-a894-a9ee1a0dcd59_02-18-week1-PASSING_AND_PASSING,7,2,9
336034512,dropwizard/metrics,23/08/18 01:25,spirals-bears,115b89a2-5f2f-4a9f-a894-a9ee1a0dcd59_02-18-week1-PASSING_AND_PASSING,6,0,6
336034517,dropwizard/metrics,23/08/18 01:25,spirals-bears,115b89a2-5f2f-4a9f-a894-a9ee1a0dcd59_02-18-week1-PASSING_AND_PASSING,9,2,11
336355928,openzipkin/zipkin,23/08/18 01:26,spirals-bears,115b89a2-5f2f-4a9f-a894-a9ee1a0dcd59_02-18-week1-PASSING_AND_PASSING,26,2,28
336355327,openzipkin/zipkin,23/08/18 01:26,spirals-bears,115b89a2-5f2f-4a9f-a894-a9ee1a0dcd59_02-18-week1-PASSING_AND_PASSING,24,3,27
336055087,openzipkin/zipkin,23/08/18 01:27,spirals-bears,115b89a2-5f2f-4a9f-a894-a9ee1a0dcd59_02-18-week1-PASSING_AND_PASSING,24,2,26
336054486,openzipkin/zipkin,23/08/18 01:27,spirals-bears,115b89a2-5f2f-4a9f-a894-a9ee1a0dcd59_02-18-week1-PASSING_AND_PASSING,28,0,28
338517742,resteasy/Resteasy,23/08/18 01:27,spirals-bears,115b89a2-5f2f-4a9f-a894-a9ee1a0dcd59_02-18-week1-PASSING_AND_PASSING,21,2,1,24
338113584,resteasy/Resteasy,23/08/18 01:27,spirals-bears,115b89a2-5f2f-4a9f-a894-a9ee1a0dcd59_02-18-week1-PASSING_AND_PASSING,20,2,1,23
337487115,resteasy/Resteasy,23/08/18 01:28,spirals-bears,115b89a2-5f2f-4a9f-a894-a9ee1a0dcd59_02-18-week1-PASSING_AND_PASSING,19,3,1,23
337994922,resteasy/Resteasy,23/08/18 01:28,spirals-bears,115b89a2-5f2f-4a9f-a894-a9ee1a0dcd59_02-18-week1-PASSING_AND_PASSING,20,2,2,24
332722508,resteasy/Resteasy,23/08/18 01:28,spirals-bears,115b89a2-5f2f-4a9f-a894-a9ee1a0dcd59_02-18-week1-PASSING_AND_PASSING,19,2,1,22
332726279,resteasy/Resteasy,23/08/18 01:28,spirals-bears,115b89a2-5f2f-4a9f-a894-a9ee1a0dcd59_02-18-week1-PASSING_AND_PASSING,19,2,1,22
338426543,geoserver/geoserver,23/08/18 01:30,spirals-bears,115b89a2-5f2f-4a9f-a894-a9ee1a0dcd59_02-18-week1-PASSING_AND_PASSING,58,0,1,7,14,80
336651698,openzipkin/zipkin,23/08/18 01:35,spirals-bears,115b89a2-5f2f-4a9f-a894-a9ee1a0dcd59_02-18-week1-PASSING_AND_PASSING,25,0,264,1,0,297,0,0,587
336558494,apache/jackrabbit-oak,23/08/18 01:36,spirals-bears,115b89a2-5f2f-4a9f-a894-a9ee1a0dcd59_02-18-week1-PASSING_AND_PASSING,15,0,0,1681,0,2,22,0,1725,0,1,391,0,34,19,492,4382
338190439,geoserver/geoserver,23/08/18 01:38,spirals-bears,115b89a2-5f2f-4a9f-a894-a9ee1a0dcd59_02-18-week1-PASSING_AND_PASSING,52,0,1,3,402,5,463
338188246,geoserver/geoserver,23/08/18 01:43,spirals-bears,115b89a2-5f2f-4a9f-a894-a9ee1a0dcd59_02-18-week1-PASSING_AND_PASSING,55,0,1,3,378,5,442
284292896,geoserver/geoserver,23/08/18 01:43,spirals-bears,115b89a2-5f2f-4a9f-a894-a9ee1a0dcd59_02-18-week1-PASSING_AND_PASSING,55,0,0,9,343,14,421
337536807,geoserver/geoserver,23/08/18 01:45,spirals-bears,115b89a2-5f2f-4a9f-a894-a9ee1a0dcd59_02-18-week1-PASSING_AND_PASSING,56,0,1,7,16,80
337994885,geoserver/geoserver,23/08/18 01:46,spirals-bears,115b89a2-5f2f-4a9f-a894-a9ee1a0dcd59_02-18-week1-PASSING_AND_PASSING,55,0,2,3,372,5,437
337518360,geoserver/geoserver,23/08/18 01:46,spirals-bears,115b89a2-5f2f-4a9f-a894-a9ee1a0dcd59_02-18-week1-PASSING_AND_PASSING,56,7,63
337208402,geoserver/geoserver,23/08/18 01:47,spirals-bears,115b89a2-5f2f-4a9f-a894-a9ee1a0dcd59_02-18-week1-PASSING_AND_PASSING,57,9,66
336746724,geoserver/geoserver,23/08/18 01:51,spirals-bears,115b89a2-5f2f-4a9f-a894-a9ee1a0dcd59_02-18-week1-PASSING_AND_PASSING,53,0,1,3,387,5,449
336747715,geoserver/geoserver,23/08/18 01:55,spirals-bears,115b89a2-5f2f-4a9f-a894-a9ee1a0dcd59_02-18-week1-PASSING_AND_PASSING,12,0,0,450,0,1,31,0,402,1,1,36,1,55,28,570,1588
338492677,aicis/fresco,23/08/18 01:59,spirals-bears,115b89a2-5f2f-4a9f-a894-a9ee1a0dcd59_02-18-week1-PASSING_AND_PASSING,8,0,0,278,0,0,4,0,277,0,0,34,0,9,5,105,720
338045646,aicis/fresco,23/08/18 02:00,spirals-bears,115b89a2-5f2f-4a9f-a894-a9ee1a0dcd59_02-18-week1-PASSING_AND_PASSING,8,0,0,0,30,0,38
338466798,aicis/fresco,23/08/18 02:10,spirals-bears,115b89a2-5f2f-4a9f-a894-a9ee1a0dcd59_02-18-week1-PASSING_AND_PASSING,8,0,1329,0,0,101,0,0,1438
337701022,aicis/fresco,23/08/18 02:11,spirals-bears,115b89a2-5f2f-4a9f-a894-a9ee1a0dcd59_02-18-week1-PASSING_AND_PASSING,8,0,0,0,29,0,37
338441997,aicis/fresco,23/08/18 02:19,spirals-bears,115b89a2-5f2f-4a9f-a894-a9ee1a0dcd59_02-18-week1-PASSING_AND_PASSING,8,0,1298,0,0,92,0,0,1398
337553294,aicis/fresco,23/08/18 02:20,spirals-bears,115b89a2-5f2f-4a9f-a894-a9ee1a0dcd59_02-18-week1-PASSING_AND_PASSING,8,0,0,0,29,0,37
337552050,aicis/fresco,23/08/18 02:21,spirals-bears,115b89a2-5f2f-4a9f-a894-a9ee1a0dcd59_02-18-week1-PASSING_AND_PASSING,8,0,0,0,35,0,43
337479177,aicis/fresco,23/08/18 02:22,spirals-bears,115b89a2-5f2f-4a9f-a894-a9ee1a0dcd59_02-18-week1-PASSING_AND_PASSING,9,0,0,0,50,0,59
337465056,aicis/fresco,23/08/18 02:23,spirals-bears,115b89a2-5f2f-4a9f-a894-a9ee1a0dcd59_02-18-week1-PASSING_AND_PASSING,9,0,0,5,22,4,40
337465069,aicis/fresco,23/08/18 02:23,spirals-bears,115b89a2-5f2f-4a9f-a894-a9ee1a0dcd59_02-18-week1-PASSING_AND_PASSING,8,0,0,0,22,0,30
333645181,aicis/fresco,23/08/18 02:23,spirals-bears,115b89a2-5f2f-4a9f-a894-a9ee1a0dcd59_02-18-week1-PASSING_AND_PASSING,8,0,1304,0,0,83,0,0,1395
338441725,aicis/fresco,23/08/18 02:24,spirals-bears,115b89a2-5f2f-4a9f-a894-a9ee1a0dcd59_02-18-week1-PASSING_AND_PASSING,8,5,0,0,8,283,0,0,4,0,1516,0,0,0,36,0,8,6,5,89,1968
337462741,aicis/fresco,23/08/18 02:24,spirals-bears,115b89a2-5f2f-4a9f-a894-a9ee1a0dcd59_02-18-week1-PASSING_AND_PASSING,10,0,0,0,24,0,34
337517715,aicis/fresco,23/08/18 02:38,spirals-bears,115b89a2-5f2f-4a9f-a894-a9ee1a0dcd59_02-18-week1-PASSING_AND_PASSING,8,0,1541,0,0,86,0,0,1635
337456270,aicis/fresco,23/08/18 02:49,spirals-bears,115b89a2-5f2f-4a9f-a894-a9ee1a0dcd59_02-18-week1-PASSING_AND_PASSING,8,0,1402,0,0,92,0,0,1502
337456257,aicis/fresco,23/08/18 02:49,spirals-bears,115b89a2-5f2f-4a9f-a894-a9ee1a0dcd59_02-18-week1-PASSING_AND_PASSING,9,0,1386,0,5,90,0,3,1493
336580834,aicis/fresco,23/08/18 02:49,spirals-bears,115b89a2-5f2f-4a9f-a894-a9ee1a0dcd59_02-18-week1-PASSING_AND_PASSING,9,0,1441,0,0,90,0,0,1540
336106178,aicis/fresco,23/08/18 02:50,spirals-bears,115b89a2-5f2f-4a9f-a894-a9ee1a0dcd59_02-18-week1-PASSING_AND_PASSING,8,0,0,0,35,0,43
336106234,aicis/fresco,23/08/18 02:50,spirals-bears,115b89a2-5f2f-4a9f-a894-a9ee1a0dcd59_02-18-week1-PASSING_AND_PASSING,9,0,0,5,36,4,54
333650740,aicis/fresco,23/08/18 02:51,spirals-bears,115b89a2-5f2f-4a9f-a894-a9ee1a0dcd59_02-18-week1-PASSING_AND_PASSING,8,0,0,0,33,0,41
333650247,aicis/fresco,23/08/18 02:51,spirals-bears,115b89a2-5f2f-4a9f-a894-a9ee1a0dcd59_02-18-week1-PASSING_AND_PASSING,8,0,0,4,34,4,50
333235961,aicis/fresco,23/08/18 02:52,spirals-bears,115b89a2-5f2f-4a9f-a894-a9ee1a0dcd59_02-18-week1-PASSING_AND_PASSING,9,0,0,0,31,0,40
336580851,aicis/fresco,23/08/18 03:05,spirals-bears,115b89a2-5f2f-4a9f-a894-a9ee1a0dcd59_02-18-week1-PASSING_AND_PASSING,9,0,1505,0,4,89,0,3,1610
336458285,aicis/fresco,23/08/18 03:11,spirals-bears,115b89a2-5f2f-4a9f-a894-a9ee1a0dcd59_02-18-week1-PASSING_AND_PASSING,8,4,0,0,7,212,0,0,2,0,826,0,0,0,32,0,8,3,3,78,1183
336575712,aicis/fresco,23/08/18 03:13,spirals-bears,115b89a2-5f2f-4a9f-a894-a9ee1a0dcd59_02-18-week1-PASSING_AND_PASSING,8,0,1327,0,0,95,0,0,1430
336091412,aicis/fresco,23/08/18 03:18,spirals-bears,115b89a2-5f2f-4a9f-a894-a9ee1a0dcd59_02-18-week1-PASSING_AND_PASSING,9,0,1448,0,0,83,0,0,1540
336078789,aicis/fresco,23/08/18 03:19,spirals-bears,115b89a2-5f2f-4a9f-a894-a9ee1a0dcd59_02-18-week1-PASSING_AND_PASSING,8,0,0,4,21,3,36
336078780,aicis/fresco,23/08/18 03:19,spirals-bears,115b89a2-5f2f-4a9f-a894-a9ee1a0dcd59_02-18-week1-PASSING_AND_PASSING,8,0,0,0,21,0,29
336091420,aicis/fresco,23/08/18 03:31,spirals-bears,115b89a2-5f2f-4a9f-a894-a9ee1a0dcd59_02-18-week1-PASSING_AND_PASSING,8,0,1433,0,5,86,0,3,1535
336082481,aicis/fresco,23/08/18 03:37,spirals-bears,115b89a2-5f2f-4a9f-a894-a9ee1a0dcd59_02-18-week1-PASSING_AND_PASSING,9,0,1452,0,0,88,0,0,1549
336065755,aicis/fresco,23/08/18 03:38,spirals-bears,115b89a2-5f2f-4a9f-a894-a9ee1a0dcd59_02-18-week1-PASSING_AND_PASSING,9,0,0,0,33,0,42
336082493,aicis/fresco,23/08/18 03:39,spirals-bears,115b89a2-5f2f-4a9f-a894-a9ee1a0dcd59_02-18-week1-PASSING_AND_PASSING,8,0,1425,0,5,88,0,3,1529
336057537,aicis/fresco,23/08/18 03:45,spirals-bears,115b89a2-5f2f-4a9f-a894-a9ee1a0dcd59_02-18-week1-PASSING_AND_PASSING,9,0,1438,0,4,85,0,3,1539
337475524,swagger-api/swagger-codegen,23/08/18 03:46,spirals-bears,115b89a2-5f2f-4a9f-a894-a9ee1a0dcd59_02-18-week1-PASSING_AND_PASSING,31,0,0,6,6,43
338035566,swagger-api/swagger-codegen,23/08/18 03:48,spirals-bears,115b89a2-5f2f-4a9f-a894-a9ee1a0dcd59_02-18-week1-PASSING_AND_PASSING,32,0,0,1,67,2,102
334356315,swagger-api/swagger-codegen,23/08/18 03:49,spirals-bears,115b89a2-5f2f-4a9f-a894-a9ee1a0dcd59_02-18-week1-PASSING_AND_PASSING,31,0,0,6,6,43
331685744,swagger-api/swagger-codegen,23/08/18 03:51,spirals-bears,115b89a2-5f2f-4a9f-a894-a9ee1a0dcd59_02-18-week1-PASSING_AND_PASSING,32,0,0,7,63,7,109
336908604,swagger-api/swagger-codegen,23/08/18 03:53,spirals-bears,115b89a2-5f2f-4a9f-a894-a9ee1a0dcd59_02-18-week1-PASSING_AND_PASSING,31,0,0,9,64,8,112
334461753,swagger-api/swagger-codegen,23/08/18 03:55,spirals-bears,115b89a2-5f2f-4a9f-a894-a9ee1a0dcd59_02-18-week1-PASSING_AND_PASSING,33,0,0,8,65,8,114
336057522,aicis/fresco,23/08/18 03:57,spirals-bears,115b89a2-5f2f-4a9f-a894-a9ee1a0dcd59_02-18-week1-PASSING_AND_PASSING,8,0,1444,0,0,81,0,0,1533
336896595,swagger-api/swagger-codegen,23/08/18 03:57,spirals-bears,115b89a2-5f2f-4a9f-a894-a9ee1a0dcd59_02-18-week1-PASSING_AND_PASSING,33,0,0,10,68,8,119
335993786,swagger-api/swagger-codegen,23/08/18 03:58,spirals-bears,115b89a2-5f2f-4a9f-a894-a9ee1a0dcd59_02-18-week1-PASSING_AND_PASSING,38,0,0,0,2,40
337889244,Blazebit/blaze-persistence,23/08/18 03:58,spirals-bears,115b89a2-5f2f-4a9f-a894-a9ee1a0dcd59_02-18-week1-PASSING_AND_PASSING,11,4,15
337760373,spring-cloud/spring-cloud-gcp,23/08/18 03:58,spirals-bears,115b89a2-5f2f-4a9f-a894-a9ee1a0dcd59_02-18-week1-PASSING_AND_PASSING,4,2,6
335958592,swagger-api/swagger-codegen,23/08/18 03:59,spirals-bears,115b89a2-5f2f-4a9f-a894-a9ee1a0dcd59_02-18-week1-PASSING_AND_PASSING,33,0,0,2,69,2,106
336004901,aicis/fresco,23/08/18 04:05,spirals-bears,115b89a2-5f2f-4a9f-a894-a9ee1a0dcd59_02-18-week1-PASSING_AND_PASSING,7,0,1502,0,0,85,0,0,1594
336005332,aicis/fresco,23/08/18 04:05,spirals-bears,115b89a2-5f2f-4a9f-a894-a9ee1a0dcd59_02-18-week1-PASSING_AND_PASSING,8,0,1466,0,5,86,0,3,1568
336642689,spring-cloud/spring-cloud-gcp,23/08/18 04:05,spirals-bears,115b89a2-5f2f-4a9f-a894-a9ee1a0dcd59_02-18-week1-PASSING_AND_PASSING,5,2,7
336024867,spring-cloud/spring-cloud-gcp,23/08/18 04:05,spirals-bears,115b89a2-5f2f-4a9f-a894-a9ee1a0dcd59_02-18-week1-PASSING_AND_PASSING,5,2,7
336670126,spring-cloud/spring-cloud-gcp,23/08/18 04:06,spirals-bears,115b89a2-5f2f-4a9f-a894-a9ee1a0dcd59_02-18-week1-PASSING_AND_PASSING,4,91,92,0,191,0,378
336258817,spring-cloud/spring-cloud-gcp,23/08/18 04:06,spirals-bears,115b89a2-5f2f-4a9f-a894-a9ee1a0dcd59_02-18-week1-PASSING_AND_PASSING,4,2,6
337584141,spring-cloud/spring-cloud-gcp,23/08/18 04:10,spirals-bears,115b89a2-5f2f-4a9f-a894-a9ee1a0dcd59_02-18-week1-PASSING_AND_PASSING,4,114,59,106,0,417,0,0,700
336198475,spring-cloud/spring-cloud-gcp,23/08/18 04:10,spirals-bears,115b89a2-5f2f-4a9f-a894-a9ee1a0dcd59_02-18-week1-PASSING_AND_PASSING,4,2,6
336615834,spring-cloud/spring-cloud-gcp,23/08/18 04:13,spirals-bears,115b89a2-5f2f-4a9f-a894-a9ee1a0dcd59_02-18-week1-PASSING_AND_PASSING,4,93,99,0,257,0,453
335538159,spring-cloud/spring-cloud-gcp,23/08/18 04:13,spirals-bears,115b89a2-5f2f-4a9f-a894-a9ee1a0dcd59_02-18-week1-PASSING_AND_PASSING,4,1,5
334619736,apache/incubator-servicecomb-saga,23/08/18 04:13,spirals-bears,115b89a2-5f2f-4a9f-a894-a9ee1a0dcd59_02-18-week1-PASSING_AND_PASSING,4,3,7
336867158,datastax/java-driver,23/08/18 04:17,spirals-bears,115b89a2-5f2f-4a9f-a894-a9ee1a0dcd59_02-18-week1-PASSING_AND_PASSING,17,0,69,0,5,103,0,6,200
336256442,spring-cloud/spring-cloud-gcp,23/08/18 04:19,spirals-bears,115b89a2-5f2f-4a9f-a894-a9ee1a0dcd59_02-18-week1-PASSING_AND_PASSING,4,394,162,0,208,0,768
336267519,spring-cloud/spring-cloud-gcp,23/08/18 04:21,spirals-bears,115b89a2-5f2f-4a9f-a894-a9ee1a0dcd59_02-18-week1-PASSING_AND_PASSING,5,240,54,196,0,403,0,0,898
337556373,MariaDB/mariadb-connector-j,23/08/18 04:22,spirals-bears,115b89a2-5f2f-4a9f-a894-a9ee1a0dcd59_02-18-week1-PASSING_AND_PASSING,11,0,0,18,0,0,1,0,19,0,0,33,0,9,1,61,153
337464501,MariaDB/mariadb-connector-j,23/08/18 04:23,spirals-bears,115b89a2-5f2f-4a9f-a894-a9ee1a0dcd59_02-18-week1-PASSING_AND_PASSING,12,0,0,19,0,0,1,0,17,0,0,35,0,7,1,59,151
335644995,MariaDB/mariadb-connector-j,23/08/18 04:24,spirals-bears,115b89a2-5f2f-4a9f-a894-a9ee1a0dcd59_02-18-week1-PASSING_AND_PASSING,10,0,0,18,0,0,1,0,17,0,0,33,0,9,1,64,153
336247006,spring-cloud/spring-cloud-gcp,23/08/18 04:25,spirals-bears,115b89a2-5f2f-4a9f-a894-a9ee1a0dcd59_02-18-week1-PASSING_AND_PASSING,26,1,120,0,7,55,0,129,1,1,56,0,0,0,66,0,4,1,4,395,866
338455049,dhis2/dhis2-core,23/08/18 04:27,spirals-bears,115b89a2-5f2f-4a9f-a894-a9ee1a0dcd59_02-18-week1-PASSING_AND_PASSING,26,0,0,6,83,5,120
338425891,dhis2/dhis2-core,23/08/18 04:29,spirals-bears,115b89a2-5f2f-4a9f-a894-a9ee1a0dcd59_02-18-week1-PASSING_AND_PASSING,23,0,0,1,81,1,106
336545700,vaadin/vaadin-components-testbench,23/08/18 04:30,spirals-bears,115b89a2-5f2f-4a9f-a894-a9ee1a0dcd59_02-18-week1-PASSING_AND_PASSING,3,0,5,0,762,0,770
337975190,dhis2/dhis2-core,23/08/18 04:30,spirals-bears,115b89a2-5f2f-4a9f-a894-a9ee1a0dcd59_02-18-week1-PASSING_AND_PASSING,23,3,26
338308059,dhis2/dhis2-core,23/08/18 04:32,spirals-bears,115b89a2-5f2f-4a9f-a894-a9ee1a0dcd59_02-18-week1-PASSING_AND_PASSING,24,0,1,1,91,2,119
337908643,dhis2/dhis2-core,23/08/18 04:33,spirals-bears,115b89a2-5f2f-4a9f-a894-a9ee1a0dcd59_02-18-week1-PASSING_AND_PASSING,22,0,0,1,37,1,61
338093827,dhis2/dhis2-core,23/08/18 04:35,spirals-bears,115b89a2-5f2f-4a9f-a894-a9ee1a0dcd59_02-18-week1-PASSING_AND_PASSING,21,0,0,1,231,2,255
338092862,dhis2/dhis2-core,23/08/18 04:35,spirals-bears,115b89a2-5f2f-4a9f-a894-a9ee1a0dcd59_02-18-week1-PASSING_AND_PASSING,22,0,0,4,76,5,107
337765651,danglotb/dspot,23/08/18 04:35,spirals-bears,115b89a2-5f2f-4a9f-a894-a9ee1a0dcd59_02-18-week1-PASSING_AND_PASSING,6,0,492,0,0,192,0,0,690
337386684,dhis2/dhis2-core,23/08/18 04:35,spirals-bears,115b89a2-5f2f-4a9f-a894-a9ee1a0dcd59_02-18-week1-PASSING_AND_PASSING,22,3,25
337845604,dhis2/dhis2-core,23/08/18 04:36,spirals-bears,115b89a2-5f2f-4a9f-a894-a9ee1a0dcd59_02-18-week1-PASSING_AND_PASSING,23,0,0,1,37,1,62
337646430,danglotb/dspot,23/08/18 04:36,spirals-bears,115b89a2-5f2f-4a9f-a894-a9ee1a0dcd59_02-18-week1-PASSING_AND_PASSING,9,0,0,474,0,0,0,0,9,0,0,49,0,5,0,136,682
337602141,dhis2/dhis2-core,23/08/18 04:37,spirals-bears,115b89a2-5f2f-4a9f-a894-a9ee1a0dcd59_02-18-week1-PASSING_AND_PASSING,22,0,0,5,87,8,122
337591742,dhis2/dhis2-core,23/08/18 04:37,spirals-bears,115b89a2-5f2f-4a9f-a894-a9ee1a0dcd59_02-18-week1-PASSING_AND_PASSING,23,0,0,5,89,5,122
337371198,dhis2/dhis2-core,23/08/18 04:38,spirals-bears,115b89a2-5f2f-4a9f-a894-a9ee1a0dcd59_02-18-week1-PASSING_AND_PASSING,24,3,27
337515023,dhis2/dhis2-core,23/08/18 04:38,spirals-bears,115b89a2-5f2f-4a9f-a894-a9ee1a0dcd59_02-18-week1-PASSING_AND_PASSING,25,0,0,1,88,1,115
337553194,dhis2/dhis2-core,23/08/18 04:38,spirals-bears,115b89a2-5f2f-4a9f-a894-a9ee1a0dcd59_02-18-week1-PASSING_AND_PASSING,23,0,1,7,87,6,124
336437016,dhis2/dhis2-core,23/08/18 04:39,spirals-bears,115b89a2-5f2f-4a9f-a894-a9ee1a0dcd59_02-18-week1-PASSING_AND_PASSING,24,3,27
336805761,dhis2/dhis2-core,23/08/18 04:39,spirals-bears,115b89a2-5f2f-4a9f-a894-a9ee1a0dcd59_02-18-week1-PASSING_AND_PASSING,26,3,29
337655375,debezium/debezium,23/08/18 04:39,spirals-bears,115b89a2-5f2f-4a9f-a894-a9ee1a0dcd59_02-18-week1-PASSING_AND_PASSING,6,5,11
337123661,dhis2/dhis2-core,23/08/18 04:40,spirals-bears,115b89a2-5f2f-4a9f-a894-a9ee1a0dcd59_02-18-week1-PASSING_AND_PASSING,24,0,0,1,90,1,116
335551308,debezium/debezium,23/08/18 04:40,spirals-bears,115b89a2-5f2f-4a9f-a894-a9ee1a0dcd59_02-18-week1-PASSING_AND_PASSING,7,6,13
336470488,dhis2/dhis2-core,23/08/18 04:40,spirals-bears,115b89a2-5f2f-4a9f-a894-a9ee1a0dcd59_02-18-week1-PASSING_AND_PASSING,24,0,0,2,85,1,112
336435578,dhis2/dhis2-core,23/08/18 04:41,spirals-bears,115b89a2-5f2f-4a9f-a894-a9ee1a0dcd59_02-18-week1-PASSING_AND_PASSING,25,0,0,1,84,2,112
336450795,debezium/debezium,23/08/18 04:42,spirals-bears,115b89a2-5f2f-4a9f-a894-a9ee1a0dcd59_02-18-week1-PASSING_AND_PASSING,6,0,0,0,114,0,120
336102802,debezium/debezium,23/08/18 04:42,spirals-bears,115b89a2-5f2f-4a9f-a894-a9ee1a0dcd59_02-18-week1-PASSING_AND_PASSING,7,0,0,4,112,5,128
334924325,debezium/debezium,23/08/18 04:42,spirals-bears,115b89a2-5f2f-4a9f-a894-a9ee1a0dcd59_02-18-week1-PASSING_AND_PASSING,7,0,1,4,83,4,99
329347184,fabric8io/fabric8-maven-plugin,23/08/18 04:43,spirals-bears,115b89a2-5f2f-4a9f-a894-a9ee1a0dcd59_02-18-week1-PASSING_AND_PASSING,32,0,2,4,8,46
331713529,MyCoRe-Org/mycore,23/08/18 04:43,spirals-bears,115b89a2-5f2f-4a9f-a894-a9ee1a0dcd59_02-18-week1-PASSING_AND_PASSING,57,0,57
338007399,Activiti/Activiti,23/08/18 04:43,spirals-bears,115b89a2-5f2f-4a9f-a894-a9ee1a0dcd59_02-18-week1-PASSING_AND_PASSING,34,0,2,2,17,4,59
335043863,debezium/debezium,23/08/18 04:44,spirals-bears,115b89a2-5f2f-4a9f-a894-a9ee1a0dcd59_02-18-week1-PASSING_AND_PASSING,7,0,48,0,0,98,0,0,153
338002279,Activiti/Activiti,23/08/18 04:44,spirals-bears,115b89a2-5f2f-4a9f-a894-a9ee1a0dcd59_02-18-week1-PASSING_AND_PASSING,33,0,2,1,15,5,56
337293266,Activiti/Activiti,23/08/18 04:44,spirals-bears,115b89a2-5f2f-4a9f-a894-a9ee1a0dcd59_02-18-week1-PASSING_AND_PASSING,34,0,2,1,15,4,56
336661772,Activiti/Activiti,23/08/18 04:44,spirals-bears,115b89a2-5f2f-4a9f-a894-a9ee1a0dcd59_02-18-week1-PASSING_AND_PASSING,32,0,3,1,19,4,59
338485912,Spirals-Team/repairnator,23/08/18 04:45,spirals-bears,115b89a2-5f2f-4a9f-a894-a9ee1a0dcd59_02-18-week1-PASSING_AND_PASSING,18,0,0,11,29
337929201,Spirals-Team/repairnator,23/08/18 04:45,spirals-bears,115b89a2-5f2f-4a9f-a894-a9ee1a0dcd59_02-18-week1-PASSING_AND_PASSING,23,0,0,2,25
337929269,Spirals-Team/repairnator,23/08/18 04:45,spirals-bears,115b89a2-5f2f-4a9f-a894-a9ee1a0dcd59_02-18-week1-PASSING_AND_PASSING,18,8,26
337929254,Spirals-Team/repairnator,23/08/18 04:45,spirals-bears,115b89a2-5f2f-4a9f-a894-a9ee1a0dcd59_02-18-week1-PASSING_AND_PASSING,19,0,19
335687901,Spirals-Team/repairnator,23/08/18 04:45,spirals-bears,115b89a2-5f2f-4a9f-a894-a9ee1a0dcd59_02-18-week1-PASSING_AND_PASSING,20,0,1,1,22
336296167,jnidzwetzki/bboxdb,23/08/18 04:46,spirals-bears,115b89a2-5f2f-4a9f-a894-a9ee1a0dcd59_02-18-week1-PASSING_AND_PASSING,8,0,0,0,36,0,44
335969309,jnidzwetzki/bboxdb,23/08/18 04:50,spirals-bears,115b89a2-5f2f-4a9f-a894-a9ee1a0dcd59_02-18-week1-PASSING_AND_PASSING,5,0,0,23,0,0,1,0,38,0,0,65,0,8,1,128,269
338083999,jnidzwetzki/bboxdb,23/08/18 04:50,spirals-bears,115b89a2-5f2f-4a9f-a894-a9ee1a0dcd59_02-18-week1-PASSING_AND_PASSING,6,0,0,37,0,0,1,0,37,0,0,64,0,8,2,130,285
336870249,jacoco/jacoco,23/08/18 04:50,spirals-bears,115b89a2-5f2f-4a9f-a894-a9ee1a0dcd59_02-18-week1-PASSING_AND_PASSING,5,0,2,0,7
336360509,jacoco/jacoco,23/08/18 04:51,spirals-bears,115b89a2-5f2f-4a9f-a894-a9ee1a0dcd59_02-18-week1-PASSING_AND_PASSING,7,0,0,0,7
336721064,jacoco/jacoco,23/08/18 04:51,spirals-bears,115b89a2-5f2f-4a9f-a894-a9ee1a0dcd59_02-18-week1-PASSING_AND_PASSING,6,2,8
336721039,jacoco/jacoco,23/08/18 04:51,spirals-bears,115b89a2-5f2f-4a9f-a894-a9ee1a0dcd59_02-18-week1-PASSING_AND_PASSING,7,0,7
335539634,jnidzwetzki/bboxdb,23/08/18 04:51,spirals-bears,115b89a2-5f2f-4a9f-a894-a9ee1a0dcd59_02-18-week1-PASSING_AND_PASSING,5,0,0,37,0,0,1,0,37,0,0,66,0,8,1,131,286
326780752,Activiti/Activiti,23/08/18 04:53,spirals-bears,115b89a2-5f2f-4a9f-a894-a9ee1a0dcd59_02-18-week1-PASSING_AND_PASSING,31,0,448,1,2,68,1,6,557
