362624551,apache/flink,02/09/18 13:19,spirals-bears,97c942ad-a60e-4cfe-b325-5fa5c5215b2e_04-18-week2-FAILING_AND_PASSING,60,9,69
365069226,apache/flink,02/09/18 13:19,spirals-bears,97c942ad-a60e-4cfe-b325-5fa5c5215b2e_04-18-week2-FAILING_AND_PASSING,68,8,76
365182529,apache/flink,02/09/18 13:20,spirals-bears,97c942ad-a60e-4cfe-b325-5fa5c5215b2e_04-18-week2-FAILING_AND_PASSING,61,6,67
365387280,apache/flink,02/09/18 13:21,spirals-bears,97c942ad-a60e-4cfe-b325-5fa5c5215b2e_04-18-week2-FAILING_AND_PASSING,62,8,70
364531601,apache/flink,02/09/18 13:22,spirals-bears,97c942ad-a60e-4cfe-b325-5fa5c5215b2e_04-18-week2-FAILING_AND_PASSING,62,8,70
362525690,apache/flink,02/09/18 13:22,spirals-bears,97c942ad-a60e-4cfe-b325-5fa5c5215b2e_04-18-week2-FAILING_AND_PASSING,65,9,74
361466231,apache/flink,02/09/18 13:23,spirals-bears,97c942ad-a60e-4cfe-b325-5fa5c5215b2e_04-18-week2-FAILING_AND_PASSING,61,5,66
363692873,apache/flink,02/09/18 13:25,spirals-bears,97c942ad-a60e-4cfe-b325-5fa5c5215b2e_04-18-week2-FAILING_AND_PASSING,59,5,64
365894900,prestodb/presto,02/09/18 13:26,spirals-bears,97c942ad-a60e-4cfe-b325-5fa5c5215b2e_04-18-week2-FAILING_AND_PASSING,45,7,52
366353323,prestodb/presto,02/09/18 13:27,spirals-bears,97c942ad-a60e-4cfe-b325-5fa5c5215b2e_04-18-week2-FAILING_AND_PASSING,43,4,47
365863090,prestodb/presto,02/09/18 13:27,spirals-bears,97c942ad-a60e-4cfe-b325-5fa5c5215b2e_04-18-week2-FAILING_AND_PASSING,46,3,49
365881615,prestodb/presto,02/09/18 13:28,spirals-bears,97c942ad-a60e-4cfe-b325-5fa5c5215b2e_04-18-week2-FAILING_AND_PASSING,43,6,49
365804070,prestodb/presto,02/09/18 13:29,spirals-bears,97c942ad-a60e-4cfe-b325-5fa5c5215b2e_04-18-week2-FAILING_AND_PASSING,42,4,46
365452682,prestodb/presto,02/09/18 13:30,spirals-bears,97c942ad-a60e-4cfe-b325-5fa5c5215b2e_04-18-week2-FAILING_AND_PASSING,47,5,52
365483028,prestodb/presto,02/09/18 14:01,spirals-bears,97c942ad-a60e-4cfe-b325-5fa5c5215b2e_04-18-week2-FAILING_AND_PASSING,840,923,42,0,1,1,1807
365424336,prestodb/presto,02/09/18 14:02,spirals-bears,97c942ad-a60e-4cfe-b325-5fa5c5215b2e_04-18-week2-FAILING_AND_PASSING,42,6,48
365291899,prestodb/presto,02/09/18 14:03,spirals-bears,97c942ad-a60e-4cfe-b325-5fa5c5215b2e_04-18-week2-FAILING_AND_PASSING,44,4,48
364860177,prestodb/presto,02/09/18 14:04,spirals-bears,97c942ad-a60e-4cfe-b325-5fa5c5215b2e_04-18-week2-FAILING_AND_PASSING,43,6,49
365680847,apache/flink,02/09/18 14:05,spirals-bears,97c942ad-a60e-4cfe-b325-5fa5c5215b2e_04-18-week2-FAILING_AND_PASSING,10,0,2,0,2,183,1,43,771,6,80,1601,83,3,2785
364856390,prestodb/presto,02/09/18 14:05,spirals-bears,97c942ad-a60e-4cfe-b325-5fa5c5215b2e_04-18-week2-FAILING_AND_PASSING,46,6,52
364844993,prestodb/presto,02/09/18 14:06,spirals-bears,97c942ad-a60e-4cfe-b325-5fa5c5215b2e_04-18-week2-FAILING_AND_PASSING,46,4,50
364727783,prestodb/presto,02/09/18 14:06,spirals-bears,97c942ad-a60e-4cfe-b325-5fa5c5215b2e_04-18-week2-FAILING_AND_PASSING,43,4,47
364420416,prestodb/presto,02/09/18 14:07,spirals-bears,97c942ad-a60e-4cfe-b325-5fa5c5215b2e_04-18-week2-FAILING_AND_PASSING,44,6,50
363107337,apache/flink,02/09/18 14:07,spirals-bears,97c942ad-a60e-4cfe-b325-5fa5c5215b2e_04-18-week2-FAILING_AND_PASSING,12,0,2,0,2,123,0,35,760,4,67,1625,62,1,2693
364034958,prestodb/presto,02/09/18 14:08,spirals-bears,97c942ad-a60e-4cfe-b325-5fa5c5215b2e_04-18-week2-FAILING_AND_PASSING,44,11,55
364333451,prestodb/presto,02/09/18 14:08,spirals-bears,97c942ad-a60e-4cfe-b325-5fa5c5215b2e_04-18-week2-FAILING_AND_PASSING,55,5,60
364115416,prestodb/presto,02/09/18 14:09,spirals-bears,97c942ad-a60e-4cfe-b325-5fa5c5215b2e_04-18-week2-FAILING_AND_PASSING,46,5,51
363087141,prestodb/presto,02/09/18 14:09,spirals-bears,97c942ad-a60e-4cfe-b325-5fa5c5215b2e_04-18-week2-FAILING_AND_PASSING,43,9,52
361484214,apache/flink,02/09/18 14:10,spirals-bears,97c942ad-a60e-4cfe-b325-5fa5c5215b2e_04-18-week2-FAILING_AND_PASSING,11,0,7,0,2,191,0,51,1086,16,70,1617,62,1,3114
364495561,prestodb/presto,02/09/18 14:35,spirals-bears,97c942ad-a60e-4cfe-b325-5fa5c5215b2e_04-18-week2-FAILING_AND_PASSING,791,880,48,0,1,3,1723
365438163,apache/incubator-druid,02/09/18 14:47,spirals-bears,97c942ad-a60e-4cfe-b325-5fa5c5215b2e_04-18-week2-FAILING_AND_PASSING,1258,940,38,0,3,1,2240
364561710,apache/incubator-druid,02/09/18 14:49,spirals-bears,97c942ad-a60e-4cfe-b325-5fa5c5215b2e_04-18-week2-FAILING_AND_PASSING,1121,1146,39,0,11,1,2318
364360180,apache/incubator-druid,02/09/18 14:50,spirals-bears,97c942ad-a60e-4cfe-b325-5fa5c5215b2e_04-18-week2-FAILING_AND_PASSING,44,9,53
364432054,apache/incubator-druid,02/09/18 15:14,spirals-bears,97c942ad-a60e-4cfe-b325-5fa5c5215b2e_04-18-week2-FAILING_AND_PASSING,12,0,3,1,1,9,0,252,544,0,67,525,65,0,1479
364394496,apache/incubator-druid,02/09/18 15:20,spirals-bears,97c942ad-a60e-4cfe-b325-5fa5c5215b2e_04-18-week2-FAILING_AND_PASSING,1230,504,35,0,2,1,1772
364724586,apache/incubator-druid,02/09/18 15:20,spirals-bears,97c942ad-a60e-4cfe-b325-5fa5c5215b2e_04-18-week2-FAILING_AND_PASSING,1239,1421,33,0,10,1,2704
365873417,apache/incubator-druid,02/09/18 15:28,spirals-bears,97c942ad-a60e-4cfe-b325-5fa5c5215b2e_04-18-week2-FAILING_AND_PASSING,12,0,3,2,1,258,0,1970,339,2,1483,542,36,86,4734
364386856,apache/incubator-druid,02/09/18 15:39,spirals-bears,97c942ad-a60e-4cfe-b325-5fa5c5215b2e_04-18-week2-FAILING_AND_PASSING,486,513,53,0,2,1,16,1071
364386637,apache/incubator-druid,02/09/18 16:17,spirals-bears,97c942ad-a60e-4cfe-b325-5fa5c5215b2e_04-18-week2-FAILING_AND_PASSING,8,0,3,1,43,0,1079,349,0,1340,522,37,3,3385
364200188,apache/incubator-druid,02/09/18 16:18,spirals-bears,97c942ad-a60e-4cfe-b325-5fa5c5215b2e_04-18-week2-FAILING_AND_PASSING,1143,1031,56,0,8,1,2239
364199458,apache/incubator-druid,02/09/18 16:20,spirals-bears,97c942ad-a60e-4cfe-b325-5fa5c5215b2e_04-18-week2-FAILING_AND_PASSING,42,14,56
363775101,apache/incubator-druid,02/09/18 16:20,spirals-bears,97c942ad-a60e-4cfe-b325-5fa5c5215b2e_04-18-week2-FAILING_AND_PASSING,49,15,64
364781449,thelastpickle/cassandra-reaper,02/09/18 16:20,spirals-bears,97c942ad-a60e-4cfe-b325-5fa5c5215b2e_04-18-week2-FAILING_AND_PASSING,7,0,7
364998553,thelastpickle/cassandra-reaper,02/09/18 16:20,spirals-bears,97c942ad-a60e-4cfe-b325-5fa5c5215b2e_04-18-week2-FAILING_AND_PASSING,9,0,9
365357656,jruby/jruby,02/09/18 16:24,spirals-bears,97c942ad-a60e-4cfe-b325-5fa5c5215b2e_04-18-week2-FAILING_AND_PASSING,17,148,105,0,3,3,0,276
363495528,apache/incubator-druid,02/09/18 16:51,spirals-bears,97c942ad-a60e-4cfe-b325-5fa5c5215b2e_04-18-week2-FAILING_AND_PASSING,10,0,2,1,1,56,0,1785,938,1,1629,918,46,2,5389
364172253,apache/incubator-druid,02/09/18 16:53,spirals-bears,97c942ad-a60e-4cfe-b325-5fa5c5215b2e_04-18-week2-FAILING_AND_PASSING,11,0,11,0,1,68,0,1541,443,5,1728,1068,48,148,5072
366598729,JMRI/JMRI,02/09/18 16:59,spirals-bears,97c942ad-a60e-4cfe-b325-5fa5c5215b2e_04-18-week2-FAILING_AND_PASSING,1703,117,11,306,0,4,0,70,0,110,2,1,2324
366402152,JMRI/JMRI,02/09/18 17:12,spirals-bears,97c942ad-a60e-4cfe-b325-5fa5c5215b2e_04-18-week2-FAILING_AND_PASSING,1588,264,10,737,0,27,0,100,0,86,13,8,2833
364663215,JMRI/JMRI,02/09/18 17:17,spirals-bears,97c942ad-a60e-4cfe-b325-5fa5c5215b2e_04-18-week2-FAILING_AND_PASSING,279,0,279
366258246,JMRI/JMRI,02/09/18 17:28,spirals-bears,97c942ad-a60e-4cfe-b325-5fa5c5215b2e_04-18-week2-FAILING_AND_PASSING,1579,119,11,296,0,25,0,100,0,91,6,11,2238
365205929,JMRI/JMRI,02/09/18 17:31,spirals-bears,97c942ad-a60e-4cfe-b325-5fa5c5215b2e_04-18-week2-FAILING_AND_PASSING,1671,117,14,263,0,3,0,124,0,87,8,4,2291
365240551,JMRI/JMRI,02/09/18 17:35,spirals-bears,97c942ad-a60e-4cfe-b325-5fa5c5215b2e_04-18-week2-FAILING_AND_PASSING,1685,103,260,0,41,0,6,2095
363969140,JMRI/JMRI,02/09/18 17:54,spirals-bears,97c942ad-a60e-4cfe-b325-5fa5c5215b2e_04-18-week2-FAILING_AND_PASSING,1643,116,401,0,25,0,10,2195
364906888,apache/nifi,02/09/18 17:58,spirals-bears,97c942ad-a60e-4cfe-b325-5fa5c5215b2e_04-18-week2-FAILING_AND_PASSING,1329,42,1,9,3,1384
353468148,apache/nifi,02/09/18 17:59,spirals-bears,97c942ad-a60e-4cfe-b325-5fa5c5215b2e_04-18-week2-FAILING_AND_PASSING,36,5,41
364609883,apache/nifi,02/09/18 18:00,spirals-bears,97c942ad-a60e-4cfe-b325-5fa5c5215b2e_04-18-week2-FAILING_AND_PASSING,40,6,46
363955892,JMRI/JMRI,02/09/18 18:07,spirals-bears,97c942ad-a60e-4cfe-b325-5fa5c5215b2e_04-18-week2-FAILING_AND_PASSING,1767,214,274,0,3,2,16,2276
337853651,apache/nifi,02/09/18 18:08,spirals-bears,97c942ad-a60e-4cfe-b325-5fa5c5215b2e_04-18-week2-FAILING_AND_PASSING,43,8,51
364320935,apache/nifi,02/09/18 18:09,spirals-bears,97c942ad-a60e-4cfe-b325-5fa5c5215b2e_04-18-week2-FAILING_AND_PASSING,38,7,45
366216634,INRIA/spoon,02/09/18 18:09,spirals-bears,97c942ad-a60e-4cfe-b325-5fa5c5215b2e_04-18-week2-FAILING_AND_PASSING,14,4,18
363645070,JMRI/JMRI,02/09/18 18:12,spirals-bears,97c942ad-a60e-4cfe-b325-5fa5c5215b2e_04-18-week2-FAILING_AND_PASSING,1762,111,14,304,0,3,0,139,0,74,15,1,2423
364735732,apache/nifi,02/09/18 18:23,spirals-bears,97c942ad-a60e-4cfe-b325-5fa5c5215b2e_04-18-week2-FAILING_AND_PASSING,1654,40,1,2,3,1700
362671831,apache/nifi,02/09/18 18:24,spirals-bears,97c942ad-a60e-4cfe-b325-5fa5c5215b2e_04-18-week2-FAILING_AND_PASSING,1340,42,2,10,3,1397
365824487,INRIA/spoon,02/09/18 18:24,spirals-bears,97c942ad-a60e-4cfe-b325-5fa5c5215b2e_04-18-week2-FAILING_AND_PASSING,14,9,0,5,20,48
366162512,INRIA/spoon,02/09/18 18:25,spirals-bears,97c942ad-a60e-4cfe-b325-5fa5c5215b2e_04-18-week2-FAILING_AND_PASSING,8,0,5,0,0,4,0,554,17,2,114,58,10,0,772
364144025,INRIA/spoon,02/09/18 18:26,spirals-bears,97c942ad-a60e-4cfe-b325-5fa5c5215b2e_04-18-week2-FAILING_AND_PASSING,9,6,15
366082769,EnMasseProject/enmasse,02/09/18 18:26,spirals-bears,97c942ad-a60e-4cfe-b325-5fa5c5215b2e_04-18-week2-FAILING_AND_PASSING,27,0,27
364975002,EnMasseProject/enmasse,02/09/18 18:27,spirals-bears,97c942ad-a60e-4cfe-b325-5fa5c5215b2e_04-18-week2-FAILING_AND_PASSING,25,3,28
365095402,EnMasseProject/enmasse,02/09/18 18:28,spirals-bears,97c942ad-a60e-4cfe-b325-5fa5c5215b2e_04-18-week2-FAILING_AND_PASSING,24,3,27
364097827,EnMasseProject/enmasse,02/09/18 18:28,spirals-bears,97c942ad-a60e-4cfe-b325-5fa5c5215b2e_04-18-week2-FAILING_AND_PASSING,25,0,25
364097837,EnMasseProject/enmasse,02/09/18 18:29,spirals-bears,97c942ad-a60e-4cfe-b325-5fa5c5215b2e_04-18-week2-FAILING_AND_PASSING,25,3,28
362519843,EnMasseProject/enmasse,02/09/18 18:29,spirals-bears,97c942ad-a60e-4cfe-b325-5fa5c5215b2e_04-18-week2-FAILING_AND_PASSING,27,2,29
366361487,batfish/batfish,02/09/18 18:30,spirals-bears,97c942ad-a60e-4cfe-b325-5fa5c5215b2e_04-18-week2-FAILING_AND_PASSING,50,3,53
366224439,INRIA/spoon,02/09/18 18:31,spirals-bears,97c942ad-a60e-4cfe-b325-5fa5c5215b2e_04-18-week2-FAILING_AND_PASSING,8,0,5,0,0,6,0,563,17,3,577,63,12,0,1254
366361464,batfish/batfish,02/09/18 18:31,spirals-bears,97c942ad-a60e-4cfe-b325-5fa5c5215b2e_04-18-week2-FAILING_AND_PASSING,51,0,51
366400740,batfish/batfish,02/09/18 18:31,spirals-bears,97c942ad-a60e-4cfe-b325-5fa5c5215b2e_04-18-week2-FAILING_AND_PASSING,47,3,50
366400732,batfish/batfish,02/09/18 18:33,spirals-bears,97c942ad-a60e-4cfe-b325-5fa5c5215b2e_04-18-week2-FAILING_AND_PASSING,57,0,57
366389131,batfish/batfish,02/09/18 18:33,spirals-bears,97c942ad-a60e-4cfe-b325-5fa5c5215b2e_04-18-week2-FAILING_AND_PASSING,52,3,55
365711453,batfish/batfish,02/09/18 18:34,spirals-bears,97c942ad-a60e-4cfe-b325-5fa5c5215b2e_04-18-week2-FAILING_AND_PASSING,53,0,53
365711555,batfish/batfish,02/09/18 18:34,spirals-bears,97c942ad-a60e-4cfe-b325-5fa5c5215b2e_04-18-week2-FAILING_AND_PASSING,51,4,55
364389747,batfish/batfish,02/09/18 18:35,spirals-bears,97c942ad-a60e-4cfe-b325-5fa5c5215b2e_04-18-week2-FAILING_AND_PASSING,49,4,53
365234030,batfish/batfish,02/09/18 18:35,spirals-bears,97c942ad-a60e-4cfe-b325-5fa5c5215b2e_04-18-week2-FAILING_AND_PASSING,61,0,61
365281115,batfish/batfish,02/09/18 18:36,spirals-bears,97c942ad-a60e-4cfe-b325-5fa5c5215b2e_04-18-week2-FAILING_AND_PASSING,51,0,51
365250419,batfish/batfish,02/09/18 18:36,spirals-bears,97c942ad-a60e-4cfe-b325-5fa5c5215b2e_04-18-week2-FAILING_AND_PASSING,51,3,54
364824369,batfish/batfish,02/09/18 18:37,spirals-bears,97c942ad-a60e-4cfe-b325-5fa5c5215b2e_04-18-week2-FAILING_AND_PASSING,51,0,51
364248359,batfish/batfish,02/09/18 18:38,spirals-bears,97c942ad-a60e-4cfe-b325-5fa5c5215b2e_04-18-week2-FAILING_AND_PASSING,52,0,52
364249243,batfish/batfish,02/09/18 18:39,spirals-bears,97c942ad-a60e-4cfe-b325-5fa5c5215b2e_04-18-week2-FAILING_AND_PASSING,48,4,52
364772945,batfish/batfish,02/09/18 18:39,spirals-bears,97c942ad-a60e-4cfe-b325-5fa5c5215b2e_04-18-week2-FAILING_AND_PASSING,6,143,59,0,1,1,0,210
364276825,batfish/batfish,02/09/18 18:40,spirals-bears,97c942ad-a60e-4cfe-b325-5fa5c5215b2e_04-18-week2-FAILING_AND_PASSING,51,0,51
364276858,batfish/batfish,02/09/18 18:41,spirals-bears,97c942ad-a60e-4cfe-b325-5fa5c5215b2e_04-18-week2-FAILING_AND_PASSING,67,3,70
363999600,batfish/batfish,02/09/18 18:41,spirals-bears,97c942ad-a60e-4cfe-b325-5fa5c5215b2e_04-18-week2-FAILING_AND_PASSING,47,2,49
363998940,batfish/batfish,02/09/18 18:42,spirals-bears,97c942ad-a60e-4cfe-b325-5fa5c5215b2e_04-18-week2-FAILING_AND_PASSING,49,0,49
363949824,batfish/batfish,02/09/18 18:42,spirals-bears,97c942ad-a60e-4cfe-b325-5fa5c5215b2e_04-18-week2-FAILING_AND_PASSING,54,0,54
363940380,batfish/batfish,02/09/18 18:43,spirals-bears,97c942ad-a60e-4cfe-b325-5fa5c5215b2e_04-18-week2-FAILING_AND_PASSING,59,0,59
365463847,apache/incubator-servicecomb-java-chassis,02/09/18 18:43,spirals-bears,97c942ad-a60e-4cfe-b325-5fa5c5215b2e_04-18-week2-FAILING_AND_PASSING,8,3,11
364587748,apache/incubator-servicecomb-java-chassis,02/09/18 18:43,spirals-bears,97c942ad-a60e-4cfe-b325-5fa5c5215b2e_04-18-week2-FAILING_AND_PASSING,9,3,12
364015778,apache/incubator-servicecomb-java-chassis,02/09/18 18:44,spirals-bears,97c942ad-a60e-4cfe-b325-5fa5c5215b2e_04-18-week2-FAILING_AND_PASSING,9,3,12
364190981,INRIA/spoon,02/09/18 18:44,spirals-bears,97c942ad-a60e-4cfe-b325-5fa5c5215b2e_04-18-week2-FAILING_AND_PASSING,8,0,1,0,10,4,0,553,17,0,532,58,10,0,1193
365541650,INRIA/spoon,02/09/18 18:44,spirals-bears,97c942ad-a60e-4cfe-b325-5fa5c5215b2e_04-18-week2-FAILING_AND_PASSING,8,0,7,0,10,4,0,546,22,4,541,58,9,0,1209
363744756,apache/incubator-servicecomb-java-chassis,02/09/18 18:44,spirals-bears,97c942ad-a60e-4cfe-b325-5fa5c5215b2e_04-18-week2-FAILING_AND_PASSING,11,0,11
363788659,apache/incubator-servicecomb-java-chassis,02/09/18 18:44,spirals-bears,97c942ad-a60e-4cfe-b325-5fa5c5215b2e_04-18-week2-FAILING_AND_PASSING,11,4,15
366515093,runelite/runelite,02/09/18 18:45,spirals-bears,97c942ad-a60e-4cfe-b325-5fa5c5215b2e_04-18-week2-FAILING_AND_PASSING,12,0,12
363666233,apache/incubator-servicecomb-java-chassis,02/09/18 18:45,spirals-bears,97c942ad-a60e-4cfe-b325-5fa5c5215b2e_04-18-week2-FAILING_AND_PASSING,9,5,14
366424868,runelite/runelite,02/09/18 18:45,spirals-bears,97c942ad-a60e-4cfe-b325-5fa5c5215b2e_04-18-week2-FAILING_AND_PASSING,12,0,12
366314944,runelite/runelite,02/09/18 18:45,spirals-bears,97c942ad-a60e-4cfe-b325-5fa5c5215b2e_04-18-week2-FAILING_AND_PASSING,13,15,28
366233044,runelite/runelite,02/09/18 18:46,spirals-bears,97c942ad-a60e-4cfe-b325-5fa5c5215b2e_04-18-week2-FAILING_AND_PASSING,10,0,10
366111391,runelite/runelite,02/09/18 18:46,spirals-bears,97c942ad-a60e-4cfe-b325-5fa5c5215b2e_04-18-week2-FAILING_AND_PASSING,10,0,10
365009418,runelite/runelite,02/09/18 18:46,spirals-bears,97c942ad-a60e-4cfe-b325-5fa5c5215b2e_04-18-week2-FAILING_AND_PASSING,10,14,24
365901111,runelite/runelite,02/09/18 18:47,spirals-bears,97c942ad-a60e-4cfe-b325-5fa5c5215b2e_04-18-week2-FAILING_AND_PASSING,11,15,26
366288573,runelite/runelite,02/09/18 18:47,spirals-bears,97c942ad-a60e-4cfe-b325-5fa5c5215b2e_04-18-week2-FAILING_AND_PASSING,89,11,0,18,0,118
365689953,runelite/runelite,02/09/18 18:48,spirals-bears,97c942ad-a60e-4cfe-b325-5fa5c5215b2e_04-18-week2-FAILING_AND_PASSING,11,15,26
365622617,runelite/runelite,02/09/18 18:48,spirals-bears,97c942ad-a60e-4cfe-b325-5fa5c5215b2e_04-18-week2-FAILING_AND_PASSING,11,14,25
365514982,runelite/runelite,02/09/18 18:48,spirals-bears,97c942ad-a60e-4cfe-b325-5fa5c5215b2e_04-18-week2-FAILING_AND_PASSING,10,0,10
365444008,runelite/runelite,02/09/18 18:48,spirals-bears,97c942ad-a60e-4cfe-b325-5fa5c5215b2e_04-18-week2-FAILING_AND_PASSING,11,0,11
365415788,runelite/runelite,02/09/18 18:48,spirals-bears,97c942ad-a60e-4cfe-b325-5fa5c5215b2e_04-18-week2-FAILING_AND_PASSING,12,0,12
365398204,runelite/runelite,02/09/18 18:48,spirals-bears,97c942ad-a60e-4cfe-b325-5fa5c5215b2e_04-18-week2-FAILING_AND_PASSING,10,0,10
365321751,runelite/runelite,02/09/18 18:49,spirals-bears,97c942ad-a60e-4cfe-b325-5fa5c5215b2e_04-18-week2-FAILING_AND_PASSING,12,0,12
365278326,runelite/runelite,02/09/18 18:49,spirals-bears,97c942ad-a60e-4cfe-b325-5fa5c5215b2e_04-18-week2-FAILING_AND_PASSING,11,13,24
365004576,runelite/runelite,02/09/18 18:49,spirals-bears,97c942ad-a60e-4cfe-b325-5fa5c5215b2e_04-18-week2-FAILING_AND_PASSING,12,0,12
364417331,runelite/runelite,02/09/18 18:49,spirals-bears,97c942ad-a60e-4cfe-b325-5fa5c5215b2e_04-18-week2-FAILING_AND_PASSING,12,0,12
363838568,runelite/runelite,02/09/18 18:49,spirals-bears,97c942ad-a60e-4cfe-b325-5fa5c5215b2e_04-18-week2-FAILING_AND_PASSING,11,0,11
363836045,runelite/runelite,02/09/18 18:50,spirals-bears,97c942ad-a60e-4cfe-b325-5fa5c5215b2e_04-18-week2-FAILING_AND_PASSING,12,0,12
363837241,runelite/runelite,02/09/18 18:50,spirals-bears,97c942ad-a60e-4cfe-b325-5fa5c5215b2e_04-18-week2-FAILING_AND_PASSING,11,0,11
363772857,runelite/runelite,02/09/18 18:50,spirals-bears,97c942ad-a60e-4cfe-b325-5fa5c5215b2e_04-18-week2-FAILING_AND_PASSING,12,0,12
363655796,runelite/runelite,02/09/18 18:50,spirals-bears,97c942ad-a60e-4cfe-b325-5fa5c5215b2e_04-18-week2-FAILING_AND_PASSING,12,0,12
364347558,CorfuDB/CorfuDB,02/09/18 18:54,spirals-bears,97c942ad-a60e-4cfe-b325-5fa5c5215b2e_04-18-week2-FAILING_AND_PASSING,249,0,249
363715628,apache/incubator-servicecomb-java-chassis,02/09/18 19:24,spirals-bears,97c942ad-a60e-4cfe-b325-5fa5c5215b2e_04-18-week2-FAILING_AND_PASSING,391,200,11,2,0,6,1,611
364904783,CorfuDB/CorfuDB,02/09/18 19:24,spirals-bears,97c942ad-a60e-4cfe-b325-5fa5c5215b2e_04-18-week2-FAILING_AND_PASSING,386,0,386
363810719,matsim-org/matsim,02/09/18 19:24,spirals-bears,97c942ad-a60e-4cfe-b325-5fa5c5215b2e_04-18-week2-FAILING_AND_PASSING,1589,258,0,2,0,1849
364377918,CorfuDB/CorfuDB,02/09/18 19:28,spirals-bears,97c942ad-a60e-4cfe-b325-5fa5c5215b2e_04-18-week2-FAILING_AND_PASSING,259,3,262
363296031,CorfuDB/CorfuDB,02/09/18 19:31,spirals-bears,97c942ad-a60e-4cfe-b325-5fa5c5215b2e_04-18-week2-FAILING_AND_PASSING,382,3,385
363233410,apache/calcite,02/09/18 19:33,spirals-bears,97c942ad-a60e-4cfe-b325-5fa5c5215b2e_04-18-week2-FAILING_AND_PASSING,379,124,23,0,0,1,0,527
365558654,apache/activemq-artemis,02/09/18 19:34,spirals-bears,97c942ad-a60e-4cfe-b325-5fa5c5215b2e_04-18-week2-FAILING_AND_PASSING,31,4,35
364974055,apache/activemq-artemis,02/09/18 19:35,spirals-bears,97c942ad-a60e-4cfe-b325-5fa5c5215b2e_04-18-week2-FAILING_AND_PASSING,33,3,36
364167829,apache/activemq-artemis,02/09/18 19:35,spirals-bears,97c942ad-a60e-4cfe-b325-5fa5c5215b2e_04-18-week2-FAILING_AND_PASSING,28,8,36
365153842,apache/activemq-artemis,02/09/18 19:48,spirals-bears,97c942ad-a60e-4cfe-b325-5fa5c5215b2e_04-18-week2-FAILING_AND_PASSING,298,441,28,0,2,1,1,771
364969007,apache/activemq-artemis,02/09/18 19:49,spirals-bears,97c942ad-a60e-4cfe-b325-5fa5c5215b2e_04-18-week2-FAILING_AND_PASSING,30,4,34
364359132,CorfuDB/CorfuDB,02/09/18 19:56,spirals-bears,97c942ad-a60e-4cfe-b325-5fa5c5215b2e_04-18-week2-FAILING_AND_PASSING,10,0,0,0,0,3,0,731,75,0,665,194,265,0,1943
364893126,apache/storm,02/09/18 19:58,spirals-bears,97c942ad-a60e-4cfe-b325-5fa5c5215b2e_04-18-week2-FAILING_AND_PASSING,573,655,15,44,0,6,1,16,0,292,0,4,1606
365322000,linkedin/pinot,02/09/18 19:59,spirals-bears,97c942ad-a60e-4cfe-b325-5fa5c5215b2e_04-18-week2-FAILING_AND_PASSING,37,8,45
364755356,linkedin/pinot,02/09/18 19:59,spirals-bears,97c942ad-a60e-4cfe-b325-5fa5c5215b2e_04-18-week2-FAILING_AND_PASSING,35,4,39
364748377,linkedin/pinot,02/09/18 20:00,spirals-bears,97c942ad-a60e-4cfe-b325-5fa5c5215b2e_04-18-week2-FAILING_AND_PASSING,36,6,42
364725414,linkedin/pinot,02/09/18 20:01,spirals-bears,97c942ad-a60e-4cfe-b325-5fa5c5215b2e_04-18-week2-FAILING_AND_PASSING,34,6,40
364341426,linkedin/pinot,02/09/18 20:02,spirals-bears,97c942ad-a60e-4cfe-b325-5fa5c5215b2e_04-18-week2-FAILING_AND_PASSING,35,4,39
364341872,linkedin/pinot,02/09/18 20:03,spirals-bears,97c942ad-a60e-4cfe-b325-5fa5c5215b2e_04-18-week2-FAILING_AND_PASSING,41,3,44
364685266,apache/activemq-artemis,02/09/18 20:03,spirals-bears,97c942ad-a60e-4cfe-b325-5fa5c5215b2e_04-18-week2-FAILING_AND_PASSING,330,470,28,0,1,1,0,830
365334651,Azure/azure-libraries-for-java,02/09/18 20:04,spirals-bears,97c942ad-a60e-4cfe-b325-5fa5c5215b2e_04-18-week2-FAILING_AND_PASSING,61,5,66
364899199,Azure/azure-libraries-for-java,02/09/18 20:05,spirals-bears,97c942ad-a60e-4cfe-b325-5fa5c5215b2e_04-18-week2-FAILING_AND_PASSING,61,4,65
364165065,apache/activemq-artemis,02/09/18 20:09,spirals-bears,97c942ad-a60e-4cfe-b325-5fa5c5215b2e_04-18-week2-FAILING_AND_PASSING,247,451,29,0,0,1,1,729
363671488,raphw/byte-buddy,02/09/18 20:09,spirals-bears,97c942ad-a60e-4cfe-b325-5fa5c5215b2e_04-18-week2-FAILING_AND_PASSING,260,4,264
363617758,raphw/byte-buddy,02/09/18 20:09,spirals-bears,97c942ad-a60e-4cfe-b325-5fa5c5215b2e_04-18-week2-FAILING_AND_PASSING,257,4,261
365510725,graphhopper/graphhopper,02/09/18 20:09,spirals-bears,97c942ad-a60e-4cfe-b325-5fa5c5215b2e_04-18-week2-FAILING_AND_PASSING,17,0,17
365567090,graphhopper/graphhopper,02/09/18 20:09,spirals-bears,97c942ad-a60e-4cfe-b325-5fa5c5215b2e_04-18-week2-FAILING_AND_PASSING,22,4,26
364531026,apache/storm,02/09/18 20:11,spirals-bears,97c942ad-a60e-4cfe-b325-5fa5c5215b2e_04-18-week2-FAILING_AND_PASSING,9,0,2,0,2,27,0,592,584,0,600,667,36,0,2519
363835522,graphhopper/graphhopper,02/09/18 20:12,spirals-bears,97c942ad-a60e-4cfe-b325-5fa5c5215b2e_04-18-week2-FAILING_AND_PASSING,100,19,0,4,0,123
364804894,graphhopper/graphhopper,02/09/18 20:13,spirals-bears,97c942ad-a60e-4cfe-b325-5fa5c5215b2e_04-18-week2-FAILING_AND_PASSING,73,118,18,0,0,0,0,209
365303869,graphhopper/graphhopper,02/09/18 20:13,spirals-bears,97c942ad-a60e-4cfe-b325-5fa5c5215b2e_04-18-week2-FAILING_AND_PASSING,75,112,24,0,7,0,0,218
361323532,HubSpot/Singularity,02/09/18 20:35,spirals-bears,97c942ad-a60e-4cfe-b325-5fa5c5215b2e_04-18-week2-FAILING_AND_PASSING,12,0,0,0,2,21,0,307,313,1,360,393,17,5,1431
365137921,HubSpot/Singularity,02/09/18 20:36,spirals-bears,97c942ad-a60e-4cfe-b325-5fa5c5215b2e_04-18-week2-FAILING_AND_PASSING,9,0,0,0,1,47,0,273,312,0,363,402,17,6,1430
362690642,HubSpot/Singularity,02/09/18 20:37,spirals-bears,97c942ad-a60e-4cfe-b325-5fa5c5215b2e_04-18-week2-FAILING_AND_PASSING,938,452,18,0,0,1,1409
365326696,HubSpot/Singularity,02/09/18 20:47,spirals-bears,97c942ad-a60e-4cfe-b325-5fa5c5215b2e_04-18-week2-FAILING_AND_PASSING,9,0,3,1,23,0,851,336,3,347,440,19,2,2034
364683223,magefree/mage,02/09/18 20:52,spirals-bears,97c942ad-a60e-4cfe-b325-5fa5c5215b2e_04-18-week2-FAILING_AND_PASSING,7,0,11,0,1,26,0,180,32,1,198,349,171,1,977
365909684,magefree/mage,02/09/18 20:53,spirals-bears,97c942ad-a60e-4cfe-b325-5fa5c5215b2e_04-18-week2-FAILING_AND_PASSING,7,0,14,0,1,30,0,149,36,1,170,332,320,1,1061
364501725,magefree/mage,02/09/18 20:53,spirals-bears,97c942ad-a60e-4cfe-b325-5fa5c5215b2e_04-18-week2-FAILING_AND_PASSING,10,0,11,1,1,27,0,179,27,3,192,353,175,1,980
365677239,molgenis/molgenis,02/09/18 20:55,spirals-bears,97c942ad-a60e-4cfe-b325-5fa5c5215b2e_04-18-week2-FAILING_AND_PASSING,44,11,55
363859033,magefree/mage,02/09/18 21:04,spirals-bears,97c942ad-a60e-4cfe-b325-5fa5c5215b2e_04-18-week2-FAILING_AND_PASSING,7,0,21,0,0,29,0,179,40,7,206,350,175,1,1015
363950894,magefree/mage,02/09/18 21:10,spirals-bears,97c942ad-a60e-4cfe-b325-5fa5c5215b2e_04-18-week2-FAILING_AND_PASSING,12,0,15,1,1,69,0,184,33,3,176,358,183,1,1036
364810768,visallo/vertexium,02/09/18 21:10,spirals-bears,97c942ad-a60e-4cfe-b325-5fa5c5215b2e_04-18-week2-FAILING_AND_PASSING,7,2,9
364810829,visallo/vertexium,02/09/18 21:11,spirals-bears,97c942ad-a60e-4cfe-b325-5fa5c5215b2e_04-18-week2-FAILING_AND_PASSING,7,3,10
365615126,molgenis/molgenis,02/09/18 21:24,spirals-bears,97c942ad-a60e-4cfe-b325-5fa5c5215b2e_04-18-week2-FAILING_AND_PASSING,1039,751,42,1,1,4,2,1840
364061911,apache/incubator-dubbo,02/09/18 21:24,spirals-bears,97c942ad-a60e-4cfe-b325-5fa5c5215b2e_04-18-week2-FAILING_AND_PASSING,10,0,10
365036482,molgenis/molgenis,02/09/18 21:25,spirals-bears,97c942ad-a60e-4cfe-b325-5fa5c5215b2e_04-18-week2-FAILING_AND_PASSING,1027,739,40,0,13,1,2,1822
364591952,languagetool-org/languagetool,02/09/18 21:33,spirals-bears,97c942ad-a60e-4cfe-b325-5fa5c5215b2e_04-18-week2-FAILING_AND_PASSING,810,112,407,0,6,1,0,1336
366169770,ga4gh/dockstore,02/09/18 21:33,spirals-bears,97c942ad-a60e-4cfe-b325-5fa5c5215b2e_04-18-week2-FAILING_AND_PASSING,9,2,11
366169714,ga4gh/dockstore,02/09/18 21:34,spirals-bears,97c942ad-a60e-4cfe-b325-5fa5c5215b2e_04-18-week2-FAILING_AND_PASSING,9,0,9
364498165,molgenis/molgenis,02/09/18 21:35,spirals-bears,97c942ad-a60e-4cfe-b325-5fa5c5215b2e_04-18-week2-FAILING_AND_PASSING,1015,726,42,0,10,1,2,1796
365309300,ga4gh/dockstore,02/09/18 21:35,spirals-bears,97c942ad-a60e-4cfe-b325-5fa5c5215b2e_04-18-week2-FAILING_AND_PASSING,9,2,11
364731330,ga4gh/dockstore,02/09/18 21:36,spirals-bears,97c942ad-a60e-4cfe-b325-5fa5c5215b2e_04-18-week2-FAILING_AND_PASSING,9,3,12
364731311,ga4gh/dockstore,02/09/18 21:36,spirals-bears,97c942ad-a60e-4cfe-b325-5fa5c5215b2e_04-18-week2-FAILING_AND_PASSING,9,0,9
365945269,atomix/atomix,02/09/18 21:36,spirals-bears,97c942ad-a60e-4cfe-b325-5fa5c5215b2e_04-18-week2-FAILING_AND_PASSING,11,2,13
364408317,aliyun/fc-java-sdk,02/09/18 21:38,spirals-bears,97c942ad-a60e-4cfe-b325-5fa5c5215b2e_04-18-week2-FAILING_AND_PASSING,9,0,2,0,0,0,0,7,15,2,9,31,2,0,77
364408303,aliyun/fc-java-sdk,02/09/18 21:39,spirals-bears,97c942ad-a60e-4cfe-b325-5fa5c5215b2e_04-18-week2-FAILING_AND_PASSING,10,0,0,0,0,0,0,6,15,0,8,33,2,0,74
363758804,apache/incubator-dubbo,02/09/18 21:39,spirals-bears,97c942ad-a60e-4cfe-b325-5fa5c5215b2e_04-18-week2-FAILING_AND_PASSING,199,660,9,0,1,1,0,870
364568424,Hycom-PIP/pip2018,02/09/18 21:40,spirals-bears,97c942ad-a60e-4cfe-b325-5fa5c5215b2e_04-18-week2-FAILING_AND_PASSING,28,2,0,0,3,33
364075594,dropwizard/metrics,02/09/18 21:43,spirals-bears,97c942ad-a60e-4cfe-b325-5fa5c5215b2e_04-18-week2-FAILING_AND_PASSING,67,119,7,3,3,14,0,213
364016875,apache/incubator-dubbo,02/09/18 21:44,spirals-bears,97c942ad-a60e-4cfe-b325-5fa5c5215b2e_04-18-week2-FAILING_AND_PASSING,10,5,0,4,6,0,2,5,0,201,0,50,3,116,691,13,5,0,1111
365290206,ga4gh/dockstore,02/09/18 21:47,spirals-bears,97c942ad-a60e-4cfe-b325-5fa5c5215b2e_04-18-week2-FAILING_AND_PASSING,777,10,0,0,0,787
365095309,aicis/fresco,02/09/18 22:00,spirals-bears,97c942ad-a60e-4cfe-b325-5fa5c5215b2e_04-18-week2-FAILING_AND_PASSING,9,0,0,0,0,4,0,339,36,0,249,95,8,0,740
365620061,aicis/fresco,02/09/18 22:12,spirals-bears,97c942ad-a60e-4cfe-b325-5fa5c5215b2e_04-18-week2-FAILING_AND_PASSING,9,0,0,0,0,5,0,346,33,0,1250,98,9,0,1750
365221601,spring-cloud/spring-cloud-gcp,02/09/18 22:12,spirals-bears,97c942ad-a60e-4cfe-b325-5fa5c5215b2e_04-18-week2-FAILING_AND_PASSING,4,2,6
365657097,aicis/fresco,02/09/18 22:14,spirals-bears,97c942ad-a60e-4cfe-b325-5fa5c5215b2e_04-18-week2-FAILING_AND_PASSING,10,5,0,0,7,0,0,4,0,1469,0,37,0,358,102,8,5,0,2005
365215322,spring-cloud/spring-cloud-gcp,02/09/18 22:14,spirals-bears,97c942ad-a60e-4cfe-b325-5fa5c5215b2e_04-18-week2-FAILING_AND_PASSING,4,2,6
365218088,spring-cloud/spring-cloud-gcp,02/09/18 22:14,spirals-bears,97c942ad-a60e-4cfe-b325-5fa5c5215b2e_04-18-week2-FAILING_AND_PASSING,4,1,5
364786460,spring-cloud/spring-cloud-gcp,02/09/18 22:14,spirals-bears,97c942ad-a60e-4cfe-b325-5fa5c5215b2e_04-18-week2-FAILING_AND_PASSING,4,2,6
364640448,spring-cloud/spring-cloud-gcp,02/09/18 22:15,spirals-bears,97c942ad-a60e-4cfe-b325-5fa5c5215b2e_04-18-week2-FAILING_AND_PASSING,4,2,6
364197609,spring-cloud/spring-cloud-gcp,02/09/18 22:15,spirals-bears,97c942ad-a60e-4cfe-b325-5fa5c5215b2e_04-18-week2-FAILING_AND_PASSING,4,2,6
363306870,spring-cloud/spring-cloud-gcp,02/09/18 22:15,spirals-bears,97c942ad-a60e-4cfe-b325-5fa5c5215b2e_04-18-week2-FAILING_AND_PASSING,4,2,6
365167272,aicis/fresco,02/09/18 22:17,spirals-bears,97c942ad-a60e-4cfe-b325-5fa5c5215b2e_04-18-week2-FAILING_AND_PASSING,13,5,0,0,7,0,0,5,0,1403,0,37,0,364,101,9,6,0,1950
365899283,apache/incubator-servicecomb-saga,02/09/18 22:21,spirals-bears,97c942ad-a60e-4cfe-b325-5fa5c5215b2e_04-18-week2-FAILING_AND_PASSING,105,84,4,0,0,2,0,195
365203582,datastax/java-driver,02/09/18 22:21,spirals-bears,97c942ad-a60e-4cfe-b325-5fa5c5215b2e_04-18-week2-FAILING_AND_PASSING,16,0,16
365203620,datastax/java-driver,02/09/18 22:21,spirals-bears,97c942ad-a60e-4cfe-b325-5fa5c5215b2e_04-18-week2-FAILING_AND_PASSING,16,2,18
365195779,spring-cloud/spring-cloud-gcp,02/09/18 22:21,spirals-bears,97c942ad-a60e-4cfe-b325-5fa5c5215b2e_04-18-week2-FAILING_AND_PASSING,62,447,5,5,0,10,0,529
366287971,datastax/java-driver,02/09/18 22:22,spirals-bears,97c942ad-a60e-4cfe-b325-5fa5c5215b2e_04-18-week2-FAILING_AND_PASSING,17,0,17
362746892,datastax/java-driver,02/09/18 22:22,spirals-bears,97c942ad-a60e-4cfe-b325-5fa5c5215b2e_04-18-week2-FAILING_AND_PASSING,17,3,20
362746851,datastax/java-driver,02/09/18 22:23,spirals-bears,97c942ad-a60e-4cfe-b325-5fa5c5215b2e_04-18-week2-FAILING_AND_PASSING,16,0,16
365837210,datastax/java-driver,02/09/18 22:25,spirals-bears,97c942ad-a60e-4cfe-b325-5fa5c5215b2e_04-18-week2-FAILING_AND_PASSING,75,109,17,0,0,0,0,201
364861488,RipMeApp/ripme,02/09/18 22:25,spirals-bears,97c942ad-a60e-4cfe-b325-5fa5c5215b2e_04-18-week2-FAILING_AND_PASSING,9,0,0,0,0,0,0,306,13,0,256,20,4,0,608
365353786,datastax/java-driver,02/09/18 22:26,spirals-bears,97c942ad-a60e-4cfe-b325-5fa5c5215b2e_04-18-week2-FAILING_AND_PASSING,16,4,20
365313041,datastax/java-driver,02/09/18 22:26,spirals-bears,97c942ad-a60e-4cfe-b325-5fa5c5215b2e_04-18-week2-FAILING_AND_PASSING,16,0,16
365313069,datastax/java-driver,02/09/18 22:26,spirals-bears,97c942ad-a60e-4cfe-b325-5fa5c5215b2e_04-18-week2-FAILING_AND_PASSING,16,2,18
365197635,datastax/java-driver,02/09/18 22:26,spirals-bears,97c942ad-a60e-4cfe-b325-5fa5c5215b2e_04-18-week2-FAILING_AND_PASSING,69,97,15,0,0,0,0,181
365205231,datastax/java-driver,02/09/18 22:26,spirals-bears,97c942ad-a60e-4cfe-b325-5fa5c5215b2e_04-18-week2-FAILING_AND_PASSING,17,2,19
364716178,datastax/java-driver,02/09/18 22:26,spirals-bears,97c942ad-a60e-4cfe-b325-5fa5c5215b2e_04-18-week2-FAILING_AND_PASSING,16,3,19
364345060,datastax/java-driver,02/09/18 22:26,spirals-bears,97c942ad-a60e-4cfe-b325-5fa5c5215b2e_04-18-week2-FAILING_AND_PASSING,17,3,20
366452913,alipay/sofa-rpc-boot-projects,02/09/18 22:27,spirals-bears,97c942ad-a60e-4cfe-b325-5fa5c5215b2e_04-18-week2-FAILING_AND_PASSING,2,0,2
364345045,datastax/java-driver,02/09/18 22:27,spirals-bears,97c942ad-a60e-4cfe-b325-5fa5c5215b2e_04-18-week2-FAILING_AND_PASSING,18,0,18
363360862,datastax/java-driver,02/09/18 22:27,spirals-bears,97c942ad-a60e-4cfe-b325-5fa5c5215b2e_04-18-week2-FAILING_AND_PASSING,17,0,17
364263911,SzFMV2018-Tavasz/AutomatedCar,02/09/18 22:29,spirals-bears,97c942ad-a60e-4cfe-b325-5fa5c5215b2e_04-18-week2-FAILING_AND_PASSING,12,0,0,0,5,0,0,0,0,14,0,15,0,19,26,9,0,0,100
364263958,SzFMV2018-Tavasz/AutomatedCar,02/09/18 22:29,spirals-bears,97c942ad-a60e-4cfe-b325-5fa5c5215b2e_04-18-week2-FAILING_AND_PASSING,12,0,0,3,4,0,0,0,0,11,0,17,2,19,26,9,0,0,103
364227081,SzFMV2018-Tavasz/AutomatedCar,02/09/18 22:29,spirals-bears,97c942ad-a60e-4cfe-b325-5fa5c5215b2e_04-18-week2-FAILING_AND_PASSING,12,0,0,2,4,0,0,0,0,12,0,14,2,19,25,9,0,0,99
365935600,debezium/debezium,02/09/18 22:29,spirals-bears,97c942ad-a60e-4cfe-b325-5fa5c5215b2e_04-18-week2-FAILING_AND_PASSING,7,4,11
364920912,dhis2/dhis2-core,02/09/18 22:31,spirals-bears,97c942ad-a60e-4cfe-b325-5fa5c5215b2e_04-18-week2-FAILING_AND_PASSING,97,23,0,10,0,130
365776377,2018swecapstone/h2ms,02/09/18 22:34,spirals-bears,97c942ad-a60e-4cfe-b325-5fa5c5215b2e_04-18-week2-FAILING_AND_PASSING,88,67,3,0,3,2,0,163
363785124,debezium/debezium,02/09/18 22:35,spirals-bears,97c942ad-a60e-4cfe-b325-5fa5c5215b2e_04-18-week2-FAILING_AND_PASSING,12,1,0,5,6,0,1,1,0,51,0,32,3,45,168,6,2,0,333
365261784,alipay/sofa-rpc,02/09/18 22:35,spirals-bears,97c942ad-a60e-4cfe-b325-5fa5c5215b2e_04-18-week2-FAILING_AND_PASSING,4,0,4
365153776,alipay/sofa-rpc,02/09/18 22:35,spirals-bears,97c942ad-a60e-4cfe-b325-5fa5c5215b2e_04-18-week2-FAILING_AND_PASSING,3,0,3
364711327,alipay/sofa-rpc,02/09/18 22:35,spirals-bears,97c942ad-a60e-4cfe-b325-5fa5c5215b2e_04-18-week2-FAILING_AND_PASSING,4,0,4
365629573,alipay/sofa-rpc,02/09/18 22:36,spirals-bears,97c942ad-a60e-4cfe-b325-5fa5c5215b2e_04-18-week2-FAILING_AND_PASSING,4,6,0,0,7,1,6,14,18,0,14,51,3,0,124
365597595,fabric8io/fabric8-maven-plugin,02/09/18 22:37,spirals-bears,97c942ad-a60e-4cfe-b325-5fa5c5215b2e_04-18-week2-FAILING_AND_PASSING,29,6,35
365482072,fabric8io/fabric8-maven-plugin,02/09/18 22:38,spirals-bears,97c942ad-a60e-4cfe-b325-5fa5c5215b2e_04-18-week2-FAILING_AND_PASSING,30,6,36
365429504,fabric8io/fabric8-maven-plugin,02/09/18 22:38,spirals-bears,97c942ad-a60e-4cfe-b325-5fa5c5215b2e_04-18-week2-FAILING_AND_PASSING,29,5,34
365306839,fabric8io/fabric8-maven-plugin,02/09/18 22:39,spirals-bears,97c942ad-a60e-4cfe-b325-5fa5c5215b2e_04-18-week2-FAILING_AND_PASSING,30,6,36
365306087,fabric8io/fabric8-maven-plugin,02/09/18 22:40,spirals-bears,97c942ad-a60e-4cfe-b325-5fa5c5215b2e_04-18-week2-FAILING_AND_PASSING,29,6,35
365207050,fabric8io/fabric8-maven-plugin,02/09/18 22:41,spirals-bears,97c942ad-a60e-4cfe-b325-5fa5c5215b2e_04-18-week2-FAILING_AND_PASSING,30,6,36
365083072,fabric8io/fabric8-maven-plugin,02/09/18 22:41,spirals-bears,97c942ad-a60e-4cfe-b325-5fa5c5215b2e_04-18-week2-FAILING_AND_PASSING,29,6,35
363993941,aicis/fresco,02/09/18 22:42,spirals-bears,97c942ad-a60e-4cfe-b325-5fa5c5215b2e_04-18-week2-FAILING_AND_PASSING,9,5,0,0,7,0,0,5,0,1269,0,38,0,1085,113,9,5,0,2545
364997410,fabric8io/fabric8-maven-plugin,02/09/18 22:42,spirals-bears,97c942ad-a60e-4cfe-b325-5fa5c5215b2e_04-18-week2-FAILING_AND_PASSING,30,6,36
366051259,Activiti/Activiti,02/09/18 22:43,spirals-bears,97c942ad-a60e-4cfe-b325-5fa5c5215b2e_04-18-week2-FAILING_AND_PASSING,54,0,54
366125945,fabric8io/fabric8-maven-plugin,02/09/18 22:45,spirals-bears,97c942ad-a60e-4cfe-b325-5fa5c5215b2e_04-18-week2-FAILING_AND_PASSING,116,443,28,0,0,2,0,589
366320280,jdbi/jdbi,02/09/18 22:49,spirals-bears,97c942ad-a60e-4cfe-b325-5fa5c5215b2e_04-18-week2-FAILING_AND_PASSING,175,8,0,4,1,188
366284994,jdbi/jdbi,02/09/18 22:49,spirals-bears,97c942ad-a60e-4cfe-b325-5fa5c5215b2e_04-18-week2-FAILING_AND_PASSING,11,3,14
366039231,jdbi/jdbi,02/09/18 22:52,spirals-bears,97c942ad-a60e-4cfe-b325-5fa5c5215b2e_04-18-week2-FAILING_AND_PASSING,158,8,0,5,1,172
354472002,Activiti/Activiti,02/09/18 22:53,spirals-bears,97c942ad-a60e-4cfe-b325-5fa5c5215b2e_04-18-week2-FAILING_AND_PASSING,427,166,32,2,0,4,1,632
365338780,jdbi/jdbi,02/09/18 22:55,spirals-bears,97c942ad-a60e-4cfe-b325-5fa5c5215b2e_04-18-week2-FAILING_AND_PASSING,85,8,0,3,1,97
365452275,MyCoRe-Org/mycore,02/09/18 22:56,spirals-bears,97c942ad-a60e-4cfe-b325-5fa5c5215b2e_04-18-week2-FAILING_AND_PASSING,15,60,0,0,28,17,0,435,203,1,441,367,43,1,1611
364598366,jdbi/jdbi,02/09/18 22:57,spirals-bears,97c942ad-a60e-4cfe-b325-5fa5c5215b2e_04-18-week2-FAILING_AND_PASSING,138,8,0,3,1,150
365527029,Spirals-Team/repairnator,02/09/18 22:58,spirals-bears,97c942ad-a60e-4cfe-b325-5fa5c5215b2e_04-18-week2-FAILING_AND_PASSING,16,2,18
366493909,jdbi/jdbi,02/09/18 22:58,spirals-bears,97c942ad-a60e-4cfe-b325-5fa5c5215b2e_04-18-week2-FAILING_AND_PASSING,10,0,4,0,1,1,0,24,215,3,27,594,8,0,887
365164760,Spirals-Team/repairnator,02/09/18 22:58,spirals-bears,97c942ad-a60e-4cfe-b325-5fa5c5215b2e_04-18-week2-FAILING_AND_PASSING,18,0,18
365209847,Spirals-Team/repairnator,02/09/18 22:59,spirals-bears,97c942ad-a60e-4cfe-b325-5fa5c5215b2e_04-18-week2-FAILING_AND_PASSING,19,0,19
364513736,jdbi/jdbi,02/09/18 22:59,spirals-bears,97c942ad-a60e-4cfe-b325-5fa5c5215b2e_04-18-week2-FAILING_AND_PASSING,136,9,0,4,1,150
364239590,jnidzwetzki/bboxdb,02/09/18 23:02,spirals-bears,97c942ad-a60e-4cfe-b325-5fa5c5215b2e_04-18-week2-FAILING_AND_PASSING,6,0,0,0,1,1,0,32,16,0,35,66,10,0,167
364635217,Spirals-Team/repairnator,02/09/18 23:02,spirals-bears,97c942ad-a60e-4cfe-b325-5fa5c5215b2e_04-18-week2-FAILING_AND_PASSING,203,19,0,4,1,227
364030242,Spirals-Team/repairnator,02/09/18 23:02,spirals-bears,97c942ad-a60e-4cfe-b325-5fa5c5215b2e_04-18-week2-FAILING_AND_PASSING,175,17,0,3,0,195
365943313,jdbi/jdbi,02/09/18 23:04,spirals-bears,97c942ad-a60e-4cfe-b325-5fa5c5215b2e_04-18-week2-FAILING_AND_PASSING,8,0,3,0,1,1,0,21,174,3,26,464,8,0,709
