330280818,apache/flink,19/08/18 04:13,spirals-bears,a7a5945f-cafe-4f3e-93ac-cda95067199f_01-18-week3-FAILING_AND_PASSING,64,5,69
329904895,apache/flink,19/08/18 04:13,spirals-bears,a7a5945f-cafe-4f3e-93ac-cda95067199f_01-18-week3-FAILING_AND_PASSING,74,8,82
331339429,apache/flink,19/08/18 04:13,spirals-bears,a7a5945f-cafe-4f3e-93ac-cda95067199f_01-18-week3-FAILING_AND_PASSING,96,7,103
330803512,apache/flink,19/08/18 04:15,spirals-bears,a7a5945f-cafe-4f3e-93ac-cda95067199f_01-18-week3-FAILING_AND_PASSING,74,7,81
330728672,apache/flink,19/08/18 04:15,spirals-bears,a7a5945f-cafe-4f3e-93ac-cda95067199f_01-18-week3-FAILING_AND_PASSING,58,7,65
330690195,apache/flink,19/08/18 04:16,spirals-bears,a7a5945f-cafe-4f3e-93ac-cda95067199f_01-18-week3-FAILING_AND_PASSING,67,7,74
330423965,apache/flink,19/08/18 04:17,spirals-bears,a7a5945f-cafe-4f3e-93ac-cda95067199f_01-18-week3-FAILING_AND_PASSING,67,6,73
330378576,apache/flink,19/08/18 04:57,spirals-bears,a7a5945f-cafe-4f3e-93ac-cda95067199f_01-18-week3-FAILING_AND_PASSING,75,1561,20,62,0,2,1,108,1,522,1,5,2358
331396118,apache/flink,19/08/18 04:57,spirals-bears,a7a5945f-cafe-4f3e-93ac-cda95067199f_01-18-week3-FAILING_AND_PASSING,15,0,2,1,2,304,0,45,722,2,50,1511,81,1,2736
330282675,apache/flink,19/08/18 04:59,spirals-bears,a7a5945f-cafe-4f3e-93ac-cda95067199f_01-18-week3-FAILING_AND_PASSING,61,7,68
330263258,apache/flink,19/08/18 04:59,spirals-bears,a7a5945f-cafe-4f3e-93ac-cda95067199f_01-18-week3-FAILING_AND_PASSING,59,7,66
330452413,apache/flink,19/08/18 04:59,spirals-bears,a7a5945f-cafe-4f3e-93ac-cda95067199f_01-18-week3-FAILING_AND_PASSING,11,0,2,1,2,152,0,40,751,6,79,1556,61,2,2663
330257517,apache/flink,19/08/18 05:00,spirals-bears,a7a5945f-cafe-4f3e-93ac-cda95067199f_01-18-week3-FAILING_AND_PASSING,60,5,65
329506167,apache/flink,19/08/18 05:01,spirals-bears,a7a5945f-cafe-4f3e-93ac-cda95067199f_01-18-week3-FAILING_AND_PASSING,73,6,79
330950282,apache/flink,19/08/18 05:01,spirals-bears,a7a5945f-cafe-4f3e-93ac-cda95067199f_01-18-week3-FAILING_AND_PASSING,23,0,9,1,1,214,0,42,869,8,77,1525,103,5,2877
329150834,apache/flink,19/08/18 05:01,spirals-bears,a7a5945f-cafe-4f3e-93ac-cda95067199f_01-18-week3-FAILING_AND_PASSING,79,6,85
325082176,apache/flink,19/08/18 05:02,spirals-bears,a7a5945f-cafe-4f3e-93ac-cda95067199f_01-18-week3-FAILING_AND_PASSING,62,6,68
331397548,prestodb/presto,19/08/18 05:02,spirals-bears,a7a5945f-cafe-4f3e-93ac-cda95067199f_01-18-week3-FAILING_AND_PASSING,42,4,46
329747630,prestodb/presto,19/08/18 05:03,spirals-bears,a7a5945f-cafe-4f3e-93ac-cda95067199f_01-18-week3-FAILING_AND_PASSING,43,7,50
330853580,prestodb/presto,19/08/18 05:03,spirals-bears,a7a5945f-cafe-4f3e-93ac-cda95067199f_01-18-week3-FAILING_AND_PASSING,44,14,58
329664900,prestodb/presto,19/08/18 05:04,spirals-bears,a7a5945f-cafe-4f3e-93ac-cda95067199f_01-18-week3-FAILING_AND_PASSING,40,7,47
330454307,prestodb/presto,19/08/18 05:04,spirals-bears,a7a5945f-cafe-4f3e-93ac-cda95067199f_01-18-week3-FAILING_AND_PASSING,45,4,49
329317738,prestodb/presto,19/08/18 05:05,spirals-bears,a7a5945f-cafe-4f3e-93ac-cda95067199f_01-18-week3-FAILING_AND_PASSING,44,7,51
329115939,prestodb/presto,19/08/18 05:06,spirals-bears,a7a5945f-cafe-4f3e-93ac-cda95067199f_01-18-week3-FAILING_AND_PASSING,43,7,50
328891283,prestodb/presto,19/08/18 05:07,spirals-bears,a7a5945f-cafe-4f3e-93ac-cda95067199f_01-18-week3-FAILING_AND_PASSING,42,7,49
328225368,prestodb/presto,19/08/18 05:08,spirals-bears,a7a5945f-cafe-4f3e-93ac-cda95067199f_01-18-week3-FAILING_AND_PASSING,42,7,49
329857178,prestodb/presto,19/08/18 05:33,spirals-bears,a7a5945f-cafe-4f3e-93ac-cda95067199f_01-18-week3-FAILING_AND_PASSING,783,870,44,0,3,1,1701
327128559,apache/flink,19/08/18 05:44,spirals-bears,a7a5945f-cafe-4f3e-93ac-cda95067199f_01-18-week3-FAILING_AND_PASSING,46,1653,10,64,0,9,1,109,0,630,2,14,2538
329877063,apache/flink,19/08/18 05:44,spirals-bears,a7a5945f-cafe-4f3e-93ac-cda95067199f_01-18-week3-FAILING_AND_PASSING,9,0,1,1,2,280,0,52,769,8,49,1447,60,1,2679
328374665,apache/incubator-druid,19/08/18 06:13,spirals-bears,a7a5945f-cafe-4f3e-93ac-cda95067199f_01-18-week3-FAILING_AND_PASSING,1109,595,40,0,2,1,1747
327334293,apache/incubator-druid,19/08/18 06:14,spirals-bears,a7a5945f-cafe-4f3e-93ac-cda95067199f_01-18-week3-FAILING_AND_PASSING,1132,606,38,0,9,1,1786
330089878,apache/incubator-druid,19/08/18 06:18,spirals-bears,a7a5945f-cafe-4f3e-93ac-cda95067199f_01-18-week3-FAILING_AND_PASSING,18,0,2,1,1,46,0,1804,364,2,1408,481,37,10,4174
329713021,apache/incubator-druid,19/08/18 06:47,spirals-bears,a7a5945f-cafe-4f3e-93ac-cda95067199f_01-18-week3-FAILING_AND_PASSING,9,0,14,3,1,67,0,1518,371,7,1774,472,35,140,4411
331395305,JMRI/JMRI,19/08/18 06:52,spirals-bears,a7a5945f-cafe-4f3e-93ac-cda95067199f_01-18-week3-FAILING_AND_PASSING,1586,171,453,0,32,0,6,2248
331383414,JMRI/JMRI,19/08/18 06:54,spirals-bears,a7a5945f-cafe-4f3e-93ac-cda95067199f_01-18-week3-FAILING_AND_PASSING,1618,178,13,286,0,9,0,143,0,85,3,1,2336
331271714,JMRI/JMRI,19/08/18 06:54,spirals-bears,a7a5945f-cafe-4f3e-93ac-cda95067199f_01-18-week3-FAILING_AND_PASSING,1509,166,429,0,36,0,2,2142
331145489,JMRI/JMRI,19/08/18 07:00,spirals-bears,a7a5945f-cafe-4f3e-93ac-cda95067199f_01-18-week3-FAILING_AND_PASSING,306,27,333
331291333,JMRI/JMRI,19/08/18 07:19,spirals-bears,a7a5945f-cafe-4f3e-93ac-cda95067199f_01-18-week3-FAILING_AND_PASSING,1442,176,269,0,37,0,6,1930
331292337,JMRI/JMRI,19/08/18 07:25,spirals-bears,a7a5945f-cafe-4f3e-93ac-cda95067199f_01-18-week3-FAILING_AND_PASSING,1428,176,296,0,31,0,7,1938
331244604,JMRI/JMRI,19/08/18 07:26,spirals-bears,a7a5945f-cafe-4f3e-93ac-cda95067199f_01-18-week3-FAILING_AND_PASSING,1431,170,285,0,6,0,6,1898
330584248,JMRI/JMRI,19/08/18 07:30,spirals-bears,a7a5945f-cafe-4f3e-93ac-cda95067199f_01-18-week3-FAILING_AND_PASSING,1349,164,273,0,7,0,2,1795
330240260,JMRI/JMRI,19/08/18 07:53,spirals-bears,a7a5945f-cafe-4f3e-93ac-cda95067199f_01-18-week3-FAILING_AND_PASSING,1408,175,348,0,35,0,8,1974
330054537,JMRI/JMRI,19/08/18 07:57,spirals-bears,a7a5945f-cafe-4f3e-93ac-cda95067199f_01-18-week3-FAILING_AND_PASSING,1386,178,275,0,35,0,5,1879
329912966,JMRI/JMRI,19/08/18 07:57,spirals-bears,a7a5945f-cafe-4f3e-93ac-cda95067199f_01-18-week3-FAILING_AND_PASSING,1372,174,287,0,10,0,5,1848
331457276,apache/nifi,19/08/18 07:58,spirals-bears,a7a5945f-cafe-4f3e-93ac-cda95067199f_01-18-week3-FAILING_AND_PASSING,38,6,44
329317502,JMRI/JMRI,19/08/18 08:03,spirals-bears,a7a5945f-cafe-4f3e-93ac-cda95067199f_01-18-week3-FAILING_AND_PASSING,1346,171,382,0,30,0,3,1932
328207925,apache/nifi,19/08/18 08:04,spirals-bears,a7a5945f-cafe-4f3e-93ac-cda95067199f_01-18-week3-FAILING_AND_PASSING,37,4,41
329244703,INRIA/spoon,19/08/18 08:21,spirals-bears,a7a5945f-cafe-4f3e-93ac-cda95067199f_01-18-week3-FAILING_AND_PASSING,8,0,5,1,0,5,0,477,29,4,421,60,12,0,1022
330288886,EnMasseProject/enmasse,19/08/18 08:22,spirals-bears,a7a5945f-cafe-4f3e-93ac-cda95067199f_01-18-week3-FAILING_AND_PASSING,27,0,27
330099754,apache/nifi,19/08/18 08:22,spirals-bears,a7a5945f-cafe-4f3e-93ac-cda95067199f_01-18-week3-FAILING_AND_PASSING,1394,38,2,8,4,1446
330288896,EnMasseProject/enmasse,19/08/18 08:22,spirals-bears,a7a5945f-cafe-4f3e-93ac-cda95067199f_01-18-week3-FAILING_AND_PASSING,27,3,30
331062397,batfish/batfish,19/08/18 08:24,spirals-bears,a7a5945f-cafe-4f3e-93ac-cda95067199f_01-18-week3-FAILING_AND_PASSING,55,4,59
331062391,batfish/batfish,19/08/18 08:25,spirals-bears,a7a5945f-cafe-4f3e-93ac-cda95067199f_01-18-week3-FAILING_AND_PASSING,52,0,52
328898293,JMRI/JMRI,19/08/18 08:25,spirals-bears,a7a5945f-cafe-4f3e-93ac-cda95067199f_01-18-week3-FAILING_AND_PASSING,1462,171,256,0,37,0,18,1944
331064712,batfish/batfish,19/08/18 08:26,spirals-bears,a7a5945f-cafe-4f3e-93ac-cda95067199f_01-18-week3-FAILING_AND_PASSING,55,0,55
331064718,batfish/batfish,19/08/18 08:27,spirals-bears,a7a5945f-cafe-4f3e-93ac-cda95067199f_01-18-week3-FAILING_AND_PASSING,54,3,57
330957675,batfish/batfish,19/08/18 08:27,spirals-bears,a7a5945f-cafe-4f3e-93ac-cda95067199f_01-18-week3-FAILING_AND_PASSING,51,3,54
329423024,EnMasseProject/enmasse,19/08/18 08:27,spirals-bears,a7a5945f-cafe-4f3e-93ac-cda95067199f_01-18-week3-FAILING_AND_PASSING,147,80,30,0,1,2,0,260
330957664,batfish/batfish,19/08/18 08:28,spirals-bears,a7a5945f-cafe-4f3e-93ac-cda95067199f_01-18-week3-FAILING_AND_PASSING,49,0,49
330227401,batfish/batfish,19/08/18 08:28,spirals-bears,a7a5945f-cafe-4f3e-93ac-cda95067199f_01-18-week3-FAILING_AND_PASSING,47,0,47
330514205,batfish/batfish,19/08/18 08:28,spirals-bears,a7a5945f-cafe-4f3e-93ac-cda95067199f_01-18-week3-FAILING_AND_PASSING,53,0,53
330183657,batfish/batfish,19/08/18 08:29,spirals-bears,a7a5945f-cafe-4f3e-93ac-cda95067199f_01-18-week3-FAILING_AND_PASSING,50,0,50
330167901,batfish/batfish,19/08/18 08:29,spirals-bears,a7a5945f-cafe-4f3e-93ac-cda95067199f_01-18-week3-FAILING_AND_PASSING,52,0,52
329281437,batfish/batfish,19/08/18 08:30,spirals-bears,a7a5945f-cafe-4f3e-93ac-cda95067199f_01-18-week3-FAILING_AND_PASSING,57,0,57
329136666,lucee/Lucee,19/08/18 08:30,spirals-bears,a7a5945f-cafe-4f3e-93ac-cda95067199f_01-18-week3-FAILING_AND_PASSING,3,9,22,0,0,1,0,35
328065990,lucee/Lucee,19/08/18 08:30,spirals-bears,a7a5945f-cafe-4f3e-93ac-cda95067199f_01-18-week3-FAILING_AND_PASSING,3,9,22,0,1,1,0,36
330245856,apache/incubator-servicecomb-java-chassis,19/08/18 08:31,spirals-bears,a7a5945f-cafe-4f3e-93ac-cda95067199f_01-18-week3-FAILING_AND_PASSING,9,3,12
330197238,apache/incubator-servicecomb-java-chassis,19/08/18 08:31,spirals-bears,a7a5945f-cafe-4f3e-93ac-cda95067199f_01-18-week3-FAILING_AND_PASSING,9,3,12
329368174,apache/incubator-servicecomb-java-chassis,19/08/18 08:31,spirals-bears,a7a5945f-cafe-4f3e-93ac-cda95067199f_01-18-week3-FAILING_AND_PASSING,10,4,14
331377298,runelite/runelite,19/08/18 08:32,spirals-bears,a7a5945f-cafe-4f3e-93ac-cda95067199f_01-18-week3-FAILING_AND_PASSING,10,1,11
328837635,JMRI/JMRI,19/08/18 08:32,spirals-bears,a7a5945f-cafe-4f3e-93ac-cda95067199f_01-18-week3-FAILING_AND_PASSING,1557,170,338,0,31,0,13,2109
331238938,runelite/runelite,19/08/18 08:32,spirals-bears,a7a5945f-cafe-4f3e-93ac-cda95067199f_01-18-week3-FAILING_AND_PASSING,11,12,23
331158651,runelite/runelite,19/08/18 08:32,spirals-bears,a7a5945f-cafe-4f3e-93ac-cda95067199f_01-18-week3-FAILING_AND_PASSING,10,0,10
331089761,runelite/runelite,19/08/18 08:32,spirals-bears,a7a5945f-cafe-4f3e-93ac-cda95067199f_01-18-week3-FAILING_AND_PASSING,10,0,10
331078991,runelite/runelite,19/08/18 08:33,spirals-bears,a7a5945f-cafe-4f3e-93ac-cda95067199f_01-18-week3-FAILING_AND_PASSING,11,0,11
330992674,runelite/runelite,19/08/18 08:33,spirals-bears,a7a5945f-cafe-4f3e-93ac-cda95067199f_01-18-week3-FAILING_AND_PASSING,10,0,10
330984648,runelite/runelite,19/08/18 08:33,spirals-bears,a7a5945f-cafe-4f3e-93ac-cda95067199f_01-18-week3-FAILING_AND_PASSING,10,0,10
330750165,runelite/runelite,19/08/18 08:33,spirals-bears,a7a5945f-cafe-4f3e-93ac-cda95067199f_01-18-week3-FAILING_AND_PASSING,11,0,11
329152358,runelite/runelite,19/08/18 08:34,spirals-bears,a7a5945f-cafe-4f3e-93ac-cda95067199f_01-18-week3-FAILING_AND_PASSING,10,1,11
328968148,runelite/runelite,19/08/18 08:34,spirals-bears,a7a5945f-cafe-4f3e-93ac-cda95067199f_01-18-week3-FAILING_AND_PASSING,11,0,11
329260943,runelite/runelite,19/08/18 08:34,spirals-bears,a7a5945f-cafe-4f3e-93ac-cda95067199f_01-18-week3-FAILING_AND_PASSING,10,27,37
328888609,runelite/runelite,19/08/18 08:34,spirals-bears,a7a5945f-cafe-4f3e-93ac-cda95067199f_01-18-week3-FAILING_AND_PASSING,10,0,10
328681493,runelite/runelite,19/08/18 08:34,spirals-bears,a7a5945f-cafe-4f3e-93ac-cda95067199f_01-18-week3-FAILING_AND_PASSING,11,0,11
330183960,apache/incubator-servicecomb-java-chassis,19/08/18 08:38,spirals-bears,a7a5945f-cafe-4f3e-93ac-cda95067199f_01-18-week3-FAILING_AND_PASSING,255,128,10,1,1,5,0,400
331082425,CorfuDB/CorfuDB,19/08/18 08:39,spirals-bears,a7a5945f-cafe-4f3e-93ac-cda95067199f_01-18-week3-FAILING_AND_PASSING,251,3,254
331082423,CorfuDB/CorfuDB,19/08/18 08:39,spirals-bears,a7a5945f-cafe-4f3e-93ac-cda95067199f_01-18-week3-FAILING_AND_PASSING,265,0,265
331076420,CorfuDB/CorfuDB,19/08/18 08:42,spirals-bears,a7a5945f-cafe-4f3e-93ac-cda95067199f_01-18-week3-FAILING_AND_PASSING,271,3,274
331047162,CorfuDB/CorfuDB,19/08/18 08:43,spirals-bears,a7a5945f-cafe-4f3e-93ac-cda95067199f_01-18-week3-FAILING_AND_PASSING,253,4,257
330949848,CorfuDB/CorfuDB,19/08/18 08:43,spirals-bears,a7a5945f-cafe-4f3e-93ac-cda95067199f_01-18-week3-FAILING_AND_PASSING,258,4,262
330626791,CorfuDB/CorfuDB,19/08/18 08:47,spirals-bears,a7a5945f-cafe-4f3e-93ac-cda95067199f_01-18-week3-FAILING_AND_PASSING,247,3,250
330626515,CorfuDB/CorfuDB,19/08/18 08:47,spirals-bears,a7a5945f-cafe-4f3e-93ac-cda95067199f_01-18-week3-FAILING_AND_PASSING,243,0,243
330639354,CorfuDB/CorfuDB,19/08/18 08:48,spirals-bears,a7a5945f-cafe-4f3e-93ac-cda95067199f_01-18-week3-FAILING_AND_PASSING,253,4,257
330632135,CorfuDB/CorfuDB,19/08/18 08:51,spirals-bears,a7a5945f-cafe-4f3e-93ac-cda95067199f_01-18-week3-FAILING_AND_PASSING,249,0,249
330615604,CorfuDB/CorfuDB,19/08/18 08:52,spirals-bears,a7a5945f-cafe-4f3e-93ac-cda95067199f_01-18-week3-FAILING_AND_PASSING,252,4,256
330176121,CorfuDB/CorfuDB,19/08/18 08:56,spirals-bears,a7a5945f-cafe-4f3e-93ac-cda95067199f_01-18-week3-FAILING_AND_PASSING,272,0,272
329051186,matsim-org/matsim,19/08/18 08:57,spirals-bears,a7a5945f-cafe-4f3e-93ac-cda95067199f_01-18-week3-FAILING_AND_PASSING,1556,150,0,1,1,1708
330172825,CorfuDB/CorfuDB,19/08/18 09:01,spirals-bears,a7a5945f-cafe-4f3e-93ac-cda95067199f_01-18-week3-FAILING_AND_PASSING,258,3,261
329699174,CorfuDB/CorfuDB,19/08/18 09:02,spirals-bears,a7a5945f-cafe-4f3e-93ac-cda95067199f_01-18-week3-FAILING_AND_PASSING,282,4,286
330775639,apache/storm,19/08/18 09:03,spirals-bears,a7a5945f-cafe-4f3e-93ac-cda95067199f_01-18-week3-FAILING_AND_PASSING,37,4,41
330626679,Azure/azure-libraries-for-java,19/08/18 09:04,spirals-bears,a7a5945f-cafe-4f3e-93ac-cda95067199f_01-18-week3-FAILING_AND_PASSING,64,0,64
328783960,graphhopper/graphhopper,19/08/18 09:08,spirals-bears,a7a5945f-cafe-4f3e-93ac-cda95067199f_01-18-week3-FAILING_AND_PASSING,84,141,18,0,0,0,0,243
328783976,graphhopper/graphhopper,19/08/18 09:12,spirals-bears,a7a5945f-cafe-4f3e-93ac-cda95067199f_01-18-week3-FAILING_AND_PASSING,72,128,18,0,3,0,0,221
328282038,apache/calcite,19/08/18 09:14,spirals-bears,a7a5945f-cafe-4f3e-93ac-cda95067199f_01-18-week3-FAILING_AND_PASSING,602,133,23,0,6,1,0,765
330246430,CorfuDB/CorfuDB,19/08/18 09:18,spirals-bears,a7a5945f-cafe-4f3e-93ac-cda95067199f_01-18-week3-FAILING_AND_PASSING,10,4,0,0,5,0,0,2,0,618,0,81,0,606,180,311,4,0,1821
331378030,magefree/mage,19/08/18 09:19,spirals-bears,a7a5945f-cafe-4f3e-93ac-cda95067199f_01-18-week3-FAILING_AND_PASSING,118,172,0,19,1,310
330247480,CorfuDB/CorfuDB,19/08/18 09:22,spirals-bears,a7a5945f-cafe-4f3e-93ac-cda95067199f_01-18-week3-FAILING_AND_PASSING,10,4,0,3,4,0,0,3,0,619,0,86,4,654,194,248,4,0,1833
329843098,molgenis/molgenis,19/08/18 09:23,spirals-bears,a7a5945f-cafe-4f3e-93ac-cda95067199f_01-18-week3-FAILING_AND_PASSING,43,12,55
329428805,molgenis/molgenis,19/08/18 09:24,spirals-bears,a7a5945f-cafe-4f3e-93ac-cda95067199f_01-18-week3-FAILING_AND_PASSING,39,9,48
327764465,HubSpot/Singularity,19/08/18 09:32,spirals-bears,a7a5945f-cafe-4f3e-93ac-cda95067199f_01-18-week3-FAILING_AND_PASSING,9,0,0,0,1,5,0,280,285,0,256,331,19,0,1186
328109137,molgenis/molgenis,19/08/18 09:33,spirals-bears,a7a5945f-cafe-4f3e-93ac-cda95067199f_01-18-week3-FAILING_AND_PASSING,490,55,0,9,1,555
328134207,molgenis/molgenis,19/08/18 09:33,spirals-bears,a7a5945f-cafe-4f3e-93ac-cda95067199f_01-18-week3-FAILING_AND_PASSING,41,9,50
329059212,algolia/algoliasearch-client-java-2,19/08/18 09:34,spirals-bears,a7a5945f-cafe-4f3e-93ac-cda95067199f_01-18-week3-FAILING_AND_PASSING,3,2,5
329045131,algolia/algoliasearch-client-java-2,19/08/18 09:34,spirals-bears,a7a5945f-cafe-4f3e-93ac-cda95067199f_01-18-week3-FAILING_AND_PASSING,3,2,5
328990209,algolia/algoliasearch-client-java-2,19/08/18 09:34,spirals-bears,a7a5945f-cafe-4f3e-93ac-cda95067199f_01-18-week3-FAILING_AND_PASSING,3,0,3
329034073,algolia/algoliasearch-client-java-2,19/08/18 09:34,spirals-bears,a7a5945f-cafe-4f3e-93ac-cda95067199f_01-18-week3-FAILING_AND_PASSING,3,1,4
328126976,algolia/algoliasearch-client-java-2,19/08/18 09:34,spirals-bears,a7a5945f-cafe-4f3e-93ac-cda95067199f_01-18-week3-FAILING_AND_PASSING,4,0,4
328132561,algolia/algoliasearch-client-java-2,19/08/18 09:34,spirals-bears,a7a5945f-cafe-4f3e-93ac-cda95067199f_01-18-week3-FAILING_AND_PASSING,4,2,6
331525419,StuPro-TOSCAna/TOSCAna,19/08/18 09:35,spirals-bears,a7a5945f-cafe-4f3e-93ac-cda95067199f_01-18-week3-FAILING_AND_PASSING,15,2,17
331525379,StuPro-TOSCAna/TOSCAna,19/08/18 09:35,spirals-bears,a7a5945f-cafe-4f3e-93ac-cda95067199f_01-18-week3-FAILING_AND_PASSING,19,0,19
330595399,magefree/mage,19/08/18 09:35,spirals-bears,a7a5945f-cafe-4f3e-93ac-cda95067199f_01-18-week3-FAILING_AND_PASSING,9,0,12,0,1,32,0,176,26,1,201,330,188,1,977
331522780,StuPro-TOSCAna/TOSCAna,19/08/18 09:35,spirals-bears,a7a5945f-cafe-4f3e-93ac-cda95067199f_01-18-week3-FAILING_AND_PASSING,16,3,19
331522749,StuPro-TOSCAna/TOSCAna,19/08/18 09:35,spirals-bears,a7a5945f-cafe-4f3e-93ac-cda95067199f_01-18-week3-FAILING_AND_PASSING,20,0,20
331509533,StuPro-TOSCAna/TOSCAna,19/08/18 09:36,spirals-bears,a7a5945f-cafe-4f3e-93ac-cda95067199f_01-18-week3-FAILING_AND_PASSING,20,0,20
331434590,StuPro-TOSCAna/TOSCAna,19/08/18 09:36,spirals-bears,a7a5945f-cafe-4f3e-93ac-cda95067199f_01-18-week3-FAILING_AND_PASSING,20,0,20
331434601,StuPro-TOSCAna/TOSCAna,19/08/18 09:36,spirals-bears,a7a5945f-cafe-4f3e-93ac-cda95067199f_01-18-week3-FAILING_AND_PASSING,20,2,22
330826764,StuPro-TOSCAna/TOSCAna,19/08/18 09:36,spirals-bears,a7a5945f-cafe-4f3e-93ac-cda95067199f_01-18-week3-FAILING_AND_PASSING,17,0,17
330409501,StuPro-TOSCAna/TOSCAna,19/08/18 09:36,spirals-bears,a7a5945f-cafe-4f3e-93ac-cda95067199f_01-18-week3-FAILING_AND_PASSING,19,2,21
330826773,StuPro-TOSCAna/TOSCAna,19/08/18 09:36,spirals-bears,a7a5945f-cafe-4f3e-93ac-cda95067199f_01-18-week3-FAILING_AND_PASSING,22,3,25
330409486,StuPro-TOSCAna/TOSCAna,19/08/18 09:36,spirals-bears,a7a5945f-cafe-4f3e-93ac-cda95067199f_01-18-week3-FAILING_AND_PASSING,15,0,15
328899925,magefree/mage,19/08/18 09:37,spirals-bears,a7a5945f-cafe-4f3e-93ac-cda95067199f_01-18-week3-FAILING_AND_PASSING,7,0,12,0,0,29,0,178,29,1,204,324,224,1,1009
330329758,StuPro-TOSCAna/TOSCAna,19/08/18 09:37,spirals-bears,a7a5945f-cafe-4f3e-93ac-cda95067199f_01-18-week3-FAILING_AND_PASSING,15,3,18
330329731,StuPro-TOSCAna/TOSCAna,19/08/18 09:37,spirals-bears,a7a5945f-cafe-4f3e-93ac-cda95067199f_01-18-week3-FAILING_AND_PASSING,17,0,17
329496441,StuPro-TOSCAna/TOSCAna,19/08/18 09:37,spirals-bears,a7a5945f-cafe-4f3e-93ac-cda95067199f_01-18-week3-FAILING_AND_PASSING,24,2,26
329496212,StuPro-TOSCAna/TOSCAna,19/08/18 09:37,spirals-bears,a7a5945f-cafe-4f3e-93ac-cda95067199f_01-18-week3-FAILING_AND_PASSING,19,0,19
329915738,StuPro-TOSCAna/TOSCAna,19/08/18 09:37,spirals-bears,a7a5945f-cafe-4f3e-93ac-cda95067199f_01-18-week3-FAILING_AND_PASSING,21,2,23
329915054,StuPro-TOSCAna/TOSCAna,19/08/18 09:37,spirals-bears,a7a5945f-cafe-4f3e-93ac-cda95067199f_01-18-week3-FAILING_AND_PASSING,27,0,27
330544347,ga4gh/dockstore,19/08/18 09:38,spirals-bears,a7a5945f-cafe-4f3e-93ac-cda95067199f_01-18-week3-FAILING_AND_PASSING,10,0,10
330051361,ga4gh/dockstore,19/08/18 09:38,spirals-bears,a7a5945f-cafe-4f3e-93ac-cda95067199f_01-18-week3-FAILING_AND_PASSING,9,0,9
330090275,ga4gh/dockstore,19/08/18 09:38,spirals-bears,a7a5945f-cafe-4f3e-93ac-cda95067199f_01-18-week3-FAILING_AND_PASSING,12,3,15
329529800,ga4gh/dockstore,19/08/18 09:38,spirals-bears,a7a5945f-cafe-4f3e-93ac-cda95067199f_01-18-week3-FAILING_AND_PASSING,12,0,12
329180891,dropwizard/metrics,19/08/18 09:38,spirals-bears,a7a5945f-cafe-4f3e-93ac-cda95067199f_01-18-week3-FAILING_AND_PASSING,6,0,6
329140889,dropwizard/metrics,19/08/18 09:38,spirals-bears,a7a5945f-cafe-4f3e-93ac-cda95067199f_01-18-week3-FAILING_AND_PASSING,6,2,8
330696298,openzipkin/zipkin,19/08/18 09:48,spirals-bears,a7a5945f-cafe-4f3e-93ac-cda95067199f_01-18-week3-FAILING_AND_PASSING,254,283,26,0,0,2,0,565
331347609,openzipkin/zipkin,19/08/18 09:49,spirals-bears,a7a5945f-cafe-4f3e-93ac-cda95067199f_01-18-week3-FAILING_AND_PASSING,23,2,25
331347603,openzipkin/zipkin,19/08/18 09:49,spirals-bears,a7a5945f-cafe-4f3e-93ac-cda95067199f_01-18-week3-FAILING_AND_PASSING,22,0,22
330000100,resteasy/Resteasy,19/08/18 09:50,spirals-bears,a7a5945f-cafe-4f3e-93ac-cda95067199f_01-18-week3-FAILING_AND_PASSING,17,3,20
331264727,pgjdbc/pgjdbc,19/08/18 09:52,spirals-bears,a7a5945f-cafe-4f3e-93ac-cda95067199f_01-18-week3-FAILING_AND_PASSING,8,0,4,1,0,2,0,34,22,3,31,35,9,1,150
330713825,pgjdbc/pgjdbc,19/08/18 09:53,spirals-bears,a7a5945f-cafe-4f3e-93ac-cda95067199f_01-18-week3-FAILING_AND_PASSING,9,3,12
329485450,pgjdbc/pgjdbc,19/08/18 09:56,spirals-bears,a7a5945f-cafe-4f3e-93ac-cda95067199f_01-18-week3-FAILING_AND_PASSING,11,0,0,2,20,3,0,34,24,0,38,39,8,2,181
330017908,languagetool-org/languagetool,19/08/18 09:57,spirals-bears,a7a5945f-cafe-4f3e-93ac-cda95067199f_01-18-week3-FAILING_AND_PASSING,769,109,285,0,1,1,0,1165
329160941,pgjdbc/pgjdbc,19/08/18 09:59,spirals-bears,a7a5945f-cafe-4f3e-93ac-cda95067199f_01-18-week3-FAILING_AND_PASSING,10,0,4,1,0,3,0,36,20,3,35,41,9,2,164
330883085,aicis/fresco,19/08/18 10:29,spirals-bears,a7a5945f-cafe-4f3e-93ac-cda95067199f_01-18-week3-FAILING_AND_PASSING,10,3,0,4,7,0,0,4,0,1376,0,39,3,338,100,9,4,0,1897
330883035,aicis/fresco,19/08/18 10:30,spirals-bears,a7a5945f-cafe-4f3e-93ac-cda95067199f_01-18-week3-FAILING_AND_PASSING,10,4,0,0,7,0,0,3,0,1348,0,39,0,347,97,9,4,0,1868
327617019,apache/jackrabbit-oak,19/08/18 10:34,spirals-bears,a7a5945f-cafe-4f3e-93ac-cda95067199f_01-18-week3-FAILING_AND_PASSING,7,0,3,0,2,7,0,1421,165,0,1503,240,36,1,3385
330291145,aicis/fresco,19/08/18 10:44,spirals-bears,a7a5945f-cafe-4f3e-93ac-cda95067199f_01-18-week3-FAILING_AND_PASSING,8,0,4,0,0,3,0,249,37,3,385,103,9,0,801
329441928,apache/jackrabbit-oak,19/08/18 10:48,spirals-bears,a7a5945f-cafe-4f3e-93ac-cda95067199f_01-18-week3-FAILING_AND_PASSING,11,0,3,0,2,10,0,1623,366,0,1661,467,40,1,4184
330283265,aicis/fresco,19/08/18 10:48,spirals-bears,a7a5945f-cafe-4f3e-93ac-cda95067199f_01-18-week3-FAILING_AND_PASSING,8,0,0,0,0,3,0,285,36,0,374,90,9,0,805
330356407,aicis/fresco,19/08/18 10:54,spirals-bears,a7a5945f-cafe-4f3e-93ac-cda95067199f_01-18-week3-FAILING_AND_PASSING,1368,104,9,0,4,0,0,1485
329384963,aicis/fresco,19/08/18 11:08,spirals-bears,a7a5945f-cafe-4f3e-93ac-cda95067199f_01-18-week3-FAILING_AND_PASSING,1300,96,9,0,4,0,0,1409
329349630,aicis/fresco,19/08/18 11:32,spirals-bears,a7a5945f-cafe-4f3e-93ac-cda95067199f_01-18-week3-FAILING_AND_PASSING,9,2,0,4,8,0,0,3,0,1253,0,41,3,1225,90,8,3,0,2649
329349615,aicis/fresco,19/08/18 11:37,spirals-bears,a7a5945f-cafe-4f3e-93ac-cda95067199f_01-18-week3-FAILING_AND_PASSING,8,4,0,0,7,0,0,3,0,1273,0,40,0,1180,88,8,4,0,2615
329938497,swagger-api/swagger-codegen,19/08/18 11:38,spirals-bears,a7a5945f-cafe-4f3e-93ac-cda95067199f_01-18-week3-FAILING_AND_PASSING,33,5,38
330450765,spring-cloud/spring-cloud-gcp,19/08/18 11:39,spirals-bears,a7a5945f-cafe-4f3e-93ac-cda95067199f_01-18-week3-FAILING_AND_PASSING,4,2,6
329369431,aicis/fresco,19/08/18 11:44,spirals-bears,a7a5945f-cafe-4f3e-93ac-cda95067199f_01-18-week3-FAILING_AND_PASSING,8,3,0,3,6,0,0,3,0,1327,0,37,3,1887,93,10,4,0,3384
328858215,RipMeApp/ripme,19/08/18 11:49,spirals-bears,a7a5945f-cafe-4f3e-93ac-cda95067199f_01-18-week3-FAILING_AND_PASSING,7,0,2,0,0,0,0,294,10,2,284,18,4,0,621
329081167,apache/incubator-servicecomb-saga,19/08/18 11:49,spirals-bears,a7a5945f-cafe-4f3e-93ac-cda95067199f_01-18-week3-FAILING_AND_PASSING,4,2,6
329044523,apache/incubator-servicecomb-saga,19/08/18 11:50,spirals-bears,a7a5945f-cafe-4f3e-93ac-cda95067199f_01-18-week3-FAILING_AND_PASSING,4,3,7
329909136,debezium/debezium,19/08/18 11:50,spirals-bears,a7a5945f-cafe-4f3e-93ac-cda95067199f_01-18-week3-FAILING_AND_PASSING,6,3,9
328959942,debezium/debezium,19/08/18 11:50,spirals-bears,a7a5945f-cafe-4f3e-93ac-cda95067199f_01-18-week3-FAILING_AND_PASSING,6,4,10
328183145,MyCoRe-Org/mycore,19/08/18 11:51,spirals-bears,a7a5945f-cafe-4f3e-93ac-cda95067199f_01-18-week3-FAILING_AND_PASSING,47,0,47
328184348,MyCoRe-Org/mycore,19/08/18 11:52,spirals-bears,a7a5945f-cafe-4f3e-93ac-cda95067199f_01-18-week3-FAILING_AND_PASSING,41,2,43
326889818,MyCoRe-Org/mycore,19/08/18 11:53,spirals-bears,a7a5945f-cafe-4f3e-93ac-cda95067199f_01-18-week3-FAILING_AND_PASSING,49,2,51
326889446,MyCoRe-Org/mycore,19/08/18 11:54,spirals-bears,a7a5945f-cafe-4f3e-93ac-cda95067199f_01-18-week3-FAILING_AND_PASSING,43,0,43
329852878,Spirals-Team/repairnator,19/08/18 11:55,spirals-bears,a7a5945f-cafe-4f3e-93ac-cda95067199f_01-18-week3-FAILING_AND_PASSING,5,17,18,0,1,0,0,41
329411251,RipMeApp/ripme,19/08/18 11:55,spirals-bears,a7a5945f-cafe-4f3e-93ac-cda95067199f_01-18-week3-FAILING_AND_PASSING,8,0,0,0,0,0,0,264,11,0,300,17,5,0,605
329796842,Spirals-Team/repairnator,19/08/18 11:55,spirals-bears,a7a5945f-cafe-4f3e-93ac-cda95067199f_01-18-week3-FAILING_AND_PASSING,18,0,18
329534601,Spirals-Team/repairnator,19/08/18 11:55,spirals-bears,a7a5945f-cafe-4f3e-93ac-cda95067199f_01-18-week3-FAILING_AND_PASSING,17,2,19
329531122,Spirals-Team/repairnator,19/08/18 11:55,spirals-bears,a7a5945f-cafe-4f3e-93ac-cda95067199f_01-18-week3-FAILING_AND_PASSING,16,0,16
329469165,Spirals-Team/repairnator,19/08/18 11:56,spirals-bears,a7a5945f-cafe-4f3e-93ac-cda95067199f_01-18-week3-FAILING_AND_PASSING,17,2,19
329092734,aicis/fresco,19/08/18 11:56,spirals-bears,a7a5945f-cafe-4f3e-93ac-cda95067199f_01-18-week3-FAILING_AND_PASSING,9,4,0,4,7,0,0,3,0,1301,0,38,3,1411,94,9,4,0,2887
329469115,Spirals-Team/repairnator,19/08/18 11:56,spirals-bears,a7a5945f-cafe-4f3e-93ac-cda95067199f_01-18-week3-FAILING_AND_PASSING,17,0,17
329092754,aicis/fresco,19/08/18 12:26,spirals-bears,a7a5945f-cafe-4f3e-93ac-cda95067199f_01-18-week3-FAILING_AND_PASSING,9,3,0,0,8,0,0,3,0,1477,0,40,0,1551,89,7,3,0,3190
