354149527,apache/flink,29/08/18 19:53,spirals-bears,b8329044-fa38-406d-a987-171158d4cf73_03-18-week3-FAILING_AND_PASSING,62,8,70
356326566,apache/flink,29/08/18 19:53,spirals-bears,b8329044-fa38-406d-a987-171158d4cf73_03-18-week3-FAILING_AND_PASSING,70,8,78
351633844,apache/flink,29/08/18 19:53,spirals-bears,b8329044-fa38-406d-a987-171158d4cf73_03-18-week3-FAILING_AND_PASSING,84,8,92
354359567,apache/flink,29/08/18 19:54,spirals-bears,b8329044-fa38-406d-a987-171158d4cf73_03-18-week3-FAILING_AND_PASSING,62,6,68
354718277,apache/flink,29/08/18 19:54,spirals-bears,b8329044-fa38-406d-a987-171158d4cf73_03-18-week3-FAILING_AND_PASSING,60,6,66
354290441,apache/flink,29/08/18 19:54,spirals-bears,b8329044-fa38-406d-a987-171158d4cf73_03-18-week3-FAILING_AND_PASSING,62,6,68
354611121,apache/flink,29/08/18 19:55,spirals-bears,b8329044-fa38-406d-a987-171158d4cf73_03-18-week3-FAILING_AND_PASSING,62,6,68
354175882,apache/flink,29/08/18 19:56,spirals-bears,b8329044-fa38-406d-a987-171158d4cf73_03-18-week3-FAILING_AND_PASSING,59,5,64
353198435,apache/flink,29/08/18 19:57,spirals-bears,b8329044-fa38-406d-a987-171158d4cf73_03-18-week3-FAILING_AND_PASSING,59,5,64
355237024,apache/flink,29/08/18 20:38,spirals-bears,b8329044-fa38-406d-a987-171158d4cf73_03-18-week3-FAILING_AND_PASSING,10,0,10,1,1,109,0,46,873,7,51,1601,65,1,2775
353373375,apache/flink,29/08/18 20:39,spirals-bears,b8329044-fa38-406d-a987-171158d4cf73_03-18-week3-FAILING_AND_PASSING,61,6,67
351255784,apache/flink,29/08/18 20:41,spirals-bears,b8329044-fa38-406d-a987-171158d4cf73_03-18-week3-FAILING_AND_PASSING,59,9,68
354610577,apache/flink,29/08/18 20:41,spirals-bears,b8329044-fa38-406d-a987-171158d4cf73_03-18-week3-FAILING_AND_PASSING,14,0,8,0,2,186,0,43,795,17,46,1649,63,3,2826
353716302,apache/flink,29/08/18 20:42,spirals-bears,b8329044-fa38-406d-a987-171158d4cf73_03-18-week3-FAILING_AND_PASSING,60,7,67
356202150,prestodb/presto,29/08/18 20:43,spirals-bears,b8329044-fa38-406d-a987-171158d4cf73_03-18-week3-FAILING_AND_PASSING,43,6,49
346765839,apache/flink,29/08/18 20:43,spirals-bears,b8329044-fa38-406d-a987-171158d4cf73_03-18-week3-FAILING_AND_PASSING,60,1681,12,72,0,8,2,121,0,766,3,17,2742
355692050,prestodb/presto,29/08/18 20:43,spirals-bears,b8329044-fa38-406d-a987-171158d4cf73_03-18-week3-FAILING_AND_PASSING,44,6,50
356073922,prestodb/presto,29/08/18 20:44,spirals-bears,b8329044-fa38-406d-a987-171158d4cf73_03-18-week3-FAILING_AND_PASSING,45,4,49
356023116,prestodb/presto,29/08/18 20:44,spirals-bears,b8329044-fa38-406d-a987-171158d4cf73_03-18-week3-FAILING_AND_PASSING,44,3,47
355724255,prestodb/presto,29/08/18 20:45,spirals-bears,b8329044-fa38-406d-a987-171158d4cf73_03-18-week3-FAILING_AND_PASSING,43,3,46
355915365,prestodb/presto,29/08/18 20:45,spirals-bears,b8329044-fa38-406d-a987-171158d4cf73_03-18-week3-FAILING_AND_PASSING,47,5,52
355950176,prestodb/presto,29/08/18 20:46,spirals-bears,b8329044-fa38-406d-a987-171158d4cf73_03-18-week3-FAILING_AND_PASSING,56,4,60
351304783,apache/flink,29/08/18 20:47,spirals-bears,b8329044-fa38-406d-a987-171158d4cf73_03-18-week3-FAILING_AND_PASSING,17,0,8,0,1,152,0,41,1105,12,64,1633,60,7,3100
355813492,prestodb/presto,29/08/18 20:47,spirals-bears,b8329044-fa38-406d-a987-171158d4cf73_03-18-week3-FAILING_AND_PASSING,44,9,53
355676281,prestodb/presto,29/08/18 20:48,spirals-bears,b8329044-fa38-406d-a987-171158d4cf73_03-18-week3-FAILING_AND_PASSING,45,5,50
355774221,prestodb/presto,29/08/18 20:48,spirals-bears,b8329044-fa38-406d-a987-171158d4cf73_03-18-week3-FAILING_AND_PASSING,42,8,50
355544962,prestodb/presto,29/08/18 20:49,spirals-bears,b8329044-fa38-406d-a987-171158d4cf73_03-18-week3-FAILING_AND_PASSING,46,5,51
355487493,prestodb/presto,29/08/18 20:50,spirals-bears,b8329044-fa38-406d-a987-171158d4cf73_03-18-week3-FAILING_AND_PASSING,43,4,47
354067005,prestodb/presto,29/08/18 20:52,spirals-bears,b8329044-fa38-406d-a987-171158d4cf73_03-18-week3-FAILING_AND_PASSING,53,4,57
356029412,prestodb/presto,29/08/18 21:13,spirals-bears,b8329044-fa38-406d-a987-171158d4cf73_03-18-week3-FAILING_AND_PASSING,840,919,43,0,1,2,1805
354633872,prestodb/presto,29/08/18 21:14,spirals-bears,b8329044-fa38-406d-a987-171158d4cf73_03-18-week3-FAILING_AND_PASSING,41,4,45
354497991,prestodb/presto,29/08/18 21:15,spirals-bears,b8329044-fa38-406d-a987-171158d4cf73_03-18-week3-FAILING_AND_PASSING,41,3,44
355889055,prestodb/presto,29/08/18 21:15,spirals-bears,b8329044-fa38-406d-a987-171158d4cf73_03-18-week3-FAILING_AND_PASSING,813,897,45,0,2,1,1758
354538847,prestodb/presto,29/08/18 21:16,spirals-bears,b8329044-fa38-406d-a987-171158d4cf73_03-18-week3-FAILING_AND_PASSING,46,3,49
354515005,prestodb/presto,29/08/18 21:16,spirals-bears,b8329044-fa38-406d-a987-171158d4cf73_03-18-week3-FAILING_AND_PASSING,43,3,46
353862838,prestodb/presto,29/08/18 21:17,spirals-bears,b8329044-fa38-406d-a987-171158d4cf73_03-18-week3-FAILING_AND_PASSING,41,5,46
354204659,prestodb/presto,29/08/18 21:17,spirals-bears,b8329044-fa38-406d-a987-171158d4cf73_03-18-week3-FAILING_AND_PASSING,41,4,45
353937813,prestodb/presto,29/08/18 21:18,spirals-bears,b8329044-fa38-406d-a987-171158d4cf73_03-18-week3-FAILING_AND_PASSING,44,6,50
355614019,prestodb/presto,29/08/18 21:20,spirals-bears,b8329044-fa38-406d-a987-171158d4cf73_03-18-week3-FAILING_AND_PASSING,842,964,46,0,1,1,1854
354533183,prestodb/presto,29/08/18 21:22,spirals-bears,b8329044-fa38-406d-a987-171158d4cf73_03-18-week3-FAILING_AND_PASSING,780,977,42,0,5,1,1805
352952532,apache/incubator-druid,29/08/18 21:23,spirals-bears,b8329044-fa38-406d-a987-171158d4cf73_03-18-week3-FAILING_AND_PASSING,40,5,45
353657196,apache/incubator-druid,29/08/18 21:47,spirals-bears,b8329044-fa38-406d-a987-171158d4cf73_03-18-week3-FAILING_AND_PASSING,457,826,36,0,13,1,90,1423
354516584,apache/incubator-druid,29/08/18 21:50,spirals-bears,b8329044-fa38-406d-a987-171158d4cf73_03-18-week3-FAILING_AND_PASSING,1032,840,35,0,2,1,1910
351457721,apache/incubator-druid,29/08/18 21:51,spirals-bears,b8329044-fa38-406d-a987-171158d4cf73_03-18-week3-FAILING_AND_PASSING,1103,863,36,0,7,1,2010
353562905,apache/incubator-druid,29/08/18 21:54,spirals-bears,b8329044-fa38-406d-a987-171158d4cf73_03-18-week3-FAILING_AND_PASSING,42,10,52
353542857,apache/incubator-druid,29/08/18 22:27,spirals-bears,b8329044-fa38-406d-a987-171158d4cf73_03-18-week3-FAILING_AND_PASSING,1100,864,47,0,4,1,2016
354015008,apache/nifi,29/08/18 22:31,spirals-bears,b8329044-fa38-406d-a987-171158d4cf73_03-18-week3-FAILING_AND_PASSING,37,10,47
356140289,apache/nifi,29/08/18 22:32,spirals-bears,b8329044-fa38-406d-a987-171158d4cf73_03-18-week3-FAILING_AND_PASSING,56,5,61
356127151,apache/nifi,29/08/18 22:33,spirals-bears,b8329044-fa38-406d-a987-171158d4cf73_03-18-week3-FAILING_AND_PASSING,39,6,45
355382734,apache/nifi,29/08/18 22:34,spirals-bears,b8329044-fa38-406d-a987-171158d4cf73_03-18-week3-FAILING_AND_PASSING,36,5,41
355350247,apache/nifi,29/08/18 22:35,spirals-bears,b8329044-fa38-406d-a987-171158d4cf73_03-18-week3-FAILING_AND_PASSING,35,6,41
355152502,JMRI/JMRI,29/08/18 22:35,spirals-bears,b8329044-fa38-406d-a987-171158d4cf73_03-18-week3-FAILING_AND_PASSING,1859,105,10,281,0,6,0,138,0,86,15,5,2505
354033860,apache/nifi,29/08/18 22:36,spirals-bears,b8329044-fa38-406d-a987-171158d4cf73_03-18-week3-FAILING_AND_PASSING,54,7,61
354891686,apache/nifi,29/08/18 22:37,spirals-bears,b8329044-fa38-406d-a987-171158d4cf73_03-18-week3-FAILING_AND_PASSING,36,5,41
354867109,apache/nifi,29/08/18 22:37,spirals-bears,b8329044-fa38-406d-a987-171158d4cf73_03-18-week3-FAILING_AND_PASSING,35,4,39
352804129,apache/nifi,29/08/18 22:37,spirals-bears,b8329044-fa38-406d-a987-171158d4cf73_03-18-week3-FAILING_AND_PASSING,38,6,44
354369543,JMRI/JMRI,29/08/18 22:41,spirals-bears,b8329044-fa38-406d-a987-171158d4cf73_03-18-week3-FAILING_AND_PASSING,2031,104,11,383,0,32,0,116,0,84,22,10,2793
354127663,apache/incubator-druid,29/08/18 22:42,spirals-bears,b8329044-fa38-406d-a987-171158d4cf73_03-18-week3-FAILING_AND_PASSING,13,0,2,4,1,42,0,1741,355,2,1882,838,35,5,4920
346839385,apache/nifi,29/08/18 22:42,spirals-bears,b8329044-fa38-406d-a987-171158d4cf73_03-18-week3-FAILING_AND_PASSING,35,6,41
353925626,apache/nifi,29/08/18 22:43,spirals-bears,b8329044-fa38-406d-a987-171158d4cf73_03-18-week3-FAILING_AND_PASSING,37,0,37
354455490,apache/nifi,29/08/18 23:01,spirals-bears,b8329044-fa38-406d-a987-171158d4cf73_03-18-week3-FAILING_AND_PASSING,1382,35,1,1,5,1424
354938526,INRIA/spoon,29/08/18 23:01,spirals-bears,b8329044-fa38-406d-a987-171158d4cf73_03-18-week3-FAILING_AND_PASSING,8,4,12
354686324,INRIA/spoon,29/08/18 23:02,spirals-bears,b8329044-fa38-406d-a987-171158d4cf73_03-18-week3-FAILING_AND_PASSING,9,5,14
354225641,apache/nifi,29/08/18 23:02,spirals-bears,b8329044-fa38-406d-a987-171158d4cf73_03-18-week3-FAILING_AND_PASSING,1390,40,1,2,3,1436
355528399,INRIA/spoon,29/08/18 23:02,spirals-bears,b8329044-fa38-406d-a987-171158d4cf73_03-18-week3-FAILING_AND_PASSING,10,0,8,2,0,4,0,537,20,3,518,62,9,0,1173
355340978,EnMasseProject/enmasse,29/08/18 23:03,spirals-bears,b8329044-fa38-406d-a987-171158d4cf73_03-18-week3-FAILING_AND_PASSING,28,0,28
354709008,INRIA/spoon,29/08/18 23:03,spirals-bears,b8329044-fa38-406d-a987-171158d4cf73_03-18-week3-FAILING_AND_PASSING,9,0,7,0,0,7,0,545,22,3,518,61,9,1,1182
354067582,EnMasseProject/enmasse,29/08/18 23:03,spirals-bears,b8329044-fa38-406d-a987-171158d4cf73_03-18-week3-FAILING_AND_PASSING,34,0,34
354044956,EnMasseProject/enmasse,29/08/18 23:03,spirals-bears,b8329044-fa38-406d-a987-171158d4cf73_03-18-week3-FAILING_AND_PASSING,30,3,33
353885835,EnMasseProject/enmasse,29/08/18 23:04,spirals-bears,b8329044-fa38-406d-a987-171158d4cf73_03-18-week3-FAILING_AND_PASSING,27,0,27
353702375,EnMasseProject/enmasse,29/08/18 23:04,spirals-bears,b8329044-fa38-406d-a987-171158d4cf73_03-18-week3-FAILING_AND_PASSING,25,3,28
356137573,batfish/batfish,29/08/18 23:05,spirals-bears,b8329044-fa38-406d-a987-171158d4cf73_03-18-week3-FAILING_AND_PASSING,49,2,51
355581973,batfish/batfish,29/08/18 23:06,spirals-bears,b8329044-fa38-406d-a987-171158d4cf73_03-18-week3-FAILING_AND_PASSING,48,0,48
355582007,batfish/batfish,29/08/18 23:07,spirals-bears,b8329044-fa38-406d-a987-171158d4cf73_03-18-week3-FAILING_AND_PASSING,53,3,56
355230055,batfish/batfish,29/08/18 23:08,spirals-bears,b8329044-fa38-406d-a987-171158d4cf73_03-18-week3-FAILING_AND_PASSING,49,3,52
356573177,batfish/batfish,29/08/18 23:09,spirals-bears,b8329044-fa38-406d-a987-171158d4cf73_03-18-week3-FAILING_AND_PASSING,6,220,51,0,1,1,0,279
355230013,batfish/batfish,29/08/18 23:09,spirals-bears,b8329044-fa38-406d-a987-171158d4cf73_03-18-week3-FAILING_AND_PASSING,53,0,53
355151501,batfish/batfish,29/08/18 23:10,spirals-bears,b8329044-fa38-406d-a987-171158d4cf73_03-18-week3-FAILING_AND_PASSING,66,0,66
354921345,batfish/batfish,29/08/18 23:10,spirals-bears,b8329044-fa38-406d-a987-171158d4cf73_03-18-week3-FAILING_AND_PASSING,45,4,49
354801529,batfish/batfish,29/08/18 23:11,spirals-bears,b8329044-fa38-406d-a987-171158d4cf73_03-18-week3-FAILING_AND_PASSING,46,2,48
354921049,batfish/batfish,29/08/18 23:11,spirals-bears,b8329044-fa38-406d-a987-171158d4cf73_03-18-week3-FAILING_AND_PASSING,62,0,62
354453019,batfish/batfish,29/08/18 23:12,spirals-bears,b8329044-fa38-406d-a987-171158d4cf73_03-18-week3-FAILING_AND_PASSING,50,0,50
354580434,batfish/batfish,29/08/18 23:12,spirals-bears,b8329044-fa38-406d-a987-171158d4cf73_03-18-week3-FAILING_AND_PASSING,64,0,64
354442080,batfish/batfish,29/08/18 23:13,spirals-bears,b8329044-fa38-406d-a987-171158d4cf73_03-18-week3-FAILING_AND_PASSING,51,0,51
354453174,batfish/batfish,29/08/18 23:14,spirals-bears,b8329044-fa38-406d-a987-171158d4cf73_03-18-week3-FAILING_AND_PASSING,70,4,74
354077125,batfish/batfish,29/08/18 23:15,spirals-bears,b8329044-fa38-406d-a987-171158d4cf73_03-18-week3-FAILING_AND_PASSING,52,8,60
354442091,batfish/batfish,29/08/18 23:15,spirals-bears,b8329044-fa38-406d-a987-171158d4cf73_03-18-week3-FAILING_AND_PASSING,102,3,105
353581293,batfish/batfish,29/08/18 23:16,spirals-bears,b8329044-fa38-406d-a987-171158d4cf73_03-18-week3-FAILING_AND_PASSING,51,0,51
354208350,apache/incubator-servicecomb-java-chassis,29/08/18 23:16,spirals-bears,b8329044-fa38-406d-a987-171158d4cf73_03-18-week3-FAILING_AND_PASSING,9,3,12
354374582,INRIA/spoon,29/08/18 23:20,spirals-bears,b8329044-fa38-406d-a987-171158d4cf73_03-18-week3-FAILING_AND_PASSING,7,0,8,0,0,4,0,492,22,4,494,61,11,0,1103
354349383,INRIA/spoon,29/08/18 23:20,spirals-bears,b8329044-fa38-406d-a987-171158d4cf73_03-18-week3-FAILING_AND_PASSING,8,0,9,0,0,5,0,492,18,3,495,61,10,0,1101
353811022,apache/incubator-servicecomb-java-chassis,29/08/18 23:21,spirals-bears,b8329044-fa38-406d-a987-171158d4cf73_03-18-week3-FAILING_AND_PASSING,10,0,10
353682482,apache/incubator-servicecomb-java-chassis,29/08/18 23:21,spirals-bears,b8329044-fa38-406d-a987-171158d4cf73_03-18-week3-FAILING_AND_PASSING,9,4,13
356201315,runelite/runelite,29/08/18 23:21,spirals-bears,b8329044-fa38-406d-a987-171158d4cf73_03-18-week3-FAILING_AND_PASSING,10,0,10
356187717,runelite/runelite,29/08/18 23:22,spirals-bears,b8329044-fa38-406d-a987-171158d4cf73_03-18-week3-FAILING_AND_PASSING,11,13,24
356123758,runelite/runelite,29/08/18 23:22,spirals-bears,b8329044-fa38-406d-a987-171158d4cf73_03-18-week3-FAILING_AND_PASSING,10,12,22
356128714,runelite/runelite,29/08/18 23:23,spirals-bears,b8329044-fa38-406d-a987-171158d4cf73_03-18-week3-FAILING_AND_PASSING,10,0,10
356101442,runelite/runelite,29/08/18 23:23,spirals-bears,b8329044-fa38-406d-a987-171158d4cf73_03-18-week3-FAILING_AND_PASSING,11,14,25
356085479,runelite/runelite,29/08/18 23:24,spirals-bears,b8329044-fa38-406d-a987-171158d4cf73_03-18-week3-FAILING_AND_PASSING,10,14,24
356049846,runelite/runelite,29/08/18 23:24,spirals-bears,b8329044-fa38-406d-a987-171158d4cf73_03-18-week3-FAILING_AND_PASSING,10,12,22
355327994,apache/incubator-servicecomb-java-chassis,29/08/18 23:25,spirals-bears,b8329044-fa38-406d-a987-171158d4cf73_03-18-week3-FAILING_AND_PASSING,357,185,9,1,1,5,0,558
356007544,runelite/runelite,29/08/18 23:25,spirals-bears,b8329044-fa38-406d-a987-171158d4cf73_03-18-week3-FAILING_AND_PASSING,10,15,25
355850319,runelite/runelite,29/08/18 23:25,spirals-bears,b8329044-fa38-406d-a987-171158d4cf73_03-18-week3-FAILING_AND_PASSING,10,0,10
355638558,runelite/runelite,29/08/18 23:25,spirals-bears,b8329044-fa38-406d-a987-171158d4cf73_03-18-week3-FAILING_AND_PASSING,11,0,11
355330160,runelite/runelite,29/08/18 23:25,spirals-bears,b8329044-fa38-406d-a987-171158d4cf73_03-18-week3-FAILING_AND_PASSING,11,0,11
355035494,runelite/runelite,29/08/18 23:26,spirals-bears,b8329044-fa38-406d-a987-171158d4cf73_03-18-week3-FAILING_AND_PASSING,12,4,16
354128213,apache/incubator-servicecomb-java-chassis,29/08/18 23:26,spirals-bears,b8329044-fa38-406d-a987-171158d4cf73_03-18-week3-FAILING_AND_PASSING,362,183,9,1,1,5,1,562
354887703,runelite/runelite,29/08/18 23:26,spirals-bears,b8329044-fa38-406d-a987-171158d4cf73_03-18-week3-FAILING_AND_PASSING,12,0,12
354780370,runelite/runelite,29/08/18 23:26,spirals-bears,b8329044-fa38-406d-a987-171158d4cf73_03-18-week3-FAILING_AND_PASSING,11,0,11
354610609,runelite/runelite,29/08/18 23:26,spirals-bears,b8329044-fa38-406d-a987-171158d4cf73_03-18-week3-FAILING_AND_PASSING,13,0,13
354584527,runelite/runelite,29/08/18 23:26,spirals-bears,b8329044-fa38-406d-a987-171158d4cf73_03-18-week3-FAILING_AND_PASSING,12,0,12
354314535,runelite/runelite,29/08/18 23:26,spirals-bears,b8329044-fa38-406d-a987-171158d4cf73_03-18-week3-FAILING_AND_PASSING,11,0,11
354282511,runelite/runelite,29/08/18 23:26,spirals-bears,b8329044-fa38-406d-a987-171158d4cf73_03-18-week3-FAILING_AND_PASSING,11,0,11
354424134,runelite/runelite,29/08/18 23:27,spirals-bears,b8329044-fa38-406d-a987-171158d4cf73_03-18-week3-FAILING_AND_PASSING,12,20,32
353315714,runelite/runelite,29/08/18 23:27,spirals-bears,b8329044-fa38-406d-a987-171158d4cf73_03-18-week3-FAILING_AND_PASSING,11,15,26
353774072,apache/incubator-servicecomb-java-chassis,29/08/18 23:30,spirals-bears,b8329044-fa38-406d-a987-171158d4cf73_03-18-week3-FAILING_AND_PASSING,352,198,10,1,5,6,0,572
356445014,CorfuDB/CorfuDB,29/08/18 23:31,spirals-bears,b8329044-fa38-406d-a987-171158d4cf73_03-18-week3-FAILING_AND_PASSING,249,0,249
356317743,CorfuDB/CorfuDB,29/08/18 23:31,spirals-bears,b8329044-fa38-406d-a987-171158d4cf73_03-18-week3-FAILING_AND_PASSING,250,0,250
354541024,CorfuDB/CorfuDB,29/08/18 23:31,spirals-bears,b8329044-fa38-406d-a987-171158d4cf73_03-18-week3-FAILING_AND_PASSING,257,3,260
354497548,CorfuDB/CorfuDB,29/08/18 23:35,spirals-bears,b8329044-fa38-406d-a987-171158d4cf73_03-18-week3-FAILING_AND_PASSING,249,4,253
354130959,CorfuDB/CorfuDB,29/08/18 23:35,spirals-bears,b8329044-fa38-406d-a987-171158d4cf73_03-18-week3-FAILING_AND_PASSING,237,3,240
354111943,CorfuDB/CorfuDB,29/08/18 23:35,spirals-bears,b8329044-fa38-406d-a987-171158d4cf73_03-18-week3-FAILING_AND_PASSING,237,3,240
353486587,CorfuDB/CorfuDB,29/08/18 23:36,spirals-bears,b8329044-fa38-406d-a987-171158d4cf73_03-18-week3-FAILING_AND_PASSING,245,3,248
356452520,apache/activemq-artemis,29/08/18 23:37,spirals-bears,b8329044-fa38-406d-a987-171158d4cf73_03-18-week3-FAILING_AND_PASSING,30,6,36
354067872,apache/activemq-artemis,29/08/18 23:37,spirals-bears,b8329044-fa38-406d-a987-171158d4cf73_03-18-week3-FAILING_AND_PASSING,25,4,29
355797196,apache/activemq-artemis,29/08/18 23:38,spirals-bears,b8329044-fa38-406d-a987-171158d4cf73_03-18-week3-FAILING_AND_PASSING,27,6,33
354183799,apache/activemq-artemis,29/08/18 23:39,spirals-bears,b8329044-fa38-406d-a987-171158d4cf73_03-18-week3-FAILING_AND_PASSING,25,6,31
353499676,CorfuDB/CorfuDB,29/08/18 23:39,spirals-bears,b8329044-fa38-406d-a987-171158d4cf73_03-18-week3-FAILING_AND_PASSING,249,3,252
354039719,CorfuDB/CorfuDB,29/08/18 23:40,spirals-bears,b8329044-fa38-406d-a987-171158d4cf73_03-18-week3-FAILING_AND_PASSING,315,0,315
356578396,Azure/azure-libraries-for-java,29/08/18 23:50,spirals-bears,b8329044-fa38-406d-a987-171158d4cf73_03-18-week3-FAILING_AND_PASSING,75,0,11,0,1,19,0,93,86,5,96,171,60,0,617
356137356,Azure/azure-libraries-for-java,29/08/18 23:51,spirals-bears,b8329044-fa38-406d-a987-171158d4cf73_03-18-week3-FAILING_AND_PASSING,59,0,10,0,1,20,0,90,92,6,100,173,79,0,630
356144152,Azure/azure-libraries-for-java,29/08/18 23:51,spirals-bears,b8329044-fa38-406d-a987-171158d4cf73_03-18-week3-FAILING_AND_PASSING,61,3,64
353653654,apache/activemq-artemis,29/08/18 23:51,spirals-bears,b8329044-fa38-406d-a987-171158d4cf73_03-18-week3-FAILING_AND_PASSING,266,457,25,0,1,1,0,750
355572231,Azure/azure-libraries-for-java,29/08/18 23:52,spirals-bears,b8329044-fa38-406d-a987-171158d4cf73_03-18-week3-FAILING_AND_PASSING,68,4,72
355586801,Azure/azure-libraries-for-java,29/08/18 23:53,spirals-bears,b8329044-fa38-406d-a987-171158d4cf73_03-18-week3-FAILING_AND_PASSING,74,3,77
352939655,Azure/azure-libraries-for-java,29/08/18 23:53,spirals-bears,b8329044-fa38-406d-a987-171158d4cf73_03-18-week3-FAILING_AND_PASSING,62,4,66
354848370,graphhopper/graphhopper,29/08/18 23:54,spirals-bears,b8329044-fa38-406d-a987-171158d4cf73_03-18-week3-FAILING_AND_PASSING,18,0,18
355403133,lettuce-io/lettuce-core,29/08/18 23:55,spirals-bears,b8329044-fa38-406d-a987-171158d4cf73_03-18-week3-FAILING_AND_PASSING,17,46,8,0,0,1,0,72
353719261,lettuce-io/lettuce-core,29/08/18 23:56,spirals-bears,b8329044-fa38-406d-a987-171158d4cf73_03-18-week3-FAILING_AND_PASSING,16,40,7,0,0,1,0,64
356079775,raphw/byte-buddy,29/08/18 23:57,spirals-bears,b8329044-fa38-406d-a987-171158d4cf73_03-18-week3-FAILING_AND_PASSING,264,0,264
355557475,Azure/azure-libraries-for-java,30/08/18 00:01,spirals-bears,b8329044-fa38-406d-a987-171158d4cf73_03-18-week3-FAILING_AND_PASSING,77,0,3,0,0,22,0,94,74,0,93,168,64,0,595
355832070,magefree/mage,30/08/18 00:14,spirals-bears,b8329044-fa38-406d-a987-171158d4cf73_03-18-week3-FAILING_AND_PASSING,8,0,11,0,1,32,0,178,33,2,210,357,180,1,1013
355376312,magefree/mage,30/08/18 00:14,spirals-bears,b8329044-fa38-406d-a987-171158d4cf73_03-18-week3-FAILING_AND_PASSING,8,0,13,0,1,36,0,181,33,1,204,354,178,1,1010
356025706,apache/storm,30/08/18 00:16,spirals-bears,b8329044-fa38-406d-a987-171158d4cf73_03-18-week3-FAILING_AND_PASSING,13,0,2,0,2,8,0,589,521,0,575,671,43,0,2424
355146206,magefree/mage,30/08/18 00:17,spirals-bears,b8329044-fa38-406d-a987-171158d4cf73_03-18-week3-FAILING_AND_PASSING,8,0,16,0,1,35,0,148,35,1,177,349,173,1,944
354872435,magefree/mage,30/08/18 00:30,spirals-bears,b8329044-fa38-406d-a987-171158d4cf73_03-18-week3-FAILING_AND_PASSING,8,0,11,0,0,25,0,181,33,0,199,339,186,1,983
354785828,magefree/mage,30/08/18 00:31,spirals-bears,b8329044-fa38-406d-a987-171158d4cf73_03-18-week3-FAILING_AND_PASSING,8,0,13,0,0,29,0,178,33,1,195,342,169,1,969
354572921,magefree/mage,30/08/18 00:32,spirals-bears,b8329044-fa38-406d-a987-171158d4cf73_03-18-week3-FAILING_AND_PASSING,8,0,12,0,0,27,0,150,29,1,194,339,176,1,937
354290296,magefree/mage,30/08/18 00:33,spirals-bears,b8329044-fa38-406d-a987-171158d4cf73_03-18-week3-FAILING_AND_PASSING,8,0,14,0,1,24,0,176,32,1,175,337,167,1,936
353837983,molgenis/molgenis,30/08/18 00:34,spirals-bears,b8329044-fa38-406d-a987-171158d4cf73_03-18-week3-FAILING_AND_PASSING,50,8,58
355810491,visallo/vertexium,30/08/18 00:35,spirals-bears,b8329044-fa38-406d-a987-171158d4cf73_03-18-week3-FAILING_AND_PASSING,7,3,10
354476311,visallo/vertexium,30/08/18 00:35,spirals-bears,b8329044-fa38-406d-a987-171158d4cf73_03-18-week3-FAILING_AND_PASSING,8,2,10
355253388,StuPro-TOSCAna/TOSCAna,30/08/18 00:35,spirals-bears,b8329044-fa38-406d-a987-171158d4cf73_03-18-week3-FAILING_AND_PASSING,15,0,15
354801380,StuPro-TOSCAna/TOSCAna,30/08/18 00:36,spirals-bears,b8329044-fa38-406d-a987-171158d4cf73_03-18-week3-FAILING_AND_PASSING,17,0,17
355413107,molgenis/molgenis,30/08/18 00:41,spirals-bears,b8329044-fa38-406d-a987-171158d4cf73_03-18-week3-FAILING_AND_PASSING,498,37,0,7,1,543
354048772,magefree/mage,30/08/18 00:47,spirals-bears,b8329044-fa38-406d-a987-171158d4cf73_03-18-week3-FAILING_AND_PASSING,8,0,14,0,0,25,0,182,28,1,207,340,193,2,1000
353817112,ga4gh/dockstore,30/08/18 00:48,spirals-bears,b8329044-fa38-406d-a987-171158d4cf73_03-18-week3-FAILING_AND_PASSING,10,0,10
353585390,magefree/mage,30/08/18 00:48,spirals-bears,b8329044-fa38-406d-a987-171158d4cf73_03-18-week3-FAILING_AND_PASSING,9,0,15,0,1,31,0,182,33,1,209,345,191,1,1018
354632958,atomix/atomix,30/08/18 00:48,spirals-bears,b8329044-fa38-406d-a987-171158d4cf73_03-18-week3-FAILING_AND_PASSING,11,2,13
354742701,dropwizard/metrics,30/08/18 00:49,spirals-bears,b8329044-fa38-406d-a987-171158d4cf73_03-18-week3-FAILING_AND_PASSING,6,6,12
354788585,dropwizard/metrics,30/08/18 00:54,spirals-bears,b8329044-fa38-406d-a987-171158d4cf73_03-18-week3-FAILING_AND_PASSING,11,0,3,0,5,0,4,1,0,63,0,75,0,20,123,7,1,0,313
352596208,resteasy/Resteasy,30/08/18 00:54,spirals-bears,b8329044-fa38-406d-a987-171158d4cf73_03-18-week3-FAILING_AND_PASSING,16,4,20
356457601,geoserver/geoserver,30/08/18 00:59,spirals-bears,b8329044-fa38-406d-a987-171158d4cf73_03-18-week3-FAILING_AND_PASSING,170,50,0,15,1,236
356030069,airlift/airlift,30/08/18 01:01,spirals-bears,b8329044-fa38-406d-a987-171158d4cf73_03-18-week3-FAILING_AND_PASSING,14,0,0,0,1,1,0,165,124,0,165,235,14,0,719
356497506,geoserver/geoserver,30/08/18 01:02,spirals-bears,b8329044-fa38-406d-a987-171158d4cf73_03-18-week3-FAILING_AND_PASSING,136,48,0,6,1,191
354485840,languagetool-org/languagetool,30/08/18 01:03,spirals-bears,b8329044-fa38-406d-a987-171158d4cf73_03-18-week3-FAILING_AND_PASSING,9,42,0,1,26,0,1,36,0,805,0,69,1,192,105,286,35,0,1608
353903548,languagetool-org/languagetool,30/08/18 01:13,spirals-bears,b8329044-fa38-406d-a987-171158d4cf73_03-18-week3-FAILING_AND_PASSING,9,39,0,3,27,0,1,33,0,795,0,56,0,437,125,300,39,0,1864
353527253,SpoonLabs/nopol,30/08/18 01:14,spirals-bears,b8329044-fa38-406d-a987-171158d4cf73_03-18-week3-FAILING_AND_PASSING,41,0,41
354020997,aicis/fresco,30/08/18 01:15,spirals-bears,b8329044-fa38-406d-a987-171158d4cf73_03-18-week3-FAILING_AND_PASSING,9,0,0,0,0,4,0,255,33,0,287,93,9,0,690
353548762,arcao/geocaching-api,30/08/18 01:15,spirals-bears,b8329044-fa38-406d-a987-171158d4cf73_03-18-week3-FAILING_AND_PASSING,10,0,0,0,0,0,0,17,9,0,18,21,3,0,78
356435523,rabbitmq/rabbitmq-perf-test,30/08/18 01:17,spirals-bears,b8329044-fa38-406d-a987-171158d4cf73_03-18-week3-FAILING_AND_PASSING,52,23,3,0,0,0,0,78
355764691,rabbitmq/rabbitmq-perf-test,30/08/18 01:18,spirals-bears,b8329044-fa38-406d-a987-171158d4cf73_03-18-week3-FAILING_AND_PASSING,32,25,3,0,0,0,0,60
355831993,rabbitmq/rabbitmq-perf-test,30/08/18 01:19,spirals-bears,b8329044-fa38-406d-a987-171158d4cf73_03-18-week3-FAILING_AND_PASSING,63,22,2,0,2,0,0,89
349541463,swagger-api/swagger-codegen,30/08/18 01:20,spirals-bears,b8329044-fa38-406d-a987-171158d4cf73_03-18-week3-FAILING_AND_PASSING,27,214,35,0,8,0,0,284
356175351,datastax/java-driver,30/08/18 01:20,spirals-bears,b8329044-fa38-406d-a987-171158d4cf73_03-18-week3-FAILING_AND_PASSING,18,0,18
356085629,datastax/java-driver,30/08/18 01:21,spirals-bears,b8329044-fa38-406d-a987-171158d4cf73_03-18-week3-FAILING_AND_PASSING,16,3,19
356085542,datastax/java-driver,30/08/18 01:21,spirals-bears,b8329044-fa38-406d-a987-171158d4cf73_03-18-week3-FAILING_AND_PASSING,17,0,17
354915392,datastax/java-driver,30/08/18 01:22,spirals-bears,b8329044-fa38-406d-a987-171158d4cf73_03-18-week3-FAILING_AND_PASSING,16,2,18
354429785,datastax/java-driver,30/08/18 01:22,spirals-bears,b8329044-fa38-406d-a987-171158d4cf73_03-18-week3-FAILING_AND_PASSING,16,2,18
354093503,datastax/java-driver,30/08/18 01:23,spirals-bears,b8329044-fa38-406d-a987-171158d4cf73_03-18-week3-FAILING_AND_PASSING,16,2,18
353559133,datastax/java-driver,30/08/18 01:23,spirals-bears,b8329044-fa38-406d-a987-171158d4cf73_03-18-week3-FAILING_AND_PASSING,16,0,16
353559158,datastax/java-driver,30/08/18 01:24,spirals-bears,b8329044-fa38-406d-a987-171158d4cf73_03-18-week3-FAILING_AND_PASSING,16,3,19
354355063,rabbitmq/rabbitmq-perf-test,30/08/18 01:24,spirals-bears,b8329044-fa38-406d-a987-171158d4cf73_03-18-week3-FAILING_AND_PASSING,11,0,0,3,5,0,0,2,0,50,0,11,2,129,23,4,0,0,240
356056935,SzFMV2018-Tavasz/AutomatedCar,30/08/18 01:25,spirals-bears,b8329044-fa38-406d-a987-171158d4cf73_03-18-week3-FAILING_AND_PASSING,8,0,0,2,4,0,0,0,0,8,0,8,2,10,18,9,0,0,69
355680410,SzFMV2018-Tavasz/AutomatedCar,30/08/18 01:25,spirals-bears,b8329044-fa38-406d-a987-171158d4cf73_03-18-week3-FAILING_AND_PASSING,8,0,0,2,4,0,0,0,0,8,0,8,2,9,20,9,0,0,70
355680397,SzFMV2018-Tavasz/AutomatedCar,30/08/18 01:26,spirals-bears,b8329044-fa38-406d-a987-171158d4cf73_03-18-week3-FAILING_AND_PASSING,9,0,0,0,4,0,0,0,0,9,0,8,0,10,19,9,0,0,68
355139608,SzFMV2018-Tavasz/AutomatedCar,30/08/18 01:26,spirals-bears,b8329044-fa38-406d-a987-171158d4cf73_03-18-week3-FAILING_AND_PASSING,9,0,0,2,4,0,0,0,0,10,0,10,2,11,20,8,0,0,76
355138115,SzFMV2018-Tavasz/AutomatedCar,30/08/18 01:28,spirals-bears,b8329044-fa38-406d-a987-171158d4cf73_03-18-week3-FAILING_AND_PASSING,9,0,0,0,4,0,0,0,0,10,0,10,0,10,19,10,0,0,72
354706283,SzFMV2018-Tavasz/AutomatedCar,30/08/18 01:28,spirals-bears,b8329044-fa38-406d-a987-171158d4cf73_03-18-week3-FAILING_AND_PASSING,9,0,0,3,3,0,0,0,0,9,0,9,2,11,19,8,0,0,73
353439417,geoserver/geoserver,30/08/18 01:30,spirals-bears,b8329044-fa38-406d-a987-171158d4cf73_03-18-week3-FAILING_AND_PASSING,13,0,5,0,0,32,0,471,32,1,465,613,74,1,1707
353895642,danglotb/dspot,30/08/18 01:30,spirals-bears,b8329044-fa38-406d-a987-171158d4cf73_03-18-week3-FAILING_AND_PASSING,5,0,5
353878333,danglotb/dspot,30/08/18 01:30,spirals-bears,b8329044-fa38-406d-a987-171158d4cf73_03-18-week3-FAILING_AND_PASSING,5,0,5
355458721,dhis2/dhis2-core,30/08/18 01:31,spirals-bears,b8329044-fa38-406d-a987-171158d4cf73_03-18-week3-FAILING_AND_PASSING,22,3,25
353439167,geoserver/geoserver,30/08/18 01:31,spirals-bears,b8329044-fa38-406d-a987-171158d4cf73_03-18-week3-FAILING_AND_PASSING,10,0,5,0,2,35,0,496,31,0,493,599,57,0,1728
355319804,dhis2/dhis2-core,30/08/18 01:31,spirals-bears,b8329044-fa38-406d-a987-171158d4cf73_03-18-week3-FAILING_AND_PASSING,22,3,25
355255262,dhis2/dhis2-core,30/08/18 01:34,spirals-bears,b8329044-fa38-406d-a987-171158d4cf73_03-18-week3-FAILING_AND_PASSING,90,25,0,1,1,117
353681958,christian-schlichtherle/truelicense,30/08/18 01:42,spirals-bears,b8329044-fa38-406d-a987-171158d4cf73_03-18-week3-FAILING_AND_PASSING,56,412,5,0,0,1,0,474
355720239,debezium/debezium,30/08/18 01:42,spirals-bears,b8329044-fa38-406d-a987-171158d4cf73_03-18-week3-FAILING_AND_PASSING,6,2,8
354652807,danglotb/dspot,30/08/18 01:43,spirals-bears,b8329044-fa38-406d-a987-171158d4cf73_03-18-week3-FAILING_AND_PASSING,10,0,0,0,0,1,0,13,52,0,646,192,5,0,919
354170531,debezium/debezium,30/08/18 01:44,spirals-bears,b8329044-fa38-406d-a987-171158d4cf73_03-18-week3-FAILING_AND_PASSING,7,4,11
354248002,danglotb/dspot,30/08/18 01:44,spirals-bears,b8329044-fa38-406d-a987-171158d4cf73_03-18-week3-FAILING_AND_PASSING,10,0,0,0,0,1,0,8,50,0,721,177,5,0,972
355899803,MyCoRe-Org/mycore,30/08/18 01:44,spirals-bears,b8329044-fa38-406d-a987-171158d4cf73_03-18-week3-FAILING_AND_PASSING,45,0,45
355057408,debezium/debezium,30/08/18 01:45,spirals-bears,b8329044-fa38-406d-a987-171158d4cf73_03-18-week3-FAILING_AND_PASSING,44,129,6,0,0,0,0,179
355899830,MyCoRe-Org/mycore,30/08/18 01:45,spirals-bears,b8329044-fa38-406d-a987-171158d4cf73_03-18-week3-FAILING_AND_PASSING,48,2,50
353682012,MyCoRe-Org/mycore,30/08/18 01:45,spirals-bears,b8329044-fa38-406d-a987-171158d4cf73_03-18-week3-FAILING_AND_PASSING,46,0,46
356148907,2018swecapstone/h2ms,30/08/18 01:46,spirals-bears,b8329044-fa38-406d-a987-171158d4cf73_03-18-week3-FAILING_AND_PASSING,3,3,6
354214473,christian-schlichtherle/truelicense,30/08/18 01:46,spirals-bears,b8329044-fa38-406d-a987-171158d4cf73_03-18-week3-FAILING_AND_PASSING,9,0,0,0,1,1,0,50,321,0,50,404,7,0,843
355865996,Activiti/Activiti,30/08/18 01:46,spirals-bears,b8329044-fa38-406d-a987-171158d4cf73_03-18-week3-FAILING_AND_PASSING,35,3,38
353682025,MyCoRe-Org/mycore,30/08/18 01:47,spirals-bears,b8329044-fa38-406d-a987-171158d4cf73_03-18-week3-FAILING_AND_PASSING,76,3,79
356345622,Spirals-Team/repairnator,30/08/18 01:47,spirals-bears,b8329044-fa38-406d-a987-171158d4cf73_03-18-week3-FAILING_AND_PASSING,17,0,17
356346040,Spirals-Team/repairnator,30/08/18 01:48,spirals-bears,b8329044-fa38-406d-a987-171158d4cf73_03-18-week3-FAILING_AND_PASSING,18,2,20
356263012,Spirals-Team/repairnator,30/08/18 01:48,spirals-bears,b8329044-fa38-406d-a987-171158d4cf73_03-18-week3-FAILING_AND_PASSING,18,3,21
356575309,jnidzwetzki/bboxdb,30/08/18 01:51,spirals-bears,b8329044-fa38-406d-a987-171158d4cf73_03-18-week3-FAILING_AND_PASSING,6,0,0,0,0,1,0,28,14,0,27,74,8,0,158
355871910,zalando/zalenium,30/08/18 01:51,spirals-bears,b8329044-fa38-406d-a987-171158d4cf73_03-18-week3-FAILING_AND_PASSING,13,0,2,0,0,0,0,116,17,2,116,38,5,0,309
355820815,zalando/zalenium,30/08/18 01:52,spirals-bears,b8329044-fa38-406d-a987-171158d4cf73_03-18-week3-FAILING_AND_PASSING,12,1,0,2,5,0,1,1,0,111,0,19,3,113,37,5,0,0,310
340409087,fabric8io/fabric8-maven-plugin,30/08/18 01:54,spirals-bears,b8329044-fa38-406d-a987-171158d4cf73_03-18-week3-FAILING_AND_PASSING,120,325,31,0,0,2,0,478
356414084,jnidzwetzki/bboxdb,30/08/18 01:54,spirals-bears,b8329044-fa38-406d-a987-171158d4cf73_03-18-week3-FAILING_AND_PASSING,5,0,0,0,0,1,0,28,15,0,30,70,9,0,158
355370258,jnidzwetzki/bboxdb,30/08/18 01:54,spirals-bears,b8329044-fa38-406d-a987-171158d4cf73_03-18-week3-FAILING_AND_PASSING,5,0,0,0,0,1,0,27,17,0,31,58,8,0,147
355358297,jnidzwetzki/bboxdb,30/08/18 01:55,spirals-bears,b8329044-fa38-406d-a987-171158d4cf73_03-18-week3-FAILING_AND_PASSING,6,0,0,0,0,2,0,27,15,0,27,75,8,0,160
355359507,jnidzwetzki/bboxdb,30/08/18 01:56,spirals-bears,b8329044-fa38-406d-a987-171158d4cf73_03-18-week3-FAILING_AND_PASSING,5,0,1,0,0,1,0,27,15,0,29,72,8,0,158
354930092,jnidzwetzki/bboxdb,30/08/18 01:56,spirals-bears,b8329044-fa38-406d-a987-171158d4cf73_03-18-week3-FAILING_AND_PASSING,5,0,0,0,0,1,0,27,16,0,30,57,9,0,145
