350262360,apache/flink,26/08/18 14:33,spirals-bears,48c73b9c-1328-499c-ba34-dd1c2d05cb62_03-18-week1-FAILING_AND_PASSING,62,7,69
350151287,apache/flink,26/08/18 14:33,spirals-bears,48c73b9c-1328-499c-ba34-dd1c2d05cb62_03-18-week1-FAILING_AND_PASSING,69,7,76
348527735,apache/flink,26/08/18 14:34,spirals-bears,48c73b9c-1328-499c-ba34-dd1c2d05cb62_03-18-week1-FAILING_AND_PASSING,60,7,67
348372853,apache/flink,26/08/18 14:35,spirals-bears,48c73b9c-1328-499c-ba34-dd1c2d05cb62_03-18-week1-FAILING_AND_PASSING,59,7,66
348589808,apache/flink,26/08/18 14:36,spirals-bears,48c73b9c-1328-499c-ba34-dd1c2d05cb62_03-18-week1-FAILING_AND_PASSING,181,63,0,12,2,258
349625277,apache/flink,26/08/18 15:19,spirals-bears,48c73b9c-1328-499c-ba34-dd1c2d05cb62_03-18-week1-FAILING_AND_PASSING,9,0,8,1,2,144,1,44,915,14,50,1619,58,1,2866
347899425,apache/flink,26/08/18 15:21,spirals-bears,48c73b9c-1328-499c-ba34-dd1c2d05cb62_03-18-week1-FAILING_AND_PASSING,63,7,70
347367625,apache/flink,26/08/18 15:22,spirals-bears,48c73b9c-1328-499c-ba34-dd1c2d05cb62_03-18-week1-FAILING_AND_PASSING,64,7,71
348139025,apache/flink,26/08/18 15:23,spirals-bears,48c73b9c-1328-499c-ba34-dd1c2d05cb62_03-18-week1-FAILING_AND_PASSING,18,0,4,0,1,181,0,40,841,6,61,1647,60,2,2861
347362957,apache/flink,26/08/18 15:24,spirals-bears,48c73b9c-1328-499c-ba34-dd1c2d05cb62_03-18-week1-FAILING_AND_PASSING,75,7,82
350135175,prestodb/presto,26/08/18 15:24,spirals-bears,48c73b9c-1328-499c-ba34-dd1c2d05cb62_03-18-week1-FAILING_AND_PASSING,44,5,49
348545091,apache/flink,26/08/18 15:25,spirals-bears,48c73b9c-1328-499c-ba34-dd1c2d05cb62_03-18-week1-FAILING_AND_PASSING,19,0,9,1,1,143,0,46,1153,12,61,1608,61,2,3116
350085616,prestodb/presto,26/08/18 15:26,spirals-bears,48c73b9c-1328-499c-ba34-dd1c2d05cb62_03-18-week1-FAILING_AND_PASSING,44,5,49
348251460,apache/flink,26/08/18 15:27,spirals-bears,48c73b9c-1328-499c-ba34-dd1c2d05cb62_03-18-week1-FAILING_AND_PASSING,12,0,9,0,1,195,0,45,1000,14,55,1651,62,4,3048
350069856,prestodb/presto,26/08/18 15:27,spirals-bears,48c73b9c-1328-499c-ba34-dd1c2d05cb62_03-18-week1-FAILING_AND_PASSING,46,5,51
350080544,prestodb/presto,26/08/18 15:28,spirals-bears,48c73b9c-1328-499c-ba34-dd1c2d05cb62_03-18-week1-FAILING_AND_PASSING,50,5,55
348800442,prestodb/presto,26/08/18 15:29,spirals-bears,48c73b9c-1328-499c-ba34-dd1c2d05cb62_03-18-week1-FAILING_AND_PASSING,47,7,54
349413087,prestodb/presto,26/08/18 15:30,spirals-bears,48c73b9c-1328-499c-ba34-dd1c2d05cb62_03-18-week1-FAILING_AND_PASSING,46,6,52
348514591,prestodb/presto,26/08/18 15:31,spirals-bears,48c73b9c-1328-499c-ba34-dd1c2d05cb62_03-18-week1-FAILING_AND_PASSING,53,5,58
350126827,prestodb/presto,26/08/18 15:54,spirals-bears,48c73b9c-1328-499c-ba34-dd1c2d05cb62_03-18-week1-FAILING_AND_PASSING,840,909,46,0,2,4,1801
350114165,prestodb/presto,26/08/18 15:54,spirals-bears,48c73b9c-1328-499c-ba34-dd1c2d05cb62_03-18-week1-FAILING_AND_PASSING,819,898,48,0,8,2,1775
348092685,prestodb/presto,26/08/18 15:56,spirals-bears,48c73b9c-1328-499c-ba34-dd1c2d05cb62_03-18-week1-FAILING_AND_PASSING,43,5,48
347919329,prestodb/presto,26/08/18 15:57,spirals-bears,48c73b9c-1328-499c-ba34-dd1c2d05cb62_03-18-week1-FAILING_AND_PASSING,42,6,48
349660608,prestodb/presto,26/08/18 15:57,spirals-bears,48c73b9c-1328-499c-ba34-dd1c2d05cb62_03-18-week1-FAILING_AND_PASSING,802,943,45,0,3,1,1794
349199707,prestodb/presto,26/08/18 15:58,spirals-bears,48c73b9c-1328-499c-ba34-dd1c2d05cb62_03-18-week1-FAILING_AND_PASSING,112,45,0,6,1,164
348372635,prestodb/presto,26/08/18 15:58,spirals-bears,48c73b9c-1328-499c-ba34-dd1c2d05cb62_03-18-week1-FAILING_AND_PASSING,42,6,48
349218542,prestodb/presto,26/08/18 16:02,spirals-bears,48c73b9c-1328-499c-ba34-dd1c2d05cb62_03-18-week1-FAILING_AND_PASSING,796,979,45,0,3,1,1824
348402691,prestodb/presto,26/08/18 16:27,spirals-bears,48c73b9c-1328-499c-ba34-dd1c2d05cb62_03-18-week1-FAILING_AND_PASSING,821,898,43,0,2,1,1765
347572319,prestodb/presto,26/08/18 16:27,spirals-bears,48c73b9c-1328-499c-ba34-dd1c2d05cb62_03-18-week1-FAILING_AND_PASSING,816,887,43,0,1,1,1748
349623237,apache/incubator-druid,26/08/18 17:20,spirals-bears,48c73b9c-1328-499c-ba34-dd1c2d05cb62_03-18-week1-FAILING_AND_PASSING,16,0,3,0,1,49,0,1623,481,4,1536,892,34,8,4647
348044368,apache/incubator-druid,26/08/18 17:22,spirals-bears,48c73b9c-1328-499c-ba34-dd1c2d05cb62_03-18-week1-FAILING_AND_PASSING,11,0,13,0,1,57,0,1546,641,8,1649,1026,37,19,5008
348488625,apache/incubator-druid,26/08/18 17:39,spirals-bears,48c73b9c-1328-499c-ba34-dd1c2d05cb62_03-18-week1-FAILING_AND_PASSING,88,0,3,0,1,124,0,1397,342,22,1475,529,49,12,4042
349571440,apache/incubator-druid,26/08/18 17:44,spirals-bears,48c73b9c-1328-499c-ba34-dd1c2d05cb62_03-18-week1-FAILING_AND_PASSING,13,0,11,0,1,41,0,1335,313,4,1740,830,49,4,4341
348105154,apache/incubator-druid,26/08/18 17:45,spirals-bears,48c73b9c-1328-499c-ba34-dd1c2d05cb62_03-18-week1-FAILING_AND_PASSING,38,12,50
347596789,apache/incubator-druid,26/08/18 17:49,spirals-bears,48c73b9c-1328-499c-ba34-dd1c2d05cb62_03-18-week1-FAILING_AND_PASSING,79,76,155
348536404,apache/incubator-druid,26/08/18 17:55,spirals-bears,48c73b9c-1328-499c-ba34-dd1c2d05cb62_03-18-week1-FAILING_AND_PASSING,1025,1055,34,0,3,1,2118
347684220,apache/incubator-druid,26/08/18 17:57,spirals-bears,48c73b9c-1328-499c-ba34-dd1c2d05cb62_03-18-week1-FAILING_AND_PASSING,49,15,64
347524823,apache/incubator-druid,26/08/18 17:58,spirals-bears,48c73b9c-1328-499c-ba34-dd1c2d05cb62_03-18-week1-FAILING_AND_PASSING,41,0,41
349609561,JMRI/JMRI,26/08/18 18:36,spirals-bears,48c73b9c-1328-499c-ba34-dd1c2d05cb62_03-18-week1-FAILING_AND_PASSING,1823,177,280,0,6,1,2,2289
350073568,JMRI/JMRI,26/08/18 18:36,spirals-bears,48c73b9c-1328-499c-ba34-dd1c2d05cb62_03-18-week1-FAILING_AND_PASSING,1887,154,298,0,4,2,2,2347
348442951,apache/incubator-druid,26/08/18 18:38,spirals-bears,48c73b9c-1328-499c-ba34-dd1c2d05cb62_03-18-week1-FAILING_AND_PASSING,10,0,3,1,1,44,0,1371,328,1,1746,1013,35,11,4564
347663579,apache/incubator-druid,26/08/18 18:50,spirals-bears,48c73b9c-1328-499c-ba34-dd1c2d05cb62_03-18-week1-FAILING_AND_PASSING,7,0,3,2,1,43,0,1224,470,0,1500,928,33,2,4213
349506965,JMRI/JMRI,26/08/18 19:10,spirals-bears,48c73b9c-1328-499c-ba34-dd1c2d05cb62_03-18-week1-FAILING_AND_PASSING,1516,110,273,0,7,1,9,1916
349136388,JMRI/JMRI,26/08/18 19:12,spirals-bears,48c73b9c-1328-499c-ba34-dd1c2d05cb62_03-18-week1-FAILING_AND_PASSING,1561,103,275,0,32,1,6,1978
349649919,JMRI/JMRI,26/08/18 19:19,spirals-bears,48c73b9c-1328-499c-ba34-dd1c2d05cb62_03-18-week1-FAILING_AND_PASSING,1608,113,683,0,30,0,6,2440
349009372,JMRI/JMRI,26/08/18 19:28,spirals-bears,48c73b9c-1328-499c-ba34-dd1c2d05cb62_03-18-week1-FAILING_AND_PASSING,1545,103,611,0,7,0,8,2274
348716065,JMRI/JMRI,26/08/18 19:29,spirals-bears,48c73b9c-1328-499c-ba34-dd1c2d05cb62_03-18-week1-FAILING_AND_PASSING,567,25,592
348812972,JMRI/JMRI,26/08/18 19:44,spirals-bears,48c73b9c-1328-499c-ba34-dd1c2d05cb62_03-18-week1-FAILING_AND_PASSING,1539,176,259,0,31,1,17,2023
348790884,JMRI/JMRI,26/08/18 19:46,spirals-bears,48c73b9c-1328-499c-ba34-dd1c2d05cb62_03-18-week1-FAILING_AND_PASSING,1559,169,291,0,8,1,17,2045
348711286,JMRI/JMRI,26/08/18 20:05,spirals-bears,48c73b9c-1328-499c-ba34-dd1c2d05cb62_03-18-week1-FAILING_AND_PASSING,1593,165,302,0,34,0,11,2105
348702848,JMRI/JMRI,26/08/18 20:07,spirals-bears,48c73b9c-1328-499c-ba34-dd1c2d05cb62_03-18-week1-FAILING_AND_PASSING,1603,168,11,270,0,34,0,126,0,82,15,10,2319
348723618,apache/nifi,26/08/18 20:08,spirals-bears,48c73b9c-1328-499c-ba34-dd1c2d05cb62_03-18-week1-FAILING_AND_PASSING,36,8,44
348556317,JMRI/JMRI,26/08/18 20:17,spirals-bears,48c73b9c-1328-499c-ba34-dd1c2d05cb62_03-18-week1-FAILING_AND_PASSING,1498,170,267,0,26,2,3,1966
347905765,JMRI/JMRI,26/08/18 20:20,spirals-bears,48c73b9c-1328-499c-ba34-dd1c2d05cb62_03-18-week1-FAILING_AND_PASSING,1554,170,275,0,7,1,8,2015
349175157,apache/nifi,26/08/18 20:35,spirals-bears,48c73b9c-1328-499c-ba34-dd1c2d05cb62_03-18-week1-FAILING_AND_PASSING,1582,40,2,10,4,1638
348659501,apache/nifi,26/08/18 20:36,spirals-bears,48c73b9c-1328-499c-ba34-dd1c2d05cb62_03-18-week1-FAILING_AND_PASSING,35,6,41
347344922,apache/nifi,26/08/18 20:37,spirals-bears,48c73b9c-1328-499c-ba34-dd1c2d05cb62_03-18-week1-FAILING_AND_PASSING,41,0,41
347445179,JMRI/JMRI,26/08/18 20:43,spirals-bears,48c73b9c-1328-499c-ba34-dd1c2d05cb62_03-18-week1-FAILING_AND_PASSING,1581,165,13,285,0,35,0,126,0,76,10,7,2298
348040968,apache/nifi,26/08/18 20:46,spirals-bears,48c73b9c-1328-499c-ba34-dd1c2d05cb62_03-18-week1-FAILING_AND_PASSING,1647,39,2,7,6,1701
346506661,apache/nifi,26/08/18 20:47,spirals-bears,48c73b9c-1328-499c-ba34-dd1c2d05cb62_03-18-week1-FAILING_AND_PASSING,36,4,40
348580283,INRIA/spoon,26/08/18 20:48,spirals-bears,48c73b9c-1328-499c-ba34-dd1c2d05cb62_03-18-week1-FAILING_AND_PASSING,10,4,14
348656338,INRIA/spoon,26/08/18 20:48,spirals-bears,48c73b9c-1328-499c-ba34-dd1c2d05cb62_03-18-week1-FAILING_AND_PASSING,9,4,13
348331084,INRIA/spoon,26/08/18 20:48,spirals-bears,48c73b9c-1328-499c-ba34-dd1c2d05cb62_03-18-week1-FAILING_AND_PASSING,11,4,15
345089559,apache/nifi,26/08/18 20:49,spirals-bears,48c73b9c-1328-499c-ba34-dd1c2d05cb62_03-18-week1-FAILING_AND_PASSING,1639,34,2,9,4,1688
349826240,EnMasseProject/enmasse,26/08/18 20:49,spirals-bears,48c73b9c-1328-499c-ba34-dd1c2d05cb62_03-18-week1-FAILING_AND_PASSING,31,3,34
349818809,EnMasseProject/enmasse,26/08/18 20:49,spirals-bears,48c73b9c-1328-499c-ba34-dd1c2d05cb62_03-18-week1-FAILING_AND_PASSING,29,0,29
348359460,EnMasseProject/enmasse,26/08/18 20:50,spirals-bears,48c73b9c-1328-499c-ba34-dd1c2d05cb62_03-18-week1-FAILING_AND_PASSING,33,3,36
348359443,EnMasseProject/enmasse,26/08/18 20:50,spirals-bears,48c73b9c-1328-499c-ba34-dd1c2d05cb62_03-18-week1-FAILING_AND_PASSING,31,0,31
348169067,EnMasseProject/enmasse,26/08/18 20:51,spirals-bears,48c73b9c-1328-499c-ba34-dd1c2d05cb62_03-18-week1-FAILING_AND_PASSING,28,0,28
349646299,batfish/batfish,26/08/18 20:51,spirals-bears,48c73b9c-1328-499c-ba34-dd1c2d05cb62_03-18-week1-FAILING_AND_PASSING,59,3,62
349646288,batfish/batfish,26/08/18 20:52,spirals-bears,48c73b9c-1328-499c-ba34-dd1c2d05cb62_03-18-week1-FAILING_AND_PASSING,52,0,52
349592458,batfish/batfish,26/08/18 20:52,spirals-bears,48c73b9c-1328-499c-ba34-dd1c2d05cb62_03-18-week1-FAILING_AND_PASSING,57,0,57
349592462,batfish/batfish,26/08/18 20:53,spirals-bears,48c73b9c-1328-499c-ba34-dd1c2d05cb62_03-18-week1-FAILING_AND_PASSING,54,3,57
349518450,batfish/batfish,26/08/18 20:53,spirals-bears,48c73b9c-1328-499c-ba34-dd1c2d05cb62_03-18-week1-FAILING_AND_PASSING,53,4,57
349518375,batfish/batfish,26/08/18 20:54,spirals-bears,48c73b9c-1328-499c-ba34-dd1c2d05cb62_03-18-week1-FAILING_AND_PASSING,49,0,49
348809094,batfish/batfish,26/08/18 20:54,spirals-bears,48c73b9c-1328-499c-ba34-dd1c2d05cb62_03-18-week1-FAILING_AND_PASSING,51,0,51
348809096,batfish/batfish,26/08/18 20:55,spirals-bears,48c73b9c-1328-499c-ba34-dd1c2d05cb62_03-18-week1-FAILING_AND_PASSING,54,3,57
348508705,batfish/batfish,26/08/18 20:56,spirals-bears,48c73b9c-1328-499c-ba34-dd1c2d05cb62_03-18-week1-FAILING_AND_PASSING,54,0,54
348409769,batfish/batfish,26/08/18 20:56,spirals-bears,48c73b9c-1328-499c-ba34-dd1c2d05cb62_03-18-week1-FAILING_AND_PASSING,49,3,52
348409750,batfish/batfish,26/08/18 20:57,spirals-bears,48c73b9c-1328-499c-ba34-dd1c2d05cb62_03-18-week1-FAILING_AND_PASSING,52,0,52
348012369,batfish/batfish,26/08/18 20:57,spirals-bears,48c73b9c-1328-499c-ba34-dd1c2d05cb62_03-18-week1-FAILING_AND_PASSING,55,3,58
347588693,batfish/batfish,26/08/18 20:58,spirals-bears,48c73b9c-1328-499c-ba34-dd1c2d05cb62_03-18-week1-FAILING_AND_PASSING,53,0,53
348247233,lucee/Lucee,26/08/18 20:58,spirals-bears,48c73b9c-1328-499c-ba34-dd1c2d05cb62_03-18-week1-FAILING_AND_PASSING,4,9,20,0,0,1,0,34
347917278,lucee/Lucee,26/08/18 20:58,spirals-bears,48c73b9c-1328-499c-ba34-dd1c2d05cb62_03-18-week1-FAILING_AND_PASSING,3,8,21,0,1,0,0,33
347791146,lucee/Lucee,26/08/18 20:59,spirals-bears,48c73b9c-1328-499c-ba34-dd1c2d05cb62_03-18-week1-FAILING_AND_PASSING,4,10,21,0,1,0,0,36
349733823,apache/incubator-servicecomb-java-chassis,26/08/18 20:59,spirals-bears,48c73b9c-1328-499c-ba34-dd1c2d05cb62_03-18-week1-FAILING_AND_PASSING,11,3,14
349678351,apache/incubator-servicecomb-java-chassis,26/08/18 20:59,spirals-bears,48c73b9c-1328-499c-ba34-dd1c2d05cb62_03-18-week1-FAILING_AND_PASSING,11,3,14
350463132,runelite/runelite,26/08/18 20:59,spirals-bears,48c73b9c-1328-499c-ba34-dd1c2d05cb62_03-18-week1-FAILING_AND_PASSING,11,0,11
350116142,runelite/runelite,26/08/18 21:00,spirals-bears,48c73b9c-1328-499c-ba34-dd1c2d05cb62_03-18-week1-FAILING_AND_PASSING,11,13,24
349906093,runelite/runelite,26/08/18 21:01,spirals-bears,48c73b9c-1328-499c-ba34-dd1c2d05cb62_03-18-week1-FAILING_AND_PASSING,10,14,24
348037725,runelite/runelite,26/08/18 21:02,spirals-bears,48c73b9c-1328-499c-ba34-dd1c2d05cb62_03-18-week1-FAILING_AND_PASSING,11,14,25
349585301,runelite/runelite,26/08/18 21:02,spirals-bears,48c73b9c-1328-499c-ba34-dd1c2d05cb62_03-18-week1-FAILING_AND_PASSING,11,0,11
349548307,runelite/runelite,26/08/18 21:03,spirals-bears,48c73b9c-1328-499c-ba34-dd1c2d05cb62_03-18-week1-FAILING_AND_PASSING,10,14,24
349422308,runelite/runelite,26/08/18 21:03,spirals-bears,48c73b9c-1328-499c-ba34-dd1c2d05cb62_03-18-week1-FAILING_AND_PASSING,10,0,10
349391822,runelite/runelite,26/08/18 21:03,spirals-bears,48c73b9c-1328-499c-ba34-dd1c2d05cb62_03-18-week1-FAILING_AND_PASSING,11,0,11
348237540,apache/nifi,26/08/18 21:04,spirals-bears,48c73b9c-1328-499c-ba34-dd1c2d05cb62_03-18-week1-FAILING_AND_PASSING,1516,38,2,2,4,1562
349315504,runelite/runelite,26/08/18 21:04,spirals-bears,48c73b9c-1328-499c-ba34-dd1c2d05cb62_03-18-week1-FAILING_AND_PASSING,11,13,24
349297194,runelite/runelite,26/08/18 21:04,spirals-bears,48c73b9c-1328-499c-ba34-dd1c2d05cb62_03-18-week1-FAILING_AND_PASSING,11,0,11
349248071,runelite/runelite,26/08/18 21:04,spirals-bears,48c73b9c-1328-499c-ba34-dd1c2d05cb62_03-18-week1-FAILING_AND_PASSING,12,0,12
348967510,runelite/runelite,26/08/18 21:05,spirals-bears,48c73b9c-1328-499c-ba34-dd1c2d05cb62_03-18-week1-FAILING_AND_PASSING,11,0,11
348711956,runelite/runelite,26/08/18 21:05,spirals-bears,48c73b9c-1328-499c-ba34-dd1c2d05cb62_03-18-week1-FAILING_AND_PASSING,12,0,12
348939926,runelite/runelite,26/08/18 21:05,spirals-bears,48c73b9c-1328-499c-ba34-dd1c2d05cb62_03-18-week1-FAILING_AND_PASSING,12,14,26
348909205,runelite/runelite,26/08/18 21:05,spirals-bears,48c73b9c-1328-499c-ba34-dd1c2d05cb62_03-18-week1-FAILING_AND_PASSING,10,15,25
348272346,runelite/runelite,26/08/18 21:06,spirals-bears,48c73b9c-1328-499c-ba34-dd1c2d05cb62_03-18-week1-FAILING_AND_PASSING,10,0,10
348512515,runelite/runelite,26/08/18 21:06,spirals-bears,48c73b9c-1328-499c-ba34-dd1c2d05cb62_03-18-week1-FAILING_AND_PASSING,11,13,24
348358844,runelite/runelite,26/08/18 21:06,spirals-bears,48c73b9c-1328-499c-ba34-dd1c2d05cb62_03-18-week1-FAILING_AND_PASSING,11,0,11
348297634,runelite/runelite,26/08/18 21:06,spirals-bears,48c73b9c-1328-499c-ba34-dd1c2d05cb62_03-18-week1-FAILING_AND_PASSING,11,0,11
348079668,runelite/runelite,26/08/18 21:06,spirals-bears,48c73b9c-1328-499c-ba34-dd1c2d05cb62_03-18-week1-FAILING_AND_PASSING,11,0,11
348024574,runelite/runelite,26/08/18 21:06,spirals-bears,48c73b9c-1328-499c-ba34-dd1c2d05cb62_03-18-week1-FAILING_AND_PASSING,11,1,12
347529504,runelite/runelite,26/08/18 21:07,spirals-bears,48c73b9c-1328-499c-ba34-dd1c2d05cb62_03-18-week1-FAILING_AND_PASSING,10,13,23
347514455,runelite/runelite,26/08/18 21:07,spirals-bears,48c73b9c-1328-499c-ba34-dd1c2d05cb62_03-18-week1-FAILING_AND_PASSING,10,0,10
347624725,runelite/runelite,26/08/18 21:08,spirals-bears,48c73b9c-1328-499c-ba34-dd1c2d05cb62_03-18-week1-FAILING_AND_PASSING,87,10,0,15,0,112
347622143,apache/incubator-servicecomb-java-chassis,26/08/18 21:09,spirals-bears,48c73b9c-1328-499c-ba34-dd1c2d05cb62_03-18-week1-FAILING_AND_PASSING,325,242,10,1,1,5,0,584
347530671,CorfuDB/CorfuDB,26/08/18 21:12,spirals-bears,48c73b9c-1328-499c-ba34-dd1c2d05cb62_03-18-week1-FAILING_AND_PASSING,267,0,267
343540431,apache/nifi,26/08/18 21:12,spirals-bears,48c73b9c-1328-499c-ba34-dd1c2d05cb62_03-18-week1-FAILING_AND_PASSING,1646,38,2,6,4,1696
348394668,apache/activemq-artemis,26/08/18 21:13,spirals-bears,48c73b9c-1328-499c-ba34-dd1c2d05cb62_03-18-week1-FAILING_AND_PASSING,29,5,34
347530680,CorfuDB/CorfuDB,26/08/18 21:13,spirals-bears,48c73b9c-1328-499c-ba34-dd1c2d05cb62_03-18-week1-FAILING_AND_PASSING,300,3,303
348308196,apache/activemq-artemis,26/08/18 21:14,spirals-bears,48c73b9c-1328-499c-ba34-dd1c2d05cb62_03-18-week1-FAILING_AND_PASSING,27,4,31
347888569,apache/activemq-artemis,26/08/18 21:16,spirals-bears,48c73b9c-1328-499c-ba34-dd1c2d05cb62_03-18-week1-FAILING_AND_PASSING,27,44,71
347834870,apache/activemq-artemis,26/08/18 21:17,spirals-bears,48c73b9c-1328-499c-ba34-dd1c2d05cb62_03-18-week1-FAILING_AND_PASSING,27,42,69
347598206,apache/activemq-artemis,26/08/18 21:18,spirals-bears,48c73b9c-1328-499c-ba34-dd1c2d05cb62_03-18-week1-FAILING_AND_PASSING,29,4,33
347470380,linkedin/pinot,26/08/18 21:19,spirals-bears,48c73b9c-1328-499c-ba34-dd1c2d05cb62_03-18-week1-FAILING_AND_PASSING,42,9,51
347570739,linkedin/pinot,26/08/18 21:20,spirals-bears,48c73b9c-1328-499c-ba34-dd1c2d05cb62_03-18-week1-FAILING_AND_PASSING,39,5,44
349659543,Azure/azure-libraries-for-java,26/08/18 21:21,spirals-bears,48c73b9c-1328-499c-ba34-dd1c2d05cb62_03-18-week1-FAILING_AND_PASSING,61,5,66
349931405,apache/activemq-artemis,26/08/18 21:25,spirals-bears,48c73b9c-1328-499c-ba34-dd1c2d05cb62_03-18-week1-FAILING_AND_PASSING,271,455,27,0,1,1,0,755
349719777,graphhopper/graphhopper,26/08/18 21:25,spirals-bears,48c73b9c-1328-499c-ba34-dd1c2d05cb62_03-18-week1-FAILING_AND_PASSING,67,133,19,0,1,0,0,220
349393630,graphhopper/graphhopper,26/08/18 21:29,spirals-bears,48c73b9c-1328-499c-ba34-dd1c2d05cb62_03-18-week1-FAILING_AND_PASSING,84,132,19,0,0,0,0,235
349393700,graphhopper/graphhopper,26/08/18 21:29,spirals-bears,48c73b9c-1328-499c-ba34-dd1c2d05cb62_03-18-week1-FAILING_AND_PASSING,86,134,21,0,4,1,0,246
348120228,graphhopper/graphhopper,26/08/18 21:34,spirals-bears,48c73b9c-1328-499c-ba34-dd1c2d05cb62_03-18-week1-FAILING_AND_PASSING,68,173,17,0,0,0,0,258
349510744,apache/activemq-artemis,26/08/18 21:42,spirals-bears,48c73b9c-1328-499c-ba34-dd1c2d05cb62_03-18-week1-FAILING_AND_PASSING,8,47,0,1,11,0,1,14,0,298,0,354,1,348,450,27,181,1,1742
347727806,apache/storm,26/08/18 21:43,spirals-bears,48c73b9c-1328-499c-ba34-dd1c2d05cb62_03-18-week1-FAILING_AND_PASSING,21,0,6,1,2,8,0,55,708,4,530,660,39,0,2034
349360363,HubSpot/Singularity,26/08/18 21:55,spirals-bears,48c73b9c-1328-499c-ba34-dd1c2d05cb62_03-18-week1-FAILING_AND_PASSING,20,0,0,4,1,24,0,360,342,2,360,401,19,2,1535
349438949,HubSpot/Singularity,26/08/18 22:00,spirals-bears,48c73b9c-1328-499c-ba34-dd1c2d05cb62_03-18-week1-FAILING_AND_PASSING,13,0,0,0,2,21,0,343,403,0,358,403,16,0,1559
349881067,HubSpot/Singularity,26/08/18 22:09,spirals-bears,48c73b9c-1328-499c-ba34-dd1c2d05cb62_03-18-week1-FAILING_AND_PASSING,12,0,1,14,3,71,0,368,359,0,369,392,21,2,1612
349881190,HubSpot/Singularity,26/08/18 22:10,spirals-bears,48c73b9c-1328-499c-ba34-dd1c2d05cb62_03-18-week1-FAILING_AND_PASSING,11,0,3,4,1,52,0,356,353,4,380,406,18,2,1590
348394864,HubSpot/Singularity,26/08/18 22:22,spirals-bears,48c73b9c-1328-499c-ba34-dd1c2d05cb62_03-18-week1-FAILING_AND_PASSING,16,0,1,2,6,68,4,355,370,4,354,403,19,11,1613
348003693,HubSpot/Singularity,26/08/18 22:30,spirals-bears,48c73b9c-1328-499c-ba34-dd1c2d05cb62_03-18-week1-FAILING_AND_PASSING,10,0,0,1,1,35,5,296,491,3,353,579,18,4,1796
347903666,HubSpot/Singularity,26/08/18 22:34,spirals-bears,48c73b9c-1328-499c-ba34-dd1c2d05cb62_03-18-week1-FAILING_AND_PASSING,957,419,17,0,0,1,1394
347903726,HubSpot/Singularity,26/08/18 22:35,spirals-bears,48c73b9c-1328-499c-ba34-dd1c2d05cb62_03-18-week1-FAILING_AND_PASSING,14,0,0,0,2,72,1,287,328,1,376,408,20,12,1521
347889987,HubSpot/Singularity,26/08/18 22:46,spirals-bears,48c73b9c-1328-499c-ba34-dd1c2d05cb62_03-18-week1-FAILING_AND_PASSING,9,0,0,0,1,3,0,321,351,0,288,384,17,0,1374
347797657,lettuce-io/lettuce-core,26/08/18 22:47,spirals-bears,48c73b9c-1328-499c-ba34-dd1c2d05cb62_03-18-week1-FAILING_AND_PASSING,19,43,8,0,0,1,0,71
347758753,HubSpot/Singularity,26/08/18 22:54,spirals-bears,48c73b9c-1328-499c-ba34-dd1c2d05cb62_03-18-week1-FAILING_AND_PASSING,20,0,0,0,1,6,0,325,335,0,350,387,19,0,1443
349231161,molgenis/molgenis,26/08/18 22:55,spirals-bears,48c73b9c-1328-499c-ba34-dd1c2d05cb62_03-18-week1-FAILING_AND_PASSING,397,41,0,6,2,446
348603448,StuPro-TOSCAna/TOSCAna,26/08/18 22:55,spirals-bears,48c73b9c-1328-499c-ba34-dd1c2d05cb62_03-18-week1-FAILING_AND_PASSING,16,0,16
349004833,StuPro-TOSCAna/TOSCAna,26/08/18 22:56,spirals-bears,48c73b9c-1328-499c-ba34-dd1c2d05cb62_03-18-week1-FAILING_AND_PASSING,19,2,21
347861277,HubSpot/Singularity,26/08/18 22:58,spirals-bears,48c73b9c-1328-499c-ba34-dd1c2d05cb62_03-18-week1-FAILING_AND_PASSING,8,0,0,0,1,12,0,296,337,0,311,430,18,0,1413
347517912,visallo/vertexium,26/08/18 22:58,spirals-bears,48c73b9c-1328-499c-ba34-dd1c2d05cb62_03-18-week1-FAILING_AND_PASSING,13,173,7,0,0,1,0,194
350001655,ga4gh/dockstore,26/08/18 22:58,spirals-bears,48c73b9c-1328-499c-ba34-dd1c2d05cb62_03-18-week1-FAILING_AND_PASSING,10,0,10
349472629,ga4gh/dockstore,26/08/18 22:58,spirals-bears,48c73b9c-1328-499c-ba34-dd1c2d05cb62_03-18-week1-FAILING_AND_PASSING,10,3,13
349472582,ga4gh/dockstore,26/08/18 22:59,spirals-bears,48c73b9c-1328-499c-ba34-dd1c2d05cb62_03-18-week1-FAILING_AND_PASSING,11,0,11
347849373,HubSpot/Singularity,26/08/18 22:59,spirals-bears,48c73b9c-1328-499c-ba34-dd1c2d05cb62_03-18-week1-FAILING_AND_PASSING,13,0,0,0,1,4,0,277,347,0,295,424,20,0,1381
350235744,apache/jackrabbit-oak,26/08/18 23:02,spirals-bears,48c73b9c-1328-499c-ba34-dd1c2d05cb62_03-18-week1-FAILING_AND_PASSING,174,35,0,1,2,212
345081398,aliyun/fc-java-sdk,26/08/18 23:03,spirals-bears,48c73b9c-1328-499c-ba34-dd1c2d05cb62_03-18-week1-FAILING_AND_PASSING,2,2,4
345081219,aliyun/fc-java-sdk,26/08/18 23:03,spirals-bears,48c73b9c-1328-499c-ba34-dd1c2d05cb62_03-18-week1-FAILING_AND_PASSING,2,0,2
348512177,airlift/airlift,26/08/18 23:12,spirals-bears,48c73b9c-1328-499c-ba34-dd1c2d05cb62_03-18-week1-FAILING_AND_PASSING,287,231,12,0,0,1,0,531
348265143,resteasy/Resteasy,26/08/18 23:12,spirals-bears,48c73b9c-1328-499c-ba34-dd1c2d05cb62_03-18-week1-FAILING_AND_PASSING,17,5,22
348158125,resteasy/Resteasy,26/08/18 23:13,spirals-bears,48c73b9c-1328-499c-ba34-dd1c2d05cb62_03-18-week1-FAILING_AND_PASSING,18,5,23
348156219,resteasy/Resteasy,26/08/18 23:13,spirals-bears,48c73b9c-1328-499c-ba34-dd1c2d05cb62_03-18-week1-FAILING_AND_PASSING,17,5,22
350226395,geoserver/geoserver,26/08/18 23:18,spirals-bears,48c73b9c-1328-499c-ba34-dd1c2d05cb62_03-18-week1-FAILING_AND_PASSING,176,73,0,11,1,261
346880149,geoserver/geoserver,26/08/18 23:19,spirals-bears,48c73b9c-1328-499c-ba34-dd1c2d05cb62_03-18-week1-FAILING_AND_PASSING,53,6,59
341417677,soft-serve-java/RestHub,26/08/18 23:21,spirals-bears,48c73b9c-1328-499c-ba34-dd1c2d05cb62_03-18-week1-FAILING_AND_PASSING,22,37,7,5,0,0,2,2,0,16,0,0,91
341414838,soft-serve-java/RestHub,26/08/18 23:23,spirals-bears,48c73b9c-1328-499c-ba34-dd1c2d05cb62_03-18-week1-FAILING_AND_PASSING,23,32,10,4,0,0,1,0,0,16,0,0,86
348176450,soft-serve-java/RestHub,26/08/18 23:25,spirals-bears,48c73b9c-1328-499c-ba34-dd1c2d05cb62_03-18-week1-FAILING_AND_PASSING,62,37,7,5,0,0,1,1,0,13,0,0,126
349258030,isopov/tarantool-java-driver,26/08/18 23:26,spirals-bears,48c73b9c-1328-499c-ba34-dd1c2d05cb62_03-18-week1-FAILING_AND_PASSING,11,0,0,0,2,0,0,7,9,0,8,25,2,0,64
348374090,isopov/tarantool-java-driver,26/08/18 23:27,spirals-bears,48c73b9c-1328-499c-ba34-dd1c2d05cb62_03-18-week1-FAILING_AND_PASSING,11,0,0,0,0,0,0,7,8,0,9,25,2,0,62
347768819,languagetool-org/languagetool,26/08/18 23:32,spirals-bears,48c73b9c-1328-499c-ba34-dd1c2d05cb62_03-18-week1-FAILING_AND_PASSING,9,38,0,2,26,0,0,36,0,795,0,61,0,722,111,289,35,0,2124
350359885,apache/jackrabbit-oak,26/08/18 23:45,spirals-bears,48c73b9c-1328-499c-ba34-dd1c2d05cb62_03-18-week1-FAILING_AND_PASSING,7,0,1,1,2,10,0,1749,373,1,129,468,35,0,2776
349293370,aicis/fresco,26/08/18 23:52,spirals-bears,48c73b9c-1328-499c-ba34-dd1c2d05cb62_03-18-week1-FAILING_AND_PASSING,1375,105,9,0,4,0,0,1493
348439627,aicis/fresco,26/08/18 23:53,spirals-bears,48c73b9c-1328-499c-ba34-dd1c2d05cb62_03-18-week1-FAILING_AND_PASSING,8,0,8
348221016,aicis/fresco,26/08/18 23:53,spirals-bears,48c73b9c-1328-499c-ba34-dd1c2d05cb62_03-18-week1-FAILING_AND_PASSING,9,2,11
349327903,aicis/fresco,26/08/18 23:58,spirals-bears,48c73b9c-1328-499c-ba34-dd1c2d05cb62_03-18-week1-FAILING_AND_PASSING,1440,88,9,0,3,0,0,1540
347962934,aicis/fresco,27/08/18 00:05,spirals-bears,48c73b9c-1328-499c-ba34-dd1c2d05cb62_03-18-week1-FAILING_AND_PASSING,625,97,9,0,2,0,733
347962890,aicis/fresco,27/08/18 00:10,spirals-bears,48c73b9c-1328-499c-ba34-dd1c2d05cb62_03-18-week1-FAILING_AND_PASSING,621,87,8,0,0,0,716
347797210,apache/jackrabbit-oak,27/08/18 00:10,spirals-bears,48c73b9c-1328-499c-ba34-dd1c2d05cb62_03-18-week1-FAILING_AND_PASSING,8,0,2,0,2,14,0,1603,360,0,1758,465,34,1,4247
349295799,aicis/fresco,27/08/18 00:12,spirals-bears,48c73b9c-1328-499c-ba34-dd1c2d05cb62_03-18-week1-FAILING_AND_PASSING,1499,95,8,0,0,0,0,1602
347687198,aicis/fresco,27/08/18 00:43,spirals-bears,48c73b9c-1328-499c-ba34-dd1c2d05cb62_03-18-week1-FAILING_AND_PASSING,69,6,0,3,7,0,0,4,0,1407,0,32,3,255,88,9,4,0,1887
349658615,swagger-api/swagger-codegen,27/08/18 00:44,spirals-bears,48c73b9c-1328-499c-ba34-dd1c2d05cb62_03-18-week1-FAILING_AND_PASSING,36,5,41
347765361,aicis/fresco,27/08/18 00:45,spirals-bears,48c73b9c-1328-499c-ba34-dd1c2d05cb62_03-18-week1-FAILING_AND_PASSING,8,0,3,0,4,0,619,34,3,1568,96,8,0,2343
349382841,swagger-api/swagger-codegen,27/08/18 00:45,spirals-bears,48c73b9c-1328-499c-ba34-dd1c2d05cb62_03-18-week1-FAILING_AND_PASSING,33,4,37
350020209,junit-team/junit5-samples,27/08/18 00:45,spirals-bears,48c73b9c-1328-499c-ba34-dd1c2d05cb62_03-18-week1-FAILING_AND_PASSING,2,0,2
348301792,Blazebit/blaze-persistence,27/08/18 00:46,spirals-bears,48c73b9c-1328-499c-ba34-dd1c2d05cb62_03-18-week1-FAILING_AND_PASSING,11,3,14
349729645,apache/incubator-servicecomb-saga,27/08/18 00:46,spirals-bears,48c73b9c-1328-499c-ba34-dd1c2d05cb62_03-18-week1-FAILING_AND_PASSING,4,2,6
348080323,apache/incubator-servicecomb-saga,27/08/18 00:46,spirals-bears,48c73b9c-1328-499c-ba34-dd1c2d05cb62_03-18-week1-FAILING_AND_PASSING,4,4,8
347741033,datastax/java-driver,27/08/18 00:47,spirals-bears,48c73b9c-1328-499c-ba34-dd1c2d05cb62_03-18-week1-FAILING_AND_PASSING,15,2,17
347741050,datastax/java-driver,27/08/18 00:47,spirals-bears,48c73b9c-1328-499c-ba34-dd1c2d05cb62_03-18-week1-FAILING_AND_PASSING,15,0,15
349216482,swagger-api/swagger-codegen,27/08/18 00:49,spirals-bears,48c73b9c-1328-499c-ba34-dd1c2d05cb62_03-18-week1-FAILING_AND_PASSING,24,200,33,0,7,0,0,264
347756953,aicis/fresco,27/08/18 01:03,spirals-bears,48c73b9c-1328-499c-ba34-dd1c2d05cb62_03-18-week1-FAILING_AND_PASSING,8,4,0,3,7,0,0,4,0,1519,0,35,3,1493,94,9,6,0,3185
347753461,aicis/fresco,27/08/18 01:04,spirals-bears,48c73b9c-1328-499c-ba34-dd1c2d05cb62_03-18-week1-FAILING_AND_PASSING,8,6,0,0,7,0,0,5,0,1549,0,34,0,1519,97,9,7,0,3241
349210301,danglotb/dspot,27/08/18 01:04,spirals-bears,48c73b9c-1328-499c-ba34-dd1c2d05cb62_03-18-week1-FAILING_AND_PASSING,6,0,6
349172462,danglotb/dspot,27/08/18 01:05,spirals-bears,48c73b9c-1328-499c-ba34-dd1c2d05cb62_03-18-week1-FAILING_AND_PASSING,5,0,5
349064199,danglotb/dspot,27/08/18 01:16,spirals-bears,48c73b9c-1328-499c-ba34-dd1c2d05cb62_03-18-week1-FAILING_AND_PASSING,7,0,0,0,0,1,0,8,45,0,464,132,5,0,662
350289810,danglotb/dspot,27/08/18 01:17,spirals-bears,48c73b9c-1328-499c-ba34-dd1c2d05cb62_03-18-week1-FAILING_AND_PASSING,9,0,0,0,0,1,0,8,45,0,594,185,5,0,847
349375083,dhis2/dhis2-core,27/08/18 01:18,spirals-bears,48c73b9c-1328-499c-ba34-dd1c2d05cb62_03-18-week1-FAILING_AND_PASSING,82,24,0,4,0,110
348156982,dhis2/dhis2-core,27/08/18 01:20,spirals-bears,48c73b9c-1328-499c-ba34-dd1c2d05cb62_03-18-week1-FAILING_AND_PASSING,81,22,0,1,0,104
349942519,debezium/debezium,27/08/18 01:20,spirals-bears,48c73b9c-1328-499c-ba34-dd1c2d05cb62_03-18-week1-FAILING_AND_PASSING,7,4,11
349958225,debezium/debezium,27/08/18 01:21,spirals-bears,48c73b9c-1328-499c-ba34-dd1c2d05cb62_03-18-week1-FAILING_AND_PASSING,6,4,10
349830859,debezium/debezium,27/08/18 01:21,spirals-bears,48c73b9c-1328-499c-ba34-dd1c2d05cb62_03-18-week1-FAILING_AND_PASSING,6,5,11
349371756,debezium/debezium,27/08/18 01:24,spirals-bears,48c73b9c-1328-499c-ba34-dd1c2d05cb62_03-18-week1-FAILING_AND_PASSING,46,127,6,0,3,0,0,182
347406719,debezium/debezium,27/08/18 01:24,spirals-bears,48c73b9c-1328-499c-ba34-dd1c2d05cb62_03-18-week1-FAILING_AND_PASSING,7,0,7
348029369,debezium/debezium,27/08/18 01:27,spirals-bears,48c73b9c-1328-499c-ba34-dd1c2d05cb62_03-18-week1-FAILING_AND_PASSING,42,91,6,0,3,0,0,142
348131214,fabric8io/fabric8-maven-plugin,27/08/18 01:28,spirals-bears,48c73b9c-1328-499c-ba34-dd1c2d05cb62_03-18-week1-FAILING_AND_PASSING,28,7,35
348157930,dhis2/dhis2-core,27/08/18 01:28,spirals-bears,48c73b9c-1328-499c-ba34-dd1c2d05cb62_03-18-week1-FAILING_AND_PASSING,13,0,2,0,1,10,0,191,12,1,197,167,22,0,616
347883230,fabric8io/fabric8-maven-plugin,27/08/18 01:28,spirals-bears,48c73b9c-1328-499c-ba34-dd1c2d05cb62_03-18-week1-FAILING_AND_PASSING,30,6,36
348858219,zalando/zalenium,27/08/18 01:31,spirals-bears,48c73b9c-1328-499c-ba34-dd1c2d05cb62_03-18-week1-FAILING_AND_PASSING,114,37,6,0,0,0,0,157
348944188,zalando/zalenium,27/08/18 01:31,spirals-bears,48c73b9c-1328-499c-ba34-dd1c2d05cb62_03-18-week1-FAILING_AND_PASSING,5,2,7
348814633,zalando/zalenium,27/08/18 01:34,spirals-bears,48c73b9c-1328-499c-ba34-dd1c2d05cb62_03-18-week1-FAILING_AND_PASSING,116,35,6,0,0,0,0,157
348718728,zalando/zalenium,27/08/18 01:34,spirals-bears,48c73b9c-1328-499c-ba34-dd1c2d05cb62_03-18-week1-FAILING_AND_PASSING,6,2,8
347635260,fabric8io/fabric8-maven-plugin,27/08/18 01:36,spirals-bears,48c73b9c-1328-499c-ba34-dd1c2d05cb62_03-18-week1-FAILING_AND_PASSING,122,289,30,0,9,2,0,452
343862627,B3Partners/brmo,27/08/18 01:36,spirals-bears,48c73b9c-1328-499c-ba34-dd1c2d05cb62_03-18-week1-FAILING_AND_PASSING,78,3,81
343851763,B3Partners/brmo,27/08/18 01:37,spirals-bears,48c73b9c-1328-499c-ba34-dd1c2d05cb62_03-18-week1-FAILING_AND_PASSING,84,0,84
350329442,jnidzwetzki/bboxdb,27/08/18 01:41,spirals-bears,48c73b9c-1328-499c-ba34-dd1c2d05cb62_03-18-week1-FAILING_AND_PASSING,5,0,0,0,0,2,0,27,70,0,28,129,8,0,269
350165874,jnidzwetzki/bboxdb,27/08/18 01:42,spirals-bears,48c73b9c-1328-499c-ba34-dd1c2d05cb62_03-18-week1-FAILING_AND_PASSING,6,0,0,0,0,1,0,26,75,0,27,125,9,0,269
348847447,jnidzwetzki/bboxdb,27/08/18 01:46,spirals-bears,48c73b9c-1328-499c-ba34-dd1c2d05cb62_03-18-week1-FAILING_AND_PASSING,5,0,0,0,0,1,0,26,76,0,27,143,8,0,286
348565791,jnidzwetzki/bboxdb,27/08/18 01:47,spirals-bears,48c73b9c-1328-499c-ba34-dd1c2d05cb62_03-18-week1-FAILING_AND_PASSING,5,0,0,0,0,1,0,26,76,0,27,135,9,0,279
350246478,MariaDB/mariadb-connector-j,27/08/18 01:48,spirals-bears,48c73b9c-1328-499c-ba34-dd1c2d05cb62_03-18-week1-FAILING_AND_PASSING,11,0,0,0,0,1,0,1785,29,0,1786,54,8,0,3674
348416796,jnidzwetzki/bboxdb,27/08/18 01:51,spirals-bears,48c73b9c-1328-499c-ba34-dd1c2d05cb62_03-18-week1-FAILING_AND_PASSING,5,0,1,0,0,1,0,26,75,0,29,135,9,0,281
348725206,MariaDB/mariadb-connector-j,27/08/18 01:51,spirals-bears,48c73b9c-1328-499c-ba34-dd1c2d05cb62_03-18-week1-FAILING_AND_PASSING,10,0,0,0,0,1,0,1787,29,0,1787,56,7,0,3677
